//MAP CONVERTED BY dmm2tgm.py THIS HEADER COMMENT PREVENTS RECONVERSION, DO NOT REMOVE
"a" = (
/obj/storage/closet,
/obj/critter/wraithskeleton,
/turf/simulated/floor/plating,
/area/space)
"b" = (
/obj/machinery/bot/skullbot,
/turf/simulated/floor/plating,
/area/space)
"E" = (
/turf/simulated/floor/plating,
/area/space)

(1,1,1) = {"
a
E
a
"}
(2,1,1) = {"
E
b
E
"}
(3,1,1) = {"
a
E
a
"}
