//MAP CONVERTED BY dmm2tgm.py THIS HEADER COMMENT PREVENTS RECONVERSION, DO NOT REMOVE
"a" = (
/obj/machinery/light/small/floor/netural,
/turf/simulated/floor/plating,
/area/space)
"d" = (
/obj/machinery/atmospherics/valve{
	dir = 4
	},
/turf/simulated/floor/plating,
/area/space)
"p" = (
/obj/machinery/portable_atmospherics/canister/air,
/turf/simulated/floor/plating,
/area/space)
"y" = (
/obj/machinery/atmospherics/portables_connector/east,
/obj/machinery/portable_atmospherics/canister/air,
/turf/simulated/floor/plating,
/area/space)
"C" = (
/turf/simulated/floor/plating,
/area/space)
"I" = (
/obj/machinery/atmospherics/portables_connector/west,
/obj/machinery/portable_atmospherics/canister/air/large,
/turf/simulated/floor/plating,
/area/space)

(1,1,1) = {"
y
C
p
"}
(2,1,1) = {"
d
a
p
"}
(3,1,1) = {"
I
C
C
"}
