//MAP CONVERTED BY dmm2tgm.py THIS HEADER COMMENT PREVENTS RECONVERSION, DO NOT REMOVE
"a" = (
/obj/loudspeaker,
/turf/simulated/floor/specialroom/chapel{
	dir = 1
	},
/area/dmm_suite/clear_area)
"g" = (
/turf/simulated/floor/carpet/purple/fancy/narrow/west,
/area/dmm_suite/clear_area)
"v" = (
/obj/decal/stage_edge{
	dir = 8;
	density = 0
	},
/obj/item/device/microphone,
/turf/simulated/floor/carpet/clowncarpet,
/area/dmm_suite/clear_area)
"B" = (
/turf/simulated/floor/carpet/purple/fancy/narrow/east,
/area/dmm_suite/clear_area)
"C" = (
/obj/stool/chair/pew{
	dir = 4
	},
/turf/simulated/floor/specialroom/chapel{
	dir = 1
	},
/area/dmm_suite/clear_area)
"E" = (
/obj/table/wood/round,
/obj/item/decoration/flower_vase/vase7,
/turf/simulated/floor/carpet/clowncarpet,
/area/dmm_suite/clear_area)
"F" = (
/obj/decal/stage_edge{
	dir = 8;
	density = 0
	},
/turf/simulated/floor/carpet/clowncarpet,
/area/dmm_suite/clear_area)
"G" = (
/obj/stool/chair/pew{
	dir = 4
	},
/turf/simulated/floor/specialroom/chapel,
/area/dmm_suite/clear_area)
"I" = (
/obj/machinery/light/small/floor,
/turf/simulated/floor/specialroom/chapel,
/area/dmm_suite/clear_area)
"O" = (
/obj/table/wood/round,
/obj/item/storage/goodybag,
/turf/simulated/floor/specialroom/chapel{
	dir = 1
	},
/area/dmm_suite/clear_area)
"W" = (
/obj/stool/chair/pew{
	dir = 4
	},
/obj/item/cloth/towel/clown,
/turf/simulated/floor/specialroom/chapel,
/area/dmm_suite/clear_area)
"Y" = (
/obj/item/spraybottle/clown_flower,
/obj/storage/closet/coffin,
/obj/fakeobject/skeleton,
/obj/item/clothing/under/misc/clown/fancy,
/obj/item/clothing/shoes/clown_shoes,
/obj/item/clothing/mask/clown_hat,
/turf/simulated/floor/carpet/clowncarpet,
/area/dmm_suite/clear_area)

(1,1,1) = {"
O
g
a
"}
(2,1,1) = {"
W
B
G
"}
(3,1,1) = {"
C
I
C
"}
(4,1,1) = {"
F
v
F
"}
(5,1,1) = {"
E
Y
E
"}
