//MAP CONVERTED BY dmm2tgm.py THIS HEADER COMMENT PREVENTS RECONVERSION, DO NOT REMOVE
"a" = (
/obj/random_item_spawner/tools/one_or_zero,
/turf/simulated/floor/plating,
/area/dmm_suite/clear_area)
"h" = (
/obj/storage/crate,
/obj/random_item_spawner/furniture_parts/few,
/obj/random_item_spawner/tools/one_or_zero,
/turf/simulated/floor/plating,
/area/dmm_suite/clear_area)
"r" = (
/obj/rack,
/obj/random_item_spawner/tools_w_igloves/one_or_zero,
/turf/simulated/floor/plating,
/area/dmm_suite/clear_area)
"E" = (
/obj/machinery/light/small/floor/netural,
/turf/simulated/floor/plating,
/area/dmm_suite/clear_area)
"L" = (
/obj/random_item_spawner/junk/one_or_zero,
/turf/simulated/floor/plating,
/area/dmm_suite/clear_area)
"M" = (
/turf/simulated/floor/plating,
/area/dmm_suite/clear_area)
"R" = (
/obj/rack,
/obj/random_item_spawner/tools/maybe_few,
/turf/simulated/floor/plating,
/area/dmm_suite/clear_area)
"U" = (
/obj/random_item_spawner/junk/one_or_zero,
/obj/machinery/light/small/floor/netural,
/turf/simulated/floor/plating,
/area/dmm_suite/clear_area)

(1,1,1) = {"
R
a
h
"}
(2,1,1) = {"
L
U
M
"}
(3,1,1) = {"
R
r
L
"}
(4,1,1) = {"
M
E
a
"}
(5,1,1) = {"
a
L
R
"}
