//MAP CONVERTED BY dmm2tgm.py THIS HEADER COMMENT PREVENTS RECONVERSION, DO NOT REMOVE
"a" = (
/obj/item/storage/wall/clothingrack/clothes2,
/obj/random_item_spawner/dressup/some,
/turf/simulated/floor/blackwhite/whitegrime,
/area/dmm_suite/clear_area)
"b" = (
/obj/decal/cleanable/dirt/dirt3,
/turf/simulated/floor/plating,
/area/dmm_suite/clear_area)
"g" = (
/obj/decal/cleanable/dirt/dirt2,
/turf/simulated/floor/blackwhite/whitegrime,
/area/dmm_suite/clear_area)
"q" = (
/turf/simulated/floor/blackwhite/whitegrime,
/area/dmm_suite/clear_area)
"J" = (
/obj/fakeobject/lighttube_broken{
	dir = 1;
	pixel_y = -29
	},
/turf/simulated/floor/blackwhite/whitegrime,
/area/dmm_suite/clear_area)
"L" = (
/obj/decal/cleanable/dirt/dirt5,
/turf/simulated/floor/plating,
/area/dmm_suite/clear_area)
"M" = (
/obj/fakeobject/lighttube_broken{
	dir = 1;
	pixel_y = 21
	},
/obj/decal/cleanable/dirt,
/obj/decal/cleanable/machine_debris{
	pixel_x = -3;
	pixel_y = 3
	},
/obj/item/raw_material/scrap_metal,
/turf/simulated/floor/plating,
/area/dmm_suite/clear_area)
"R" = (
/obj/submachine/laundry_machine,
/obj/item/clothing/under/misc/bandshirt,
/turf/simulated/floor/black,
/area/dmm_suite/clear_area)
"V" = (
/obj/submachine/laundry_machine,
/obj/item/clothing/suit/hoodie/dullgrey,
/obj/machinery/light/incandescent/netural{
	dir = 1;
	nostick = 1;
	pixel_y = 21
	},
/obj/machinery/light_switch/north{
	pixel_x = 13
	},
/turf/simulated/floor/black,
/area/dmm_suite/clear_area)
"W" = (
/obj/submachine/laundry_machine,
/obj/decal/cleanable/cobweb,
/turf/simulated/floor/black,
/area/dmm_suite/clear_area)
"X" = (
/obj/item/cloth/towel/white{
	pixel_x = 4;
	pixel_y = 6
	},
/obj/table/reinforced,
/obj/item/reagent_containers/glass/bucket{
	pixel_x = -5;
	pixel_y = 14
	},
/turf/simulated/floor/blackwhite/whitegrime,
/area/dmm_suite/clear_area)
"Z" = (
/obj/stool/bench{
	pixel_x = -9;
	pixel_y = 4
	},
/obj/fakeobject/lighttube_broken{
	dir = 1;
	pixel_y = -29
	},
/turf/simulated/floor/blackwhite/whitegrime,
/area/dmm_suite/clear_area)

(1,1,1) = {"
W
q
X
"}
(2,1,1) = {"
V
L
Z
"}
(3,1,1) = {"
q
q
b
"}
(4,1,1) = {"
M
q
J
"}
(5,1,1) = {"
R
g
a
"}
