//MAP CONVERTED BY dmm2tgm.py THIS HEADER COMMENT PREVENTS RECONVERSION, DO NOT REMOVE
"a" = (
/obj/disposalpipe/broken{
	dir = 4
	},
/obj/disposalpipe/broken{
	dir = 8
	},
/turf/simulated/floor/plating,
/area/dmm_suite/clear_area)
"i" = (
/obj/disposalpipe/segment/bent/south,
/obj/machinery/light/emergencyflashing{
	dir = 1
	},
/turf/simulated/floor/plating,
/area/dmm_suite/clear_area)
"q" = (
/obj/disposalpipe/segment/horizontal,
/turf/simulated/floor/engine/caution/misc{
	dir = 8
	},
/area/dmm_suite/clear_area)
"t" = (
/obj/disposalpipe/segment/bent/west,
/obj/machinery/light/emergencyflashing,
/turf/simulated/floor/plating,
/area/dmm_suite/clear_area)
"u" = (
/obj/disposalpipe/junction/left/north,
/turf/simulated/floor/plating,
/area/dmm_suite/clear_area)
"v" = (
/obj/disposalpipe/segment/horizontal,
/turf/simulated/floor/plating,
/area/dmm_suite/clear_area)
"C" = (
/obj/disposalpipe/segment/bent/east,
/obj/machinery/light/emergencyflashing{
	dir = 1
	},
/turf/simulated/floor/plating,
/area/dmm_suite/clear_area)
"E" = (
/obj/fitness/speedbag/clown,
/obj/item/paper/businesscard/clowntown{
	pixel_x = -12;
	pixel_y = 4
	},
/turf/simulated/floor/engine/caution/misc{
	dir = 4
	},
/area/dmm_suite/clear_area)
"F" = (
/obj/disposalpipe/segment/horizontal{
	dir = 2
	},
/turf/simulated/floor/plating,
/area/dmm_suite/clear_area)
"M" = (
/obj/disposalpipe/trunk{
	dir = 8
	},
/obj/machinery/disposal,
/obj/decal/poster/wallsign/poster_clown{
	pixel_y = -2;
	pixel_x = 3
	},
/turf/simulated/floor/engine/caution/northsouth,
/area/dmm_suite/clear_area)
"U" = (
/obj/disposalpipe/segment/bent/north,
/obj/fakeobject/skeleton,
/obj/item/clothing/mask/clown_hat/yellow{
	pixel_y = 6;
	pixel_x = 7
	},
/obj/item/clothing/shoes/clown_shoes/yellow{
	pixel_x = -4;
	pixel_y = -4
	},
/obj/item/clothing/under/misc/clown/yellow,
/obj/machinery/light/emergencyflashing,
/turf/simulated/floor/plating,
/area/dmm_suite/clear_area)

(1,1,1) = {"
C
u
U
"}
(2,1,1) = {"
v
q
v
"}
(3,1,1) = {"
v
M
a
"}
(4,1,1) = {"
v
E
v
"}
(5,1,1) = {"
i
F
t
"}
