//MAP CONVERTED BY dmm2tgm.py THIS HEADER COMMENT PREVENTS RECONVERSION, DO NOT REMOVE
"a" = (
/obj/reagent_dispensers/beerkeg/rum,
/turf/simulated/floor/wood/five,
/area/dmm_suite/clear_area)
"i" = (
/turf/simulated/floor/wood/five,
/area/dmm_suite/clear_area)

(1,1,1) = {"
i
i
i
"}
(2,1,1) = {"
i
a
i
"}
(3,1,1) = {"
i
a
i
"}
(4,1,1) = {"
i
a
i
"}
(5,1,1) = {"
i
i
i
"}
