"a" = (/turf/space,/area/space)
"b" = (/obj/grille/catwalk{icon_state = "catwalk_cross"},/turf/space,/area/space)
"c" = (/obj/machinery/plantpot/alien,/turf/simulated/floor/grass/leafy,/area/gnome_trader)
"e" = (/obj/decal/fakeobjects/shuttleengine,/obj/decal/fakeobjects/shuttleengine{icon_state = "alt_heater"},/turf/simulated/floor,/area/space)
"g" = (/obj/railing/orange/reinforced{dir = 8},/obj/critter/maneater,/obj/machinery/light/incandescent/greenish{dir = 1},/turf/simulated/floor/grasstodirt{dir = 9},/area/gnome_trader)
"h" = (/turf/simulated/floor/grey,/area/gnome_trader)
"i" = (/obj/critter/garden_gnome,/turf/simulated/floor/grass/leafy,/area/gnome_trader)
"k" = (/obj/machinery/door/airlock/gannets/glass/alt,/obj/machinery/door/airlock/gannets/alt,/turf/space,/area/gnome_trader)
"l" = (/obj/npc/trader/gnome,/turf/simulated/floor/grass/random,/area/gnome_trader)
"m" = (/obj/machinery/light/incandescent/greenish,/obj/machinery/plantpot/bareplant/tree,/turf/simulated/floor/grasstodirt{dir = 5},/area/gnome_trader)
"n" = (/obj/critter/garden_gnome,/turf/simulated/floor/grass/random,/area/gnome_trader)
"o" = (/obj/machinery/door/airlock/gannets/alt,/turf/simulated/floor/grass/leafy,/area/gnome_trader)
"p" = (/obj/machinery/plantpot/bareplant/flower,/turf/simulated/floor/dirt,/area/gnome_trader)
"q" = (/obj/machinery/door/airlock/gannets/alt,/turf/simulated/floor/grass,/area/gnome_trader)
"t" = (/obj/railing/orange/reinforced{dir = 8},/turf/simulated/floor/grasstodirt{dir = 10},/area/gnome_trader)
"u" = (/obj/machinery/door/airlock/gannets/alt,/turf/simulated/grass,/area/gnome_trader)
"w" = (/obj/railing/orange/reinforced{dir = 4},/turf/simulated/floor/grasstodirt{dir = 6},/area/gnome_trader)
"x" = (/obj/decal/fakeobjects/shuttleengine{icon_state = "alt_propulsion"},/turf/simulated/wall/auto/reinforced,/area/space)
"A" = (/obj/machinery/light/incandescent/greenish{dir = 4},/obj/machinery/plantpot/alien,/turf/simulated/floor/grass/random,/area/gnome_trader)
"B" = (/obj/machinery/light/incandescent/greenish{dir = 1},/obj/marker/supplymarker,/turf/simulated/floor/grass/random,/area/gnome_trader)
"D" = (/turf/simulated/wall/auto/jen/brown,/area/space)
"F" = (/obj/submachine/seed_manipulator,/turf/simulated/floor/grass/random,/area/gnome_trader)
"H" = (/obj/railing/orange/reinforced{dir = 4},/obj/critter/maneater,/obj/machinery/light/incandescent/greenish{dir = 1},/turf/simulated/floor/grasstodirt{dir = 5},/area/gnome_trader)
"L" = (/obj/decal/fakeobjects/shuttleengine{icon_state = "alt_heater-L"},/turf/simulated/wall/auto/reinforced,/area/space)
"M" = (/turf/simulated/wall/auto/jen/the_tuff_stuff,/area/space)
"N" = (/turf/simulated/floor/grass/leafy,/area/gnome_trader)
"O" = (/obj/machinery/light/incandescent/greenish{dir = 8},/obj/machinery/plantpot/alien,/turf/simulated/floor/grass/random,/area/gnome_trader)
"Q" = (/obj/decal/fakeobjects/shuttleengine{icon_state = "alt_heater-R"},/turf/simulated/wall/auto/reinforced,/area/space)
"R" = (/obj/machinery/light/incandescent/greenish,/obj/machinery/plantpot/bareplant/tree,/turf/simulated/floor/grasstodirt{dir = 9},/area/gnome_trader)
"S" = (/turf/simulated/floor/grass/random,/area/gnome_trader)
"U" = (/turf/simulated/wall/auto/reinforced/jen/red,/area/space)
"V" = (/turf/simulated/wall/auto/jen/the_tuff_stuff,/area/gnome_trader)
"Y" = (/obj/window/auto,/turf/simulated/floor/grey,/area/gnome_trader)
"Z" = (/obj/machinery/plantpot/bareplant/flower,/turf/simulated/floor/grass/random,/area/gnome_trader)

(1,1,1) = {"
aaaaaUaaaaa
aaaaUUUaaaa
aaaUUBUUaaa
aaUUlSFUUaa
aaUOnSSAUaa
aaUpSSSZUaa
aMDDDqDDDMa
buhYHNgYhkb
bMhYwNtYhMb
aMoVVoVVoMa
aMNNNiNNNMa
aMMmcccRMMa
aaMMLeQMMaa
aaaaxxxaaaa
"}
