//MAP CONVERTED BY dmm2tgm.py THIS HEADER COMMENT PREVENTS RECONVERSION, DO NOT REMOVE
"aa" = (
/obj/item/storage/wall/medical{
	dir = 4
	},
/turf/simulated/wall/auto/shuttle{
	icon_state = "3"
	},
/area/shuttle/escape/centcom/sealab)
"cs" = (
/turf/simulated/wall/auto/shuttle{
	icon_state = "14"
	},
/area/shuttle/escape/centcom/sealab)
"dy" = (
/obj/stool/chair/comfy/shuttle/brown{
	dir = 8
	},
/turf/unsimulated/floor/shuttle{
	dir = 8;
	icon_state = "floor2"
	},
/area/shuttle/escape/centcom/sealab)
"el" = (
/obj/item/storage/wall/fire{
	dir = 4;
	pixel_z = -4
	},
/turf/simulated/wall/auto/shuttle{
	icon_state = "3"
	},
/area/shuttle/escape/centcom/sealab)
"ez" = (
/obj/table/auto,
/obj/random_item_spawner/med_kit,
/turf/unsimulated/floor/shuttle{
	dir = 8;
	icon_state = "floor3"
	},
/area/shuttle/escape/centcom/sealab)
"eD" = (
/turf/unsimulated/floor/shuttle{
	dir = 8;
	icon_state = "floor3"
	},
/area/shuttle/escape/centcom/sealab)
"eX" = (
/obj/landmark/load_prefab_shuttledmm/sealab,
/turf/unsimulated/outdoors/grass,
/area/centcom/outside)
"ig" = (
/obj/machinery/door/airlock/pyro/external,
/turf/unsimulated/floor/shuttle{
	dir = 8
	},
/area/shuttle/escape/centcom/sealab)
"ih" = (
/turf/simulated/wall/auto/shuttle{
	icon_state = "11"
	},
/area/shuttle/escape/centcom/sealab)
"js" = (
/obj/wingrille_spawn/auto,
/turf/unsimulated/floor/shuttle{
	dir = 8;
	icon_state = "floor2"
	},
/area/shuttle/escape/centcom/sealab)
"jN" = (
/obj/wingrille_spawn/auto,
/obj/machinery/shuttle/engine/heater{
	dir = 8;
	icon_state = "alt_heater-L"
	},
/turf/unsimulated/floor/plating,
/area/shuttle/escape/centcom/sealab)
"lc" = (
/turf/simulated/wall/auto/shuttle{
	icon_state = "10"
	},
/area/shuttle/escape/centcom/sealab)
"li" = (
/obj/table/reinforced/auto,
/obj/item/device/radio,
/turf/unsimulated/floor/shuttle{
	dir = 8;
	icon_state = "floor2"
	},
/area/shuttle/escape/centcom/sealab)
"mu" = (
/obj/indestructible/shuttle_corner{
	dir = 1
	},
/turf/unsimulated/floor/shuttle{
	dir = 8
	},
/area/shuttle/escape/centcom/sealab)
"mR" = (
/obj/stool/chair/comfy/shuttle/green,
/turf/unsimulated/floor/shuttle{
	dir = 8;
	icon_state = "floor3"
	},
/area/shuttle/escape/centcom/sealab)
"nT" = (
/obj/indestructible/shuttle_corner{
	dir = 4
	},
/turf/unsimulated/outdoors/grass,
/area/shuttle/escape/centcom/sealab)
"ou" = (
/turf/simulated/wall/auto/shuttle{
	icon_state = "2"
	},
/area/shuttle/escape/centcom/sealab)
"tn" = (
/turf/unsimulated/outdoors/grass,
/area/centcom/outside)
"un" = (
/turf/simulated/wall/auto/shuttle{
	icon_state = "7"
	},
/area/shuttle/escape/centcom/sealab)
"va" = (
/turf/simulated/wall/auto/shuttle{
	icon_state = "13"
	},
/area/shuttle/escape/centcom/sealab)
"wQ" = (
/turf/unsimulated/floor/shuttle{
	dir = 8;
	icon_state = "floor4"
	},
/area/shuttle/escape/centcom/sealab)
"yC" = (
/obj/table/reinforced/auto,
/obj/item/storage/firstaid/regular,
/turf/unsimulated/floor/shuttle{
	dir = 8;
	icon_state = "floor2"
	},
/area/shuttle/escape/centcom/sealab)
"yP" = (
/obj/stool/chair/comfy/shuttle/green{
	dir = 1
	},
/turf/unsimulated/floor/shuttle{
	dir = 8;
	icon_state = "floor3"
	},
/area/shuttle/escape/centcom/sealab)
"zv" = (
/obj/wingrille_spawn/auto,
/obj/machinery/shuttle/engine/heater{
	dir = 8;
	icon_state = "alt_heater-R"
	},
/turf/unsimulated/floor/plating,
/area/shuttle/escape/centcom/sealab)
"Cv" = (
/obj/stool/chair/comfy/shuttle/red{
	dir = 8
	},
/turf/unsimulated/floor/shuttle{
	dir = 8;
	icon_state = "floor4"
	},
/area/shuttle/escape/centcom/sealab)
"Da" = (
/obj/indestructible/shuttle_corner{
	dir = 0
	},
/turf/unsimulated/floor/shuttle{
	dir = 8
	},
/area/shuttle/escape/centcom/sealab)
"Fw" = (
/obj/indestructible/shuttle_corner{
	dir = 4
	},
/turf/unsimulated/floor/shuttle{
	dir = 8
	},
/area/shuttle/escape/centcom/sealab)
"Gg" = (
/turf/simulated/wall/auto/shuttle{
	icon_state = "3"
	},
/area/shuttle/escape/centcom/sealab)
"IN" = (
/obj/machinery/shuttle/engine/propulsion{
	dir = 8;
	icon_state = "alt_propulsion"
	},
/turf/unsimulated/outdoors/grass,
/area/shuttle/escape/centcom/sealab)
"Jg" = (
/turf/simulated/wall/auto/shuttle{
	icon_state = "5"
	},
/area/shuttle/escape/centcom/sealab)
"Ji" = (
/obj/wingrille_spawn/auto,
/obj/machinery/shuttle/engine/heater{
	dir = 8;
	icon_state = "alt_heater-M"
	},
/turf/unsimulated/floor/plating,
/area/shuttle/escape/centcom/sealab)
"Jj" = (
/obj/machinery/light/small/floor,
/obj/stool/chair/comfy/shuttle{
	dir = 8
	},
/turf/unsimulated/floor/shuttle{
	dir = 8
	},
/area/shuttle/escape/centcom/sealab)
"Kp" = (
/obj/indestructible/shuttle_corner{
	dir = 0
	},
/turf/unsimulated/outdoors/grass,
/area/shuttle/escape/centcom/sealab)
"KB" = (
/obj/stool/chair/comfy/shuttle{
	dir = 8
	},
/turf/unsimulated/floor/shuttle{
	dir = 8
	},
/area/shuttle/escape/centcom/sealab)
"LP" = (
/obj/machinery/door/airlock/pyro/command,
/turf/unsimulated/floor/shuttle{
	dir = 8;
	icon_state = "floor2"
	},
/area/shuttle/escape/centcom/sealab)
"Mu" = (
/obj/stool/chair/comfy/shuttle/red{
	dir = 4
	},
/turf/unsimulated/floor/shuttle{
	dir = 8;
	icon_state = "floor4"
	},
/area/shuttle/escape/centcom/sealab)
"MB" = (
/turf/simulated/wall/auto/shuttle{
	icon_state = "4"
	},
/area/shuttle/escape/centcom/sealab)
"Ok" = (
/obj/machinery/light/small/floor,
/turf/unsimulated/floor/shuttle{
	dir = 8;
	icon_state = "floor2"
	},
/area/shuttle/escape/centcom/sealab)
"OM" = (
/obj/machinery/computer/shuttle{
	dir = 4;
	icon_state = "turret1"
	},
/turf/unsimulated/floor/shuttle{
	dir = 8;
	icon_state = "floor2"
	},
/area/shuttle/escape/centcom/sealab)
"Pe" = (
/obj/item/storage/wall/emergency{
	dir = 8
	},
/turf/simulated/wall/auto/shuttle{
	icon_state = "3"
	},
/area/shuttle/escape/centcom/sealab)
"PF" = (
/turf/simulated/wall/auto/shuttle{
	icon_state = "9"
	},
/area/shuttle/escape/centcom/sealab)
"Rw" = (
/obj/machinery/light/small/floor,
/turf/unsimulated/floor/shuttle{
	dir = 8;
	icon_state = "floor3"
	},
/area/shuttle/escape/centcom/sealab)
"Rx" = (
/obj/machinery/door/airlock/pyro/security{
	dir = 4;
	name = "Secure Transport";
	opacity = 0
	},
/turf/unsimulated/floor/shuttle{
	dir = 8
	},
/area/shuttle/escape/centcom/sealab)
"RD" = (
/obj/wingrille_spawn/auto,
/turf/unsimulated/floor/shuttle{
	dir = 8
	},
/area/shuttle/escape/centcom/sealab)
"RX" = (
/obj/indestructible/shuttle_corner{
	dir = 1
	},
/turf/unsimulated/outdoors/grass,
/area/shuttle/escape/centcom/sealab)
"Sm" = (
/turf/simulated/wall/auto/shuttle{
	icon_state = "12"
	},
/area/shuttle/escape/centcom/sealab)
"SN" = (
/obj/machinery/light/small/floor,
/turf/unsimulated/floor/shuttle{
	dir = 8;
	icon_state = "floor4"
	},
/area/shuttle/escape/centcom/sealab)
"ST" = (
/obj/item/storage/wall/fire{
	dir = 4;
	pixel_z = -4
	},
/turf/simulated/wall/auto/shuttle{
	icon_state = "11"
	},
/area/shuttle/escape/centcom/sealab)
"TC" = (
/obj/stool/chair/comfy/shuttle{
	dir = 4
	},
/turf/unsimulated/floor/shuttle{
	dir = 8
	},
/area/shuttle/escape/centcom/sealab)
"TS" = (
/obj/table/reinforced/auto,
/obj/item/storage/toolbox/emergency,
/turf/unsimulated/floor/shuttle{
	dir = 8;
	icon_state = "floor2"
	},
/area/shuttle/escape/centcom/sealab)
"Uh" = (
/turf/unsimulated/floor/shuttle{
	dir = 8;
	icon_state = "floor2"
	},
/area/shuttle/escape/centcom/sealab)
"UI" = (
/turf/simulated/wall/auto/shuttle{
	icon_state = "6"
	},
/area/shuttle/escape/centcom/sealab)
"UJ" = (
/obj/indestructible/shuttle_corner{
	dir = 8
	},
/turf/unsimulated/outdoors/grass,
/area/shuttle/escape/centcom/sealab)
"Vg" = (
/obj/indestructible/shuttle_corner{
	dir = 8
	},
/turf/unsimulated/floor/shuttle{
	dir = 8
	},
/area/shuttle/escape/centcom/sealab)
"Wh" = (
/turf/simulated/wall/auto/shuttle{
	icon_state = "1"
	},
/area/shuttle/escape/centcom/sealab)
"Wj" = (
/obj/machinery/light/small/floor,
/turf/unsimulated/floor/shuttle{
	dir = 8
	},
/area/shuttle/escape/centcom/sealab)
"WR" = (
/obj/machinery/door/airlock/pyro/medical{
	dir = 4;
	name = "First-Aid Station";
	opacity = 0
	},
/turf/unsimulated/floor/shuttle{
	dir = 8
	},
/area/shuttle/escape/centcom/sealab)
"WY" = (
/obj/machinery/sleeper/compact{
	dir = 8
	},
/turf/unsimulated/floor/shuttle{
	dir = 8;
	icon_state = "floor3"
	},
/area/shuttle/escape/centcom/sealab)
"Xf" = (
/obj/stool/chair/comfy/shuttle/pilot{
	dir = 8
	},
/turf/unsimulated/floor/shuttle{
	dir = 8;
	icon_state = "floor2"
	},
/area/shuttle/escape/centcom/sealab)
"XO" = (
/turf/unsimulated/floor/shuttle{
	dir = 8
	},
/area/shuttle/escape/centcom/sealab)
"Yl" = (
/obj/stool/chair/comfy/shuttle/brown{
	dir = 4
	},
/turf/unsimulated/floor/shuttle{
	dir = 8;
	icon_state = "floor2"
	},
/area/shuttle/escape/centcom/sealab)
"YU" = (
/turf/simulated/wall/auto/shuttle{
	icon_state = "15"
	},
/area/shuttle/escape/centcom/sealab)

(1,1,1) = {"
tn
tn
tn
IN
IN
IN
tn
tn
tn
IN
IN
IN
tn
tn
eX
"}
(2,1,1) = {"
IN
Kp
Wh
jN
Ji
zv
aa
un
aa
jN
Ji
zv
ou
nT
IN
"}
(3,1,1) = {"
MB
Sm
mR
eD
eD
eD
yP
Sm
Mu
Mu
wQ
Mu
Mu
Sm
Sm
"}
(4,1,1) = {"
RX
va
ez
WY
Rw
WY
ez
Sm
Cv
wQ
SN
wQ
Cv
cs
UJ
"}
(5,1,1) = {"
Kp
YU
Gg
Gg
WR
Gg
Gg
ST
Gg
Gg
Rx
Gg
Gg
YU
nT
"}
(6,1,1) = {"
cs
Vg
TC
TC
XO
TC
TC
TC
TC
TC
XO
TC
TC
mu
va
"}
(7,1,1) = {"
RD
TC
TC
XO
Wj
XO
XO
XO
XO
XO
Wj
XO
TC
TC
RD
"}
(8,1,1) = {"
Sm
TC
TC
XO
UI
js
Gg
Pe
Gg
js
Jg
XO
TC
TC
Sm
"}
(9,1,1) = {"
ig
XO
XO
XO
Sm
yC
Yl
OM
Yl
li
Sm
XO
XO
XO
ig
"}
(10,1,1) = {"
RD
XO
XO
XO
LP
Ok
Uh
Uh
Uh
Ok
LP
XO
XO
XO
RD
"}
(11,1,1) = {"
ig
XO
XO
XO
Sm
TS
dy
Xf
dy
yC
Sm
XO
XO
XO
ig
"}
(12,1,1) = {"
Sm
KB
KB
XO
lc
js
Gg
el
Gg
js
PF
XO
KB
KB
Sm
"}
(13,1,1) = {"
RD
KB
KB
XO
XO
TC
TC
TC
TC
TC
XO
XO
KB
KB
RD
"}
(14,1,1) = {"
cs
Fw
KB
Wj
XO
XO
XO
XO
XO
XO
XO
Wj
KB
Da
va
"}
(15,1,1) = {"
RX
YU
Fw
KB
KB
KB
Jj
KB
Jj
KB
KB
KB
Da
YU
UJ
"}
(16,1,1) = {"
tn
RX
ih
Gg
RD
RD
RD
Pe
RD
RD
RD
Gg
ih
UJ
tn
"}
