//MAP CONVERTED BY dmm2tgm.py THIS HEADER COMMENT PREVENTS RECONVERSION, DO NOT REMOVE
"aI" = (
/obj/machinery/shuttle/engine/propulsion{
	icon_state = "alt_propulsion"
	},
/turf/unsimulated/outdoors/grass,
/area/shuttle/escape/centcom/destiny)
"aP" = (
/turf/simulated/shuttle/wall/cockpit{
	dir = 8
	},
/area/shuttle/escape/centcom/destiny)
"bq" = (
/obj/indestructible/shuttle_corner{
	dir = 0
	},
/turf/unsimulated/outdoors/grass,
/area/shuttle/escape/centcom/destiny)
"ce" = (
/obj/item/storage/wall/medical{
	dir = 8
	},
/turf/simulated/wall/auto/shuttle{
	icon_state = "3"
	},
/area/shuttle/escape/centcom/destiny)
"cf" = (
/obj/indestructible/shuttle_corner{
	dir = 4
	},
/turf/unsimulated/floor/marble/black,
/area/shuttle/escape/centcom/destiny)
"cI" = (
/turf/simulated/wall/auto/shuttle{
	icon_state = "12"
	},
/area/shuttle/escape/centcom/destiny)
"dE" = (
/obj/item/storage/wall/emergency{
	dir = 8
	},
/turf/simulated/wall/auto/shuttle{
	icon_state = "7"
	},
/area/shuttle/escape/centcom/destiny)
"dP" = (
/obj/stool/chair/wooden/regal{
	anchored = 1
	},
/turf/unsimulated/floor/carpet/regalcarpet/border,
/area/shuttle/escape/centcom/destiny)
"fa" = (
/turf/simulated/wall/auto/shuttle{
	icon_state = "5"
	},
/area/shuttle/escape/centcom/destiny)
"fd" = (
/obj/shrub{
	dir = 8
	},
/turf/unsimulated/floor/marble/border_bw{
	dir = 4
	},
/area/shuttle/escape/centcom/destiny)
"fr" = (
/obj/shrub{
	dir = 8
	},
/turf/unsimulated/floor/marble/border_bw{
	dir = 8
	},
/area/shuttle/escape/centcom/destiny)
"fv" = (
/obj/stool/chair/wooden/regal{
	anchored = 1;
	dir = 1
	},
/turf/unsimulated/floor/carpet/regalcarpet/border{
	dir = 1
	},
/area/shuttle/escape/centcom/destiny)
"gv" = (
/obj/machinery/door/airlock/pyro/external{
	dir = 4
	},
/turf/unsimulated/floor/shuttle,
/area/shuttle/escape/centcom/destiny)
"gz" = (
/obj/decoration/regallamp{
	anchored = 1;
	lit = 1
	},
/turf/unsimulated/floor/carpet/regalcarpet/innercorner{
	dir = 1
	},
/area/shuttle/escape/centcom/destiny)
"gI" = (
/obj/table/regal/auto,
/obj/item/storage/toolbox/emergency,
/turf/unsimulated/floor/marble/border_bw{
	dir = 1
	},
/area/shuttle/escape/centcom/destiny)
"he" = (
/turf/simulated/wall/auto/shuttle{
	icon_state = "9"
	},
/area/shuttle/escape/centcom/destiny)
"hy" = (
/obj/stool/chair/comfy/throne_gold{
	anchored = 1
	},
/turf/unsimulated/floor/carpet/regalcarpet/border{
	dir = 10
	},
/area/shuttle/escape/centcom/destiny)
"iF" = (
/obj/stool/chair/wooden/regal{
	anchored = 1;
	dir = 4
	},
/turf/unsimulated/floor/carpet/regalcarpet/border{
	dir = 4
	},
/area/shuttle/escape/centcom/destiny)
"jA" = (
/obj/indestructible/shuttle_corner{
	dir = 1
	},
/turf/unsimulated/outdoors/grass,
/area/shuttle/escape/centcom/destiny)
"kD" = (
/obj/table/regal/auto,
/obj/machinery/light/small/floor/netural,
/obj/item/reagent_containers/food/drinks/bottle/wine{
	pixel_x = 3;
	pixel_y = 16;
	rand_pos = 0
	},
/obj/item/reagent_containers/food/drinks/drinkingglass/wine{
	pixel_x = -7;
	pixel_y = 14;
	rand_pos = 0
	},
/obj/item/reagent_containers/food/drinks/drinkingglass/wine{
	pixel_x = -2;
	pixel_y = 8;
	rand_pos = 0
	},
/obj/item/reagent_containers/food/drinks/bottle/champagne{
	pixel_x = 8;
	pixel_y = 10;
	rand_pos = 0
	},
/obj/item/reagent_containers/food/snacks/plant/pear{
	pixel_x = -8;
	rand_pos = 0
	},
/turf/unsimulated/floor/marble/black,
/area/shuttle/escape/centcom/destiny)
"kZ" = (
/obj/stool/chair/comfy/throne_gold{
	anchored = 1
	},
/turf/unsimulated/floor/carpet/regalcarpet/border{
	dir = 8
	},
/area/shuttle/escape/centcom/destiny)
"lj" = (
/obj/decal/lightshaft,
/obj/decoration/regallamp{
	anchored = 1;
	lit = 1
	},
/turf/unsimulated/floor/marble/black,
/area/shuttle/escape/centcom/destiny)
"lU" = (
/obj/item/storage/wall/medical{
	dir = 4
	},
/turf/simulated/wall/auto/shuttle{
	icon_state = "11"
	},
/area/shuttle/escape/centcom/destiny)
"mx" = (
/obj/stool/chair/wooden/regal{
	anchored = 1;
	dir = 8
	},
/turf/unsimulated/floor/carpet/regalcarpet/border{
	dir = 8
	},
/area/shuttle/escape/centcom/destiny)
"nf" = (
/obj/wingrille_spawn/auto,
/obj/machinery/shuttle/engine/heater{
	icon_state = "alt_heater-M"
	},
/turf/unsimulated/floor/plating,
/area/shuttle/escape/centcom/destiny)
"oH" = (
/turf/unsimulated/floor/marble/border_bw{
	dir = 4
	},
/area/shuttle/escape/centcom/destiny)
"pu" = (
/turf/unsimulated/floor/marble/border_bw{
	dir = 8
	},
/area/shuttle/escape/centcom/destiny)
"qL" = (
/obj/table/regal/auto,
/obj/machinery/light/small/floor/netural,
/obj/item/reagent_containers/food/drinks/bottle/champagne{
	pixel_y = 20;
	rand_pos = 0
	},
/obj/item/reagent_containers/food/drinks/bottle/wine{
	pixel_x = -8;
	pixel_y = 7;
	rand_pos = 0
	},
/obj/item/reagent_containers/food/drinks/drinkingglass/wine{
	pixel_x = 3;
	pixel_y = 4;
	rand_pos = 0
	},
/obj/item/reagent_containers/food/drinks/drinkingglass/wine{
	pixel_x = 9;
	pixel_y = 13;
	rand_pos = 0
	},
/obj/item/reagent_containers/food/snacks/plant/apple{
	pixel_x = 8;
	pixel_y = -8;
	rand_pos = 0
	},
/obj/item/reagent_containers/food/snacks/plant/banana{
	pixel_x = -6;
	rand_pos = 0
	},
/turf/unsimulated/floor/marble/black,
/area/shuttle/escape/centcom/destiny)
"rV" = (
/turf/unsimulated/floor/carpet/regalcarpet/border{
	dir = 9
	},
/area/shuttle/escape/centcom/destiny)
"sc" = (
/turf/unsimulated/floor/carpet/regalcarpet/border{
	dir = 5
	},
/area/shuttle/escape/centcom/destiny)
"sV" = (
/obj/decal/lightshaft,
/obj/shrub{
	dir = 10
	},
/turf/unsimulated/floor/marble/border_bw{
	dir = 8
	},
/area/shuttle/escape/centcom/destiny)
"ts" = (
/obj/table/regal/auto,
/obj/machinery/light/small/floor/netural,
/obj/item/storage/toolbox/emergency,
/turf/unsimulated/floor/carpet/regalcarpet/border{
	dir = 5
	},
/area/shuttle/escape/centcom/destiny)
"tQ" = (
/turf/unsimulated/floor/carpet/regalcarpet/border{
	dir = 8
	},
/area/shuttle/escape/centcom/destiny)
"uU" = (
/obj/table/regal/auto,
/obj/decoration/floralarrangement{
	pixel_x = 16
	},
/obj/item/storage/toolbox/emergency,
/turf/unsimulated/floor/marble/border_bw{
	dir = 1
	},
/area/shuttle/escape/centcom/destiny)
"wi" = (
/obj/table/regal/auto,
/obj/random_item_spawner/med_kit,
/turf/unsimulated/floor/marble/border_bw{
	dir = 1
	},
/area/shuttle/escape/centcom/destiny)
"xa" = (
/obj/table/regal/auto,
/obj/machinery/light/small/floor/netural,
/obj/random_item_spawner/med_kit,
/turf/unsimulated/floor/carpet/regalcarpet/border{
	dir = 9
	},
/area/shuttle/escape/centcom/destiny)
"xH" = (
/obj/stool/chair/wooden/regal{
	anchored = 1
	},
/turf/unsimulated/floor/carpet/regalcarpet/border{
	dir = 6
	},
/area/shuttle/escape/centcom/destiny)
"yd" = (
/obj/indestructible/shuttle_corner{
	dir = 8
	},
/turf/unsimulated/floor/marble/black,
/area/shuttle/escape/centcom/destiny)
"yE" = (
/obj/shrub{
	dir = 6
	},
/turf/unsimulated/floor/marble/border_bw{
	dir = 8
	},
/area/shuttle/escape/centcom/destiny)
"yF" = (
/turf/simulated/wall/auto/shuttle{
	icon_state = "7"
	},
/area/shuttle/escape/centcom/destiny)
"zl" = (
/obj/lattice{
	icon_state = "lattice-dir"
	},
/turf/unsimulated/outdoors/grass,
/area/centcom/outside)
"Ai" = (
/turf/unsimulated/floor/carpet/regalcarpet/border,
/area/shuttle/escape/centcom/destiny)
"Bm" = (
/obj/stool/chair/comfy/throne_gold{
	anchored = 1
	},
/turf/unsimulated/floor/carpet/regalcarpet/border{
	dir = 6
	},
/area/shuttle/escape/centcom/destiny)
"CS" = (
/obj/shrub{
	dir = 6
	},
/turf/unsimulated/floor/marble/border_bw,
/area/shuttle/escape/centcom/destiny)
"DK" = (
/obj/wingrille_spawn/auto,
/obj/machinery/shuttle/engine/heater{
	icon_state = "alt_heater-R"
	},
/turf/unsimulated/floor/plating,
/area/shuttle/escape/centcom/destiny)
"DU" = (
/obj/wingrille_spawn/auto/crystal,
/turf/unsimulated/floor/marble/black,
/area/shuttle/escape/centcom/destiny)
"Eh" = (
/turf/unsimulated/outdoors/grass,
/area/centcom/outside)
"EA" = (
/turf/unsimulated/floor/carpet/regalcarpet/border{
	dir = 1
	},
/area/shuttle/escape/centcom/destiny)
"FH" = (
/obj/stool/chair/comfy/throne_gold{
	anchored = 1
	},
/obj/item/clothing/head/crown,
/turf/unsimulated/floor/carpet/regalcarpet,
/area/shuttle/escape/centcom/destiny)
"FR" = (
/obj/stool/chair/wooden/regal{
	anchored = 1
	},
/turf/unsimulated/floor/carpet/regalcarpet/border{
	dir = 10
	},
/area/shuttle/escape/centcom/destiny)
"Gs" = (
/obj/machinery/computer/shuttle/embedded/north,
/obj/decoration/regallamp{
	anchored = 1;
	lit = 1
	},
/turf/unsimulated/floor/carpet/regalcarpet/border{
	dir = 1
	},
/area/shuttle/escape/centcom/destiny)
"HR" = (
/obj/indestructible/invisible_block,
/turf/unsimulated/floor/marble,
/area/shuttle/escape/centcom/destiny)
"HS" = (
/turf/unsimulated/floor/marble/border_bw,
/area/shuttle/escape/centcom/destiny)
"JP" = (
/obj/table/regal/auto,
/obj/decoration/floralarrangement{
	pixel_x = 16
	},
/obj/random_item_spawner/med_kit,
/turf/unsimulated/floor/marble/border_bw{
	dir = 1
	},
/area/shuttle/escape/centcom/destiny)
"JY" = (
/obj/decoration/regallamp{
	anchored = 1;
	lit = 1
	},
/turf/unsimulated/floor/carpet/regalcarpet/innercorner,
/area/shuttle/escape/centcom/destiny)
"Ka" = (
/obj/shrub{
	dir = 1
	},
/turf/unsimulated/floor/marble/border_bw{
	dir = 4
	},
/area/shuttle/escape/centcom/destiny)
"KA" = (
/obj/decoration/regallamp{
	anchored = 1;
	lit = 1
	},
/turf/unsimulated/floor/marble/border_bw{
	dir = 1
	},
/area/shuttle/escape/centcom/destiny)
"KB" = (
/turf/simulated/wall/auto/shuttle{
	icon_state = "11"
	},
/area/shuttle/escape/centcom/destiny)
"KV" = (
/obj/stool/chair/comfy/throne_gold{
	anchored = 1
	},
/turf/unsimulated/floor/carpet/regalcarpet/border{
	dir = 4
	},
/area/shuttle/escape/centcom/destiny)
"Lf" = (
/obj/decoration/regallamp{
	anchored = 1;
	lit = 1
	},
/turf/unsimulated/floor/marble/black,
/area/shuttle/escape/centcom/destiny)
"Me" = (
/obj/decoration/regallamp{
	anchored = 1;
	lit = 1
	},
/turf/unsimulated/floor/marble/border_bw{
	dir = 8
	},
/area/shuttle/escape/centcom/destiny)
"NE" = (
/obj/table/regal/auto,
/obj/item/reagent_containers/food/snacks/plant/grape{
	pixel_x = -5;
	pixel_y = 19;
	rand_pos = 0
	},
/obj/item/reagent_containers/food/snacks/plant/grape{
	rand_pos = 0
	},
/obj/item/reagent_containers/food/snacks/croissant{
	pixel_x = 6;
	pixel_y = 8;
	rand_pos = 0
	},
/obj/item/reagent_containers/food/snacks/painauchocolat{
	pixel_x = -6;
	pixel_y = 8;
	rand_pos = 0
	},
/obj/item/reagent_containers/food/snacks/danish_apple{
	pixel_x = 8;
	pixel_y = -10;
	rand_pos = 0
	},
/obj/item/reagent_containers/food/snacks/danish_blueb{
	pixel_x = -6;
	rand_pos = 0
	},
/obj/item/reagent_containers/food/snacks/danish_cherry{
	pixel_x = 6;
	pixel_y = 4;
	rand_pos = 0
	},
/obj/item/reagent_containers/food/snacks/danish_weed{
	pixel_x = -7;
	pixel_y = -10;
	rand_pos = 0
	},
/obj/item/reagent_containers/food/snacks/garlicbread{
	pixel_y = -13;
	rand_pos = 0
	},
/turf/unsimulated/floor/marble/black,
/area/shuttle/escape/centcom/destiny)
"OO" = (
/obj/decoration/regallamp{
	anchored = 1;
	lit = 1
	},
/turf/unsimulated/floor/marble/border_bw{
	dir = 4
	},
/area/shuttle/escape/centcom/destiny)
"OT" = (
/obj/decoration/regallamp{
	anchored = 1;
	lit = 1
	},
/turf/unsimulated/floor/carpet/regalcarpet/innercorner{
	dir = 5
	},
/area/shuttle/escape/centcom/destiny)
"Pl" = (
/obj/item/storage/wall/fire{
	dir = 4
	},
/turf/simulated/wall/auto/shuttle{
	icon_state = "3"
	},
/area/shuttle/escape/centcom/destiny)
"Po" = (
/obj/indestructible/invisible_block,
/turf/unsimulated/outdoors/grass,
/area/shuttle/escape/centcom/destiny)
"Pt" = (
/obj/indestructible/shuttle_corner{
	dir = 8
	},
/turf/unsimulated/outdoors/grass,
/area/shuttle/escape/centcom/destiny)
"Pw" = (
/obj/decoration/regallamp{
	anchored = 1;
	lit = 1
	},
/turf/unsimulated/floor/carpet/regalcarpet/innercorner{
	dir = 8
	},
/area/shuttle/escape/centcom/destiny)
"PN" = (
/obj/table/regal/auto,
/obj/machinery/light/small/floor/netural,
/obj/decoration/floralarrangement,
/obj/item/reagent_containers/food/snacks/danish_weed{
	pixel_x = -6;
	pixel_y = -10;
	rand_pos = 0
	},
/obj/item/reagent_containers/food/snacks/fairybread{
	pixel_x = 8;
	pixel_y = -12;
	rand_pos = 0
	},
/obj/item/reagent_containers/food/snacks/plant/cherry{
	pixel_x = 8;
	pixel_y = 29;
	rand_pos = 0
	},
/turf/unsimulated/floor/marble/black,
/area/shuttle/escape/centcom/destiny)
"PU" = (
/turf/simulated/wall/auto/shuttle{
	icon_state = "3"
	},
/area/shuttle/escape/centcom/destiny)
"QT" = (
/obj/table/regal/auto,
/obj/item/reagent_containers/food/snacks/plant/apple{
	pixel_x = -7;
	pixel_y = -5;
	rand_pos = 0
	},
/obj/item/reagent_containers/food/snacks/plant/grape{
	pixel_x = 12;
	pixel_y = -3;
	rand_pos = 0
	},
/obj/item/reagent_containers/food/snacks/croissant{
	pixel_x = -5;
	rand_pos = 0
	},
/obj/item/reagent_containers/food/snacks/danish_apple{
	pixel_x = 5;
	pixel_y = 13;
	rand_pos = 0
	},
/obj/item/reagent_containers/food/snacks/danish_blueb{
	pixel_x = 6;
	pixel_y = 9;
	rand_pos = 0
	},
/obj/item/reagent_containers/food/snacks/danish_cherry{
	pixel_x = -6;
	pixel_y = 10;
	rand_pos = 0
	},
/turf/unsimulated/floor/marble/black,
/area/shuttle/escape/centcom/destiny)
"Rp" = (
/obj/shrub{
	dir = 6
	},
/obj/item/clothing/head/crown,
/turf/unsimulated/floor/marble/border_bw,
/area/shuttle/escape/centcom/destiny)
"Rz" = (
/obj/indestructible/shuttle_corner{
	dir = 4
	},
/turf/unsimulated/outdoors/grass,
/area/shuttle/escape/centcom/destiny)
"RD" = (
/obj/wingrille_spawn/auto,
/obj/machinery/shuttle/engine/heater{
	icon_state = "alt_heater-L"
	},
/turf/unsimulated/floor/plating,
/area/shuttle/escape/centcom/destiny)
"Sr" = (
/obj/lattice{
	dir = 1;
	icon_state = "lattice-dir-b"
	},
/turf/unsimulated/outdoors/grass,
/area/centcom/outside)
"UO" = (
/obj/shrub{
	dir = 10
	},
/obj/item/clothing/head/crown,
/turf/unsimulated/floor/marble/border_bw{
	dir = 4
	},
/area/shuttle/escape/centcom/destiny)
"Vp" = (
/obj/shrub{
	dir = 1
	},
/turf/unsimulated/floor/marble/border_bw{
	dir = 8
	},
/area/shuttle/escape/centcom/destiny)
"Yf" = (
/turf/unsimulated/floor/carpet/regalcarpet/border{
	dir = 4
	},
/area/shuttle/escape/centcom/destiny)

(1,1,1) = {"
zl
zl
zl
Sr
bq
lU
gv
DU
DU
DU
gv
KB
PU
PU
PU
Pl
Rz
Eh
"}
(2,1,1) = {"
Eh
Eh
bq
DU
he
lj
oH
Ka
OO
fd
oH
OO
UO
Ka
fd
Lf
RD
aI
"}
(3,1,1) = {"
Sr
bq
yd
Lf
Lf
CS
rV
tQ
tQ
tQ
tQ
tQ
tQ
tQ
FR
JP
nf
aI
"}
(4,1,1) = {"
Po
HR
xa
kZ
hy
HS
EA
JY
iF
iF
iF
iF
iF
OT
dP
gI
DK
aI
"}
(5,1,1) = {"
aP
HR
Gs
FH
Ai
HS
EA
dP
qL
NE
PN
QT
kD
fv
Ai
KA
cI
Eh
"}
(6,1,1) = {"
Po
HR
ts
KV
Bm
HS
EA
Pw
mx
mx
mx
mx
mx
gz
dP
uU
RD
aI
"}
(7,1,1) = {"
Sr
jA
cf
lj
Lf
Rp
sc
Yf
Yf
Yf
Yf
Yf
Yf
Yf
xH
wi
nf
aI
"}
(8,1,1) = {"
Eh
Eh
jA
DU
fa
Lf
pu
fr
Me
Vp
pu
Me
fr
sV
yE
Lf
DK
aI
"}
(9,1,1) = {"
zl
zl
zl
Sr
jA
dE
gv
DU
DU
DU
gv
yF
PU
PU
PU
ce
Pt
Eh
"}
