//MAP CONVERTED BY dmm2tgm.py THIS HEADER COMMENT PREVENTS RECONVERSION, DO NOT REMOVE
"aR" = (
/turf/simulated/floor/twotone/black,
/area/space)
"bo" = (
/obj/machinery/light/incandescent/cool/very{
	dir = 4;
	pixel_x = 10
	},
/turf/simulated/floor,
/area/space)
"dk" = (
/obj/wingrille_spawn/auto/reinforced,
/obj/structure/woodwall{
	icon_state = "woodwall2"
	},
/turf/simulated/floor/plating,
/area/space)
"dI" = (
/obj/decal/poster/wallsign/stencil/left/r,
/obj/decal/poster/wallsign/stencil/right/r,
/turf/simulated/wall/auto/jen/green,
/area/space)
"en" = (
/turf/simulated/floor/wood/three,
/area/space)
"ep" = (
/obj/submachine/ATM/atm_alt{
	dir = 8
	},
/turf/simulated/floor/wood/three,
/area/space)
"fe" = (
/obj/stool/chair/wooden{
	dir = 1
	},
/turf/simulated/floor/carpet/grime,
/area/space)
"fz" = (
/obj/submachine/laundry_machine,
/obj/machinery/light/incandescent/cool/very{
	dir = 4;
	pixel_x = 10
	},
/turf/simulated/floor/twotone/green,
/area/space)
"gw" = (
/obj/lattice{
	icon_state = "lattice-dir";
	dir = 9
	},
/obj/machinery/light/runway_light/delay2,
/turf/variableTurf/clear,
/area/noGenerate)
"gR" = (
/obj/table/wood/auto/desk,
/obj/machinery/computer3/luggable/personal{
	pixel_y = 8
	},
/turf/simulated/floor/carpet/grime,
/area/space)
"gZ" = (
/obj/machinery/light/small{
	dir = 4;
	pixel_x = 10
	},
/turf/simulated/floor/twotone/black,
/area/space)
"iC" = (
/obj/lattice,
/turf/variableTurf/clear,
/area/noGenerate)
"iX" = (
/obj/submachine/laundry_machine,
/turf/simulated/floor/twotone/black,
/area/space)
"jW" = (
/obj/submachine/laundry_machine,
/obj/machinery/light/small{
	dir = 8;
	pixel_x = -10
	},
/turf/simulated/floor/twotone/black,
/area/space)
"kS" = (
/obj/machinery/door/airlock/pyro/glass{
	name = "Larry's laundry"
	},
/turf/simulated/floor,
/area/space)
"mg" = (
/obj/table/auto,
/turf/simulated/floor/wood/three,
/area/space)
"mj" = (
/obj/machinery/door/unpowered/wood/pyro{
	dir = 4;
	locked = 1
	},
/turf/simulated/floor/plating,
/area/space)
"nb" = (
/obj/machinery/light/incandescent/cool/very{
	dir = 8;
	pixel_x = -10
	},
/turf/simulated/floor/wood/three,
/area/space)
"nU" = (
/obj/table/wood/auto,
/obj/machinery/coffeemaker,
/obj/drink_rack/mug{
	pixel_y = 28
	},
/obj/machinery/light/incandescent/cool/very{
	dir = 4;
	pixel_x = 10
	},
/turf/simulated/floor/carpet/grime,
/area/space)
"ox" = (
/obj/table/auto,
/obj/item/spacecash/random{
	pixel_y = -2;
	pixel_x = 5
	},
/obj/item/spacecash/random{
	pixel_y = 4;
	pixel_x = -3
	},
/obj/item/spacecash/random{
	pixel_y = 11;
	pixel_x = -5
	},
/obj/item/spacecash/random{
	pixel_y = 5;
	pixel_x = 6
	},
/obj/item/spacecash/random{
	pixel_y = 12;
	pixel_x = 4
	},
/obj/item/spacecash/random{
	pixel_y = 8;
	pixel_x = -4
	},
/obj/machinery/light/small{
	dir = 8;
	pixel_x = -10
	},
/turf/simulated/floor/twotone/black,
/area/space)
"oM" = (
/obj/table/auto,
/turf/simulated/floor/twotone/black,
/area/space)
"oO" = (
/obj/decal/tile_edge/stripe{
	dir = 10;
	icon_state = "xtra_bigstripe-edge"
	},
/turf/simulated/floor/shuttlebay,
/area/space)
"pg" = (
/obj/machinery/light/incandescent/cool/very{
	dir = 4;
	pixel_x = 10
	},
/turf/simulated/floor/wood/three,
/area/space)
"pC" = (
/obj/stool/chair/office/red,
/turf/simulated/floor/carpet/grime,
/area/space)
"qS" = (
/obj/lattice{
	dir = 1;
	icon_state = "lattice-dir-b"
	},
/obj/machinery/light/runway_light,
/turf/variableTurf/clear,
/area/noGenerate)
"rk" = (
/turf/simulated/floor/carpet/grime,
/area/space)
"sl" = (
/obj/machinery/vending/coffee,
/turf/simulated/floor/wood/three,
/area/space)
"sJ" = (
/turf/simulated/wall/auto/jen/green,
/area/space)
"sQ" = (
/obj/wingrille_spawn/auto/reinforced,
/turf/simulated/floor/plating,
/area/space)
"tk" = (
/obj/decoration/decorativeplant/plant7,
/obj/machinery/light/incandescent/cool/very{
	dir = 8;
	pixel_x = -10
	},
/turf/simulated/floor/carpet/grime,
/area/space)
"tl" = (
/turf/simulated/floor/twotone/green,
/area/space)
"tY" = (
/obj/table/glass/auto,
/turf/simulated/floor/wood/three,
/area/space)
"uk" = (
/obj/random_pod_spawner/random_putt_spawner,
/turf/simulated/floor/shuttlebay,
/area/space)
"uA" = (
/obj/lattice{
	dir = 1;
	icon_state = "lattice-dir"
	},
/turf/variableTurf/clear,
/area/noGenerate)
"va" = (
/obj/wingrille_spawn/auto/reinforced,
/obj/structure/woodwall,
/turf/simulated/floor/plating,
/area/space)
"wT" = (
/obj/machinery/light/small/floor,
/turf/simulated/floor/shuttlebay,
/area/space)
"xF" = (
/obj/machinery/door/airlock/pyro,
/turf/simulated/floor/plating,
/area/space)
"ya" = (
/obj/machinery/door/airlock/pyro/external{
	name = "Larry's laundry"
	},
/turf/simulated/floor,
/area/space)
"yg" = (
/obj/stool/bench/blue/auto,
/turf/simulated/floor/wood/three,
/area/space)
"yX" = (
/obj/machinery/light/incandescent/cool/very{
	dir = 8;
	pixel_x = -10
	},
/turf/simulated/floor,
/area/space)
"BG" = (
/obj/grille/catwalk{
	dir = 4
	},
/turf/simulated/floor/airless/plating/catwalk/auto,
/area/space)
"Cb" = (
/obj/decal/poster/wallsign/stencil/left/y,
/obj/decal/poster/wallsign/stencil/right/s,
/turf/simulated/wall/auto/jen/green,
/area/space)
"CB" = (
/obj/submachine/laundry_machine,
/obj/machinery/light/incandescent/cool/very{
	dir = 8;
	pixel_x = -10
	},
/turf/simulated/floor/twotone/green,
/area/space)
"DU" = (
/obj/table/wood/auto/desk,
/obj/item/device/key/generic,
/turf/simulated/floor/carpet/grime,
/area/space)
"EV" = (
/obj/lattice{
	dir = 1;
	icon_state = "lattice-dir"
	},
/obj/machinery/light/runway_light/delay2,
/turf/variableTurf/clear,
/area/noGenerate)
"Fb" = (
/turf/space,
/area/space)
"Ff" = (
/turf/simulated/floor/stairs{
	dir = 8
	},
/area/space)
"Fv" = (
/obj/lattice{
	icon_state = "lattice-dir";
	dir = 8
	},
/turf/variableTurf/clear,
/area/noGenerate)
"Gd" = (
/obj/decal/poster/wallsign/stencil/left/l,
/obj/decal/poster/wallsign/stencil/right/a,
/turf/simulated/wall/auto/jen/green,
/area/space)
"Gx" = (
/turf/variableTurf/clear,
/area/noGenerate)
"GW" = (
/obj/table/auto,
/obj/bedsheetbin,
/turf/simulated/floor/twotone/green,
/area/space)
"Je" = (
/obj/lattice{
	dir = 6;
	icon_state = "lattice-dir"
	},
/turf/variableTurf/clear,
/area/noGenerate)
"JK" = (
/turf/simulated/floor/shuttlebay,
/area/space)
"JW" = (
/obj/stool/chair/office/blue{
	dir = 8
	},
/turf/simulated/floor/carpet/grime,
/area/space)
"Kr" = (
/obj/table/wood/auto,
/turf/simulated/floor/carpet/grime,
/area/space)
"KP" = (
/obj/table/wood/auto/desk,
/obj/machinery/computer3/generic/personal,
/obj/machinery/light/incandescent/cool/very{
	dir = 8;
	pixel_x = -10
	},
/turf/simulated/floor/carpet/grime,
/area/space)
"Lq" = (
/obj/decal/tile_edge/stripe{
	dir = 9;
	icon_state = "xtra_bigstripe-edge"
	},
/turf/simulated/floor/shuttlebay,
/area/space)
"LB" = (
/obj/table/wood/auto/desk,
/obj/decoration/decorativeplant/plant3{
	pixel_y = 5;
	pixel_x = -5
	},
/obj/machinery/light/incandescent/cool/very{
	dir = 1;
	pixel_y = 21
	},
/turf/simulated/floor/carpet/grime,
/area/space)
"Nc" = (
/obj/lattice{
	icon_state = "lattice-dir"
	},
/turf/variableTurf/clear,
/area/noGenerate)
"Oh" = (
/obj/submachine/laundry_machine,
/turf/simulated/floor/twotone/green,
/area/space)
"QV" = (
/obj/table/wood/auto/desk,
/obj/decoration/decorativeplant/plant4{
	pixel_y = 12;
	pixel_x = 4
	},
/turf/simulated/floor/carpet/grime,
/area/space)
"Ua" = (
/obj/window/cubicle{
	dir = 4;
	icon_state = "cubicle"
	},
/turf/simulated/floor/carpet/grime,
/area/space)
"Uv" = (
/obj/table/wood/auto/desk,
/turf/simulated/floor/carpet/grime,
/area/space)
"WJ" = (
/obj/table/glass/auto,
/obj/decoration/decorativeplant/plant6{
	pixel_y = 12;
	pixel_x = 2
	},
/turf/simulated/floor/wood/three,
/area/space)
"WK" = (
/obj/decal/tile_edge/stripe{
	dir = 6;
	icon_state = "xtra_bigstripe-edge"
	},
/turf/simulated/floor/shuttlebay,
/area/space)
"XW" = (
/obj/machinery/light/incandescent/cool/very,
/turf/simulated/floor/carpet/grime,
/area/space)
"YD" = (
/obj/decal/tile_edge/stripe{
	dir = 5;
	icon_state = "xtra_bigstripe-edge"
	},
/turf/simulated/floor/shuttlebay,
/area/space)

(1,1,1) = {"
Fb
Fb
Fb
Fb
Fb
Fb
Fb
Fb
Fb
Fb
Fb
Fb
Fb
Fb
Fb
Fb
Fb
Fb
Fb
Fb
Fb
Fb
Fb
Fb
Fb
Fb
Fb
Fb
Fb
Fb
Fb
Fb
Fb
Fb
Fb
Fb
Fb
Fb
Fb
Fb
Fb
Fb
Fb
Fb
Fb
Fb
Fb
Fb
Fb
Fb
Fb
Fb
Fb
Fb
Fb
Fb
Fb
Fb
Fb
Fb
"}
(2,1,1) = {"
Fb
Fb
Fb
Fb
Fb
Fb
Fb
Fb
Fb
Fb
Fb
Fb
Fb
Fb
Fb
Fb
Fb
Fb
Fb
Fb
Fb
Fb
Fb
Fb
Fb
Fb
Fb
Fb
Fb
Fb
Fb
Fb
Fb
Fb
Fb
Fb
Fb
Fb
Fb
Fb
Fb
Fb
Fb
Fb
Fb
Fb
Fb
Fb
Fb
Fb
Fb
Fb
Fb
Fb
Fb
Fb
Fb
Fb
Fb
Fb
"}
(3,1,1) = {"
Fb
Fb
Fb
Fb
Fb
Fb
Fb
Fb
Fb
Fb
Fb
Fb
Fb
Fb
Fb
Fb
Fb
Fb
Fb
Fb
Fb
Fb
Fb
Fb
Fb
Fb
Fb
Fb
Fb
Fb
Fb
Fb
Fb
Fb
Fb
Fb
Fb
Fb
Fb
Fb
Fb
Fb
Fb
Fb
Fb
Fb
Fb
Fb
Fb
Fb
Fb
Fb
Fb
Fb
Fb
Fb
Fb
Fb
Fb
Fb
"}
(4,1,1) = {"
Fb
Fb
Fb
Fb
Fb
Fb
Fb
Fb
Fb
Fb
Fb
Fb
Fb
Fb
Fb
Fb
Fb
Fb
Fb
Fb
Fb
Fb
Fb
Fb
Fb
Fb
Fb
Fb
Fb
Fb
Fb
Fb
Fb
Fb
Fb
Fb
Fb
Fb
Fb
Fb
Fb
Fb
Fb
Fb
Fb
Fb
Fb
Fb
Fb
Fb
Fb
Fb
Fb
Fb
Fb
Fb
Fb
Fb
Fb
Fb
"}
(5,1,1) = {"
Fb
Fb
Fb
Fb
Fb
Fb
Fb
Fb
Fb
Fb
Fb
Fb
Fb
Fb
Fb
Fb
Fb
Fb
Fb
Fb
Fb
Fb
Fb
Fb
Fb
Fb
Fb
Fb
Fb
Fb
Fb
Fb
Fb
Fb
Fb
Fb
Fb
Fb
Fb
Fb
Fb
Fb
Fb
Fb
Fb
Fb
Fb
Fb
Fb
Fb
Fb
Fb
Fb
Fb
Fb
Fb
Fb
Fb
Fb
Fb
"}
(6,1,1) = {"
Fb
Fb
Fb
Fb
Fb
Fb
Fb
Fb
Fb
Fb
Fb
Fb
Fb
Fb
Fb
Fb
Fb
Fb
Fb
Fb
Fb
Fb
Fb
Fb
Fb
Fb
Fb
Fb
Fb
Fb
Fb
Fb
Fb
Fb
Fb
Fb
Fb
Fb
Fb
Fb
Fb
Fb
Fb
Fb
Fb
Fb
Fb
Fb
Fb
Fb
Fb
Fb
Fb
Fb
Fb
Fb
Fb
Fb
Fb
Fb
"}
(7,1,1) = {"
Fb
Fb
Fb
Fb
Fb
Fb
Fb
Fb
Fb
Fb
Fb
Fb
Fb
Fb
Fb
Fb
Fb
Fb
Fb
Fb
Fb
Fb
Fb
Fb
Fb
Fb
Fb
Fb
Fb
Fb
Fb
Fb
Fb
Fb
Fb
Fb
Fb
Fb
Fb
Fb
Fb
Fb
Fb
Fb
Fb
Fb
Fb
Fb
Fb
Fb
Fb
Fb
Fb
Fb
Fb
Fb
Fb
Fb
Fb
Fb
"}
(8,1,1) = {"
Fb
Fb
Fb
Fb
Fb
Fb
Fb
Fb
Fb
Fb
Fb
Fb
Fb
Fb
Fb
Fb
Fb
Fb
Fb
Fb
Fb
Fb
Fb
Fb
Fb
Fb
Fb
Fb
Fb
Fb
Fb
Fb
Fb
Fb
Fb
Fb
Fb
Fb
Fb
Fb
Fb
Fb
Fb
Fb
Fb
Fb
Fb
Fb
Fb
Fb
Fb
Fb
Fb
Fb
Fb
Fb
Fb
Fb
Fb
Fb
"}
(9,1,1) = {"
Fb
Fb
Fb
Fb
Fb
Fb
Fb
Fb
Fb
Fb
Fb
Fb
Fb
Fb
Fb
Fb
Fb
Fb
Fb
Fb
Fb
Fb
Fb
Fb
Fb
Fb
Fb
Fb
Fb
Fb
Fb
Fb
Fb
Fb
Fb
Fb
Fb
Fb
Fb
Fb
Fb
Fb
Fb
Fb
Fb
Fb
Fb
Fb
Fb
Fb
Fb
Fb
Fb
Fb
Fb
Fb
Fb
Fb
Fb
Fb
"}
(10,1,1) = {"
Fb
Fb
Fb
Fb
Fb
Fb
Fb
Fb
Fb
Fb
Fb
Fb
Fb
Fb
Fb
Fb
Fb
Fb
Fb
Fb
Fb
Fb
Fb
Fb
Fb
Fb
Fb
Fb
Fb
Fb
Fb
Fb
Fb
Fb
Fb
Fb
Fb
Fb
Fb
Fb
Fb
Fb
Fb
Fb
Fb
Fb
Fb
Fb
Fb
Fb
Fb
Fb
Fb
Fb
Fb
Fb
Fb
Fb
Fb
Fb
"}
(11,1,1) = {"
Fb
Fb
Fb
Fb
Fb
Fb
Fb
Fb
Fb
Fb
Fb
Fb
Fb
Fb
Fb
Fb
Fb
Fb
Fb
Fb
Fb
Fb
Fb
Fb
Fb
Fb
Fb
Fb
Fb
Fb
Fb
Fb
Fb
Fb
Fb
Fb
Fb
Fb
Fb
Fb
Fb
Fb
Fb
Fb
Fb
Fb
Fb
Fb
Fb
Fb
Fb
Fb
Fb
Fb
Fb
Fb
Fb
Fb
Fb
Fb
"}
(12,1,1) = {"
Fb
Fb
Fb
Fb
Fb
Fb
Fb
Fb
Fb
Fb
Fb
Fb
Fb
Fb
Fb
Fb
Fb
Fb
Fb
Fb
Fb
Fb
Fb
Fb
Fb
Fb
Fb
Fb
Fb
Fb
Fb
Fb
Fb
Fb
Fb
Fb
Fb
Fb
Fb
Fb
Fb
Fb
Fb
Fb
Fb
Fb
Fb
Fb
Fb
Fb
Fb
Fb
Fb
Fb
Fb
Fb
Fb
Fb
Fb
Fb
"}
(13,1,1) = {"
Fb
Fb
Fb
Fb
Fb
Fb
Fb
Fb
Fb
Fb
Fb
Fb
Fb
Fb
Fb
Fb
Fb
Fb
Fb
Fb
Fb
Fb
Fb
Fb
Fb
Fb
Fb
Fb
Fb
Fb
Fb
Fb
Fb
Fb
Fb
Fb
Fb
Fb
Fb
Fb
Fb
Fb
Fb
Fb
Fb
Fb
Fb
Fb
Fb
Fb
Fb
Fb
Fb
Fb
Fb
Fb
Fb
Fb
Fb
Fb
"}
(14,1,1) = {"
Fb
Fb
Fb
Fb
Fb
Fb
Fb
Fb
Fb
Fb
Fb
Fb
Fb
Fb
Fb
Fb
Fb
Fb
Fb
Fb
Fb
Fb
Fb
Fb
Fb
Fb
Fb
Fb
Fb
Fb
Fb
Fb
Fb
Fb
Fb
Fb
Fb
Fb
Fb
Fb
Fb
Fb
Fb
Fb
Fb
Fb
Fb
Fb
Fb
Fb
Fb
Fb
Fb
Fb
Fb
Fb
Fb
Fb
Fb
Fb
"}
(15,1,1) = {"
Fb
Fb
Fb
Fb
Fb
Fb
Fb
Fb
Fb
Fb
Fb
Fb
Fb
Fb
Fb
Fb
Fb
Fb
Fb
Fb
Fb
Fb
Fb
Fb
Fb
Fb
Fb
Fb
Fb
Fb
Fb
Fb
Fb
Fb
Fb
Fb
Fb
Fb
Fb
Fb
Fb
Fb
Fb
Fb
Fb
Fb
Fb
Fb
Fb
Fb
Fb
Fb
Fb
Fb
Fb
Fb
Fb
Fb
Fb
Fb
"}
(16,1,1) = {"
Fb
Fb
Fb
Fb
Fb
Fb
Fb
Fb
Fb
Fb
Fb
Fb
Fb
Fb
Fb
Fb
Fb
Fb
Fb
Fb
Fb
Gx
Gx
Gx
Gx
Gx
Gx
Gx
Gx
Gx
Gx
Gx
Gx
Gx
Gx
Gx
Gx
Gx
Gx
Gx
Gx
Gx
Fb
Fb
Fb
Fb
Fb
Fb
Fb
Fb
Fb
Fb
Fb
Fb
Fb
Fb
Fb
Fb
Fb
Fb
"}
(17,1,1) = {"
Fb
Fb
Fb
Fb
Fb
Fb
Fb
Fb
Fb
Fb
Fb
Fb
Fb
Fb
Fb
Fb
Fb
Fb
Fb
Fb
Fb
Gx
Gx
Gx
Gx
Gx
Gx
sJ
sJ
sJ
sJ
sJ
sJ
sJ
Gd
Gx
Gx
Gx
gw
Gx
Gx
Gx
Fb
Fb
Fb
Fb
Fb
Fb
Fb
Fb
Fb
Fb
Fb
Fb
Fb
Fb
Fb
Fb
Fb
Fb
"}
(18,1,1) = {"
Fb
Fb
Fb
Fb
Fb
Fb
Fb
Fb
Fb
Fb
Fb
Fb
Fb
Fb
Fb
Fb
Fb
Fb
Fb
Fb
Fb
Gx
sJ
sJ
sQ
sQ
sJ
sJ
GW
CB
Oh
en
nb
yg
dI
Nc
Je
Lq
JK
oO
Gx
Gx
Fb
Fb
Fb
Fb
Fb
Fb
Fb
Fb
Fb
Fb
Fb
Fb
Fb
Fb
Fb
Fb
Fb
Fb
"}
(19,1,1) = {"
Fb
Fb
Fb
Fb
Fb
Fb
Fb
Fb
Fb
Fb
Fb
Fb
Fb
Fb
Fb
Fb
Fb
Fb
Fb
Fb
Fb
Gx
sJ
KP
Uv
rk
tk
sJ
tl
tl
tl
en
en
yg
Cb
Gx
Fv
JK
wT
JK
Gx
Gx
Fb
Fb
Fb
Fb
Fb
Fb
Fb
Fb
Fb
Fb
Fb
Fb
Fb
Fb
Fb
Fb
Fb
Fb
"}
(20,1,1) = {"
Fb
Fb
Fb
Fb
Fb
Fb
Fb
Fb
Fb
Fb
Fb
Fb
Fb
Fb
Fb
Fb
Fb
Fb
Fb
Fb
Fb
Gx
sJ
JW
DU
rk
fe
sJ
tl
tl
tl
en
en
yg
sQ
Gx
Fv
JK
uk
JK
Gx
Gx
Fb
Fb
Fb
Fb
Fb
Fb
Fb
Fb
Fb
Fb
Fb
Fb
Fb
Fb
Fb
Fb
Fb
Fb
"}
(21,1,1) = {"
Fb
Fb
Fb
Fb
Fb
Fb
Fb
Fb
Fb
Fb
Fb
Fb
Fb
Fb
Fb
Fb
Fb
Fb
Fb
Fb
Fb
Gx
sJ
rk
QV
rk
fe
sJ
Oh
fz
Oh
en
en
WJ
sQ
Gx
Fv
JK
wT
JK
Gx
Gx
Fb
Fb
Fb
Fb
Fb
Fb
Fb
Fb
Fb
Fb
Fb
Fb
Fb
Fb
Fb
Fb
Fb
Fb
"}
(22,1,1) = {"
Fb
Fb
Fb
Fb
Fb
Fb
Fb
Fb
Fb
Fb
Fb
Fb
Fb
Fb
Fb
Fb
Fb
Fb
Fb
Fb
Fb
Gx
sJ
Ua
Ua
rk
rk
sJ
sJ
sQ
sQ
en
en
sQ
sQ
sQ
iC
YD
JK
WK
Je
qS
Fb
Fb
Fb
Fb
Fb
Fb
Fb
Fb
Fb
Fb
Fb
Fb
Fb
Fb
Fb
Fb
Fb
Fb
"}
(23,1,1) = {"
Fb
Fb
Fb
Fb
Fb
Fb
Fb
Fb
Fb
Fb
Fb
Fb
Fb
Fb
Fb
Fb
Fb
Fb
Fb
Fb
Fb
Gx
sJ
LB
Uv
rk
XW
sJ
mg
nb
en
en
en
kS
yX
ya
BG
BG
BG
BG
BG
Gx
Fb
Fb
Fb
Fb
Fb
Fb
Fb
Fb
Fb
Fb
Fb
Fb
Fb
Fb
Fb
Fb
Fb
Fb
"}
(24,1,1) = {"
Fb
Fb
Fb
Fb
Fb
Fb
Fb
Fb
Fb
Fb
Fb
Fb
Fb
Fb
Fb
Fb
Fb
Fb
Fb
Fb
Fb
Gx
sJ
pC
gR
rk
rk
sJ
sl
en
en
en
en
kS
bo
ya
BG
BG
BG
BG
BG
Gx
Fb
Fb
Fb
Fb
Fb
Fb
Fb
Fb
Fb
Fb
Fb
Fb
Fb
Fb
Fb
Fb
Fb
Fb
"}
(25,1,1) = {"
Fb
Fb
Fb
Fb
Fb
Fb
Fb
Fb
Fb
Fb
Fb
Fb
Fb
Fb
Fb
Fb
Fb
Fb
Fb
Fb
Fb
Gx
sJ
rk
Uv
rk
rk
xF
en
en
en
en
en
sQ
sQ
sQ
uA
uA
EV
uA
uA
qS
Fb
Fb
Fb
Fb
Fb
Fb
Fb
Fb
Fb
Fb
Fb
Fb
Fb
Fb
Fb
Fb
Fb
Fb
"}
(26,1,1) = {"
Fb
Fb
Fb
Fb
Fb
Fb
Fb
Fb
Fb
Fb
Fb
Fb
Fb
Fb
Fb
Fb
Fb
Fb
Fb
Fb
Fb
Gx
sJ
rk
rk
rk
rk
sJ
en
pg
ep
ep
pg
tY
sJ
Gx
Gx
Gx
Gx
Gx
Gx
Gx
Fb
Fb
Fb
Fb
Fb
Fb
Fb
Fb
Fb
Fb
Fb
Fb
Fb
Fb
Fb
Fb
Fb
Fb
"}
(27,1,1) = {"
Fb
Fb
Fb
Fb
Fb
Fb
Fb
Fb
Fb
Fb
Fb
Fb
Fb
Fb
Fb
Fb
Fb
Fb
Fb
Fb
Fb
Gx
sJ
nU
Kr
rk
rk
sJ
sJ
sJ
sJ
sJ
sJ
sJ
sJ
Gx
Gx
Gx
Gx
Gx
Gx
Gx
Fb
Fb
Fb
Fb
Fb
Fb
Fb
Fb
Fb
Fb
Fb
Fb
Fb
Fb
Fb
Fb
Fb
Fb
"}
(28,1,1) = {"
Fb
Fb
Fb
Fb
Fb
Fb
Fb
Fb
Fb
Fb
Fb
Fb
Fb
Fb
Fb
Fb
Fb
Fb
Fb
Fb
Fb
Gx
sJ
sJ
sJ
sJ
mj
sJ
iX
jW
iX
ox
oM
sJ
Gx
Gx
Gx
Gx
Gx
Gx
Gx
Gx
Fb
Fb
Fb
Fb
Fb
Fb
Fb
Fb
Fb
Fb
Fb
Fb
Fb
Fb
Fb
Fb
Fb
Fb
"}
(29,1,1) = {"
Fb
Fb
Fb
Fb
Fb
Fb
Fb
Fb
Fb
Fb
Fb
Fb
Fb
Fb
Fb
Fb
Fb
Fb
Fb
Fb
Fb
Gx
Gx
Gx
Gx
sJ
Ff
sJ
aR
aR
aR
aR
aR
sJ
Gx
Gx
Gx
Gx
Gx
Gx
Gx
Gx
Fb
Fb
Fb
Fb
Fb
Fb
Fb
Fb
Fb
Fb
Fb
Fb
Fb
Fb
Fb
Fb
Fb
Fb
"}
(30,1,1) = {"
Fb
Fb
Fb
Fb
Fb
Fb
Fb
Fb
Fb
Fb
Fb
Fb
Fb
Fb
Fb
Fb
Fb
Fb
Fb
Fb
Fb
Gx
Gx
Gx
Gx
sJ
aR
aR
aR
aR
aR
aR
aR
sJ
Gx
Gx
Gx
Gx
Gx
Gx
Gx
Gx
Fb
Fb
Fb
Fb
Fb
Fb
Fb
Fb
Fb
Fb
Fb
Fb
Fb
Fb
Fb
Fb
Fb
Fb
"}
(31,1,1) = {"
Fb
Fb
Fb
Fb
Fb
Fb
Fb
Fb
Fb
Fb
Fb
Fb
Fb
Fb
Fb
Fb
Fb
Fb
Fb
Fb
Fb
Gx
Gx
Gx
Gx
sJ
aR
gZ
aR
aR
aR
gZ
aR
sJ
Gx
Gx
Gx
Gx
Gx
Gx
Gx
Gx
Fb
Fb
Fb
Fb
Fb
Fb
Fb
Fb
Fb
Fb
Fb
Fb
Fb
Fb
Fb
Fb
Fb
Fb
"}
(32,1,1) = {"
Fb
Fb
Fb
Fb
Fb
Fb
Fb
Fb
Fb
Fb
Fb
Fb
Fb
Fb
Fb
Fb
Fb
Fb
Fb
Fb
Fb
Gx
Gx
Gx
Gx
sJ
sJ
sJ
va
va
dk
sJ
sJ
sJ
Gx
Gx
Gx
Gx
Gx
Gx
Gx
Gx
Fb
Fb
Fb
Fb
Fb
Fb
Fb
Fb
Fb
Fb
Fb
Fb
Fb
Fb
Fb
Fb
Fb
Fb
"}
(33,1,1) = {"
Fb
Fb
Fb
Fb
Fb
Fb
Fb
Fb
Fb
Fb
Fb
Fb
Fb
Fb
Fb
Fb
Fb
Fb
Fb
Fb
Fb
Gx
Gx
Gx
Gx
Gx
Gx
Gx
Gx
Gx
Gx
Gx
Gx
Gx
Gx
Gx
Gx
Gx
Gx
Gx
Gx
Gx
Fb
Fb
Fb
Fb
Fb
Fb
Fb
Fb
Fb
Fb
Fb
Fb
Fb
Fb
Fb
Fb
Fb
Fb
"}
(34,1,1) = {"
Fb
Fb
Fb
Fb
Fb
Fb
Fb
Fb
Fb
Fb
Fb
Fb
Fb
Fb
Fb
Fb
Fb
Fb
Fb
Fb
Fb
Fb
Fb
Fb
Fb
Fb
Fb
Fb
Fb
Fb
Fb
Fb
Fb
Fb
Fb
Fb
Fb
Fb
Fb
Fb
Fb
Fb
Fb
Fb
Fb
Fb
Fb
Fb
Fb
Fb
Fb
Fb
Fb
Fb
Fb
Fb
Fb
Fb
Fb
Fb
"}
(35,1,1) = {"
Fb
Fb
Fb
Fb
Fb
Fb
Fb
Fb
Fb
Fb
Fb
Fb
Fb
Fb
Fb
Fb
Fb
Fb
Fb
Fb
Fb
Fb
Fb
Fb
Fb
Fb
Fb
Fb
Fb
Fb
Fb
Fb
Fb
Fb
Fb
Fb
Fb
Fb
Fb
Fb
Fb
Fb
Fb
Fb
Fb
Fb
Fb
Fb
Fb
Fb
Fb
Fb
Fb
Fb
Fb
Fb
Fb
Fb
Fb
Fb
"}
(36,1,1) = {"
Fb
Fb
Fb
Fb
Fb
Fb
Fb
Fb
Fb
Fb
Fb
Fb
Fb
Fb
Fb
Fb
Fb
Fb
Fb
Fb
Fb
Fb
Fb
Fb
Fb
Fb
Fb
Fb
Fb
Fb
Fb
Fb
Fb
Fb
Fb
Fb
Fb
Fb
Fb
Fb
Fb
Fb
Fb
Fb
Fb
Fb
Fb
Fb
Fb
Fb
Fb
Fb
Fb
Fb
Fb
Fb
Fb
Fb
Fb
Fb
"}
(37,1,1) = {"
Fb
Fb
Fb
Fb
Fb
Fb
Fb
Fb
Fb
Fb
Fb
Fb
Fb
Fb
Fb
Fb
Fb
Fb
Fb
Fb
Fb
Fb
Fb
Fb
Fb
Fb
Fb
Fb
Fb
Fb
Fb
Fb
Fb
Fb
Fb
Fb
Fb
Fb
Fb
Fb
Fb
Fb
Fb
Fb
Fb
Fb
Fb
Fb
Fb
Fb
Fb
Fb
Fb
Fb
Fb
Fb
Fb
Fb
Fb
Fb
"}
(38,1,1) = {"
Fb
Fb
Fb
Fb
Fb
Fb
Fb
Fb
Fb
Fb
Fb
Fb
Fb
Fb
Fb
Fb
Fb
Fb
Fb
Fb
Fb
Fb
Fb
Fb
Fb
Fb
Fb
Fb
Fb
Fb
Fb
Fb
Fb
Fb
Fb
Fb
Fb
Fb
Fb
Fb
Fb
Fb
Fb
Fb
Fb
Fb
Fb
Fb
Fb
Fb
Fb
Fb
Fb
Fb
Fb
Fb
Fb
Fb
Fb
Fb
"}
(39,1,1) = {"
Fb
Fb
Fb
Fb
Fb
Fb
Fb
Fb
Fb
Fb
Fb
Fb
Fb
Fb
Fb
Fb
Fb
Fb
Fb
Fb
Fb
Fb
Fb
Fb
Fb
Fb
Fb
Fb
Fb
Fb
Fb
Fb
Fb
Fb
Fb
Fb
Fb
Fb
Fb
Fb
Fb
Fb
Fb
Fb
Fb
Fb
Fb
Fb
Fb
Fb
Fb
Fb
Fb
Fb
Fb
Fb
Fb
Fb
Fb
Fb
"}
(40,1,1) = {"
Fb
Fb
Fb
Fb
Fb
Fb
Fb
Fb
Fb
Fb
Fb
Fb
Fb
Fb
Fb
Fb
Fb
Fb
Fb
Fb
Fb
Fb
Fb
Fb
Fb
Fb
Fb
Fb
Fb
Fb
Fb
Fb
Fb
Fb
Fb
Fb
Fb
Fb
Fb
Fb
Fb
Fb
Fb
Fb
Fb
Fb
Fb
Fb
Fb
Fb
Fb
Fb
Fb
Fb
Fb
Fb
Fb
Fb
Fb
Fb
"}
(41,1,1) = {"
Fb
Fb
Fb
Fb
Fb
Fb
Fb
Fb
Fb
Fb
Fb
Fb
Fb
Fb
Fb
Fb
Fb
Fb
Fb
Fb
Fb
Fb
Fb
Fb
Fb
Fb
Fb
Fb
Fb
Fb
Fb
Fb
Fb
Fb
Fb
Fb
Fb
Fb
Fb
Fb
Fb
Fb
Fb
Fb
Fb
Fb
Fb
Fb
Fb
Fb
Fb
Fb
Fb
Fb
Fb
Fb
Fb
Fb
Fb
Fb
"}
(42,1,1) = {"
Fb
Fb
Fb
Fb
Fb
Fb
Fb
Fb
Fb
Fb
Fb
Fb
Fb
Fb
Fb
Fb
Fb
Fb
Fb
Fb
Fb
Fb
Fb
Fb
Fb
Fb
Fb
Fb
Fb
Fb
Fb
Fb
Fb
Fb
Fb
Fb
Fb
Fb
Fb
Fb
Fb
Fb
Fb
Fb
Fb
Fb
Fb
Fb
Fb
Fb
Fb
Fb
Fb
Fb
Fb
Fb
Fb
Fb
Fb
Fb
"}
(43,1,1) = {"
Fb
Fb
Fb
Fb
Fb
Fb
Fb
Fb
Fb
Fb
Fb
Fb
Fb
Fb
Fb
Fb
Fb
Fb
Fb
Fb
Fb
Fb
Fb
Fb
Fb
Fb
Fb
Fb
Fb
Fb
Fb
Fb
Fb
Fb
Fb
Fb
Fb
Fb
Fb
Fb
Fb
Fb
Fb
Fb
Fb
Fb
Fb
Fb
Fb
Fb
Fb
Fb
Fb
Fb
Fb
Fb
Fb
Fb
Fb
Fb
"}
(44,1,1) = {"
Fb
Fb
Fb
Fb
Fb
Fb
Fb
Fb
Fb
Fb
Fb
Fb
Fb
Fb
Fb
Fb
Fb
Fb
Fb
Fb
Fb
Fb
Fb
Fb
Fb
Fb
Fb
Fb
Fb
Fb
Fb
Fb
Fb
Fb
Fb
Fb
Fb
Fb
Fb
Fb
Fb
Fb
Fb
Fb
Fb
Fb
Fb
Fb
Fb
Fb
Fb
Fb
Fb
Fb
Fb
Fb
Fb
Fb
Fb
Fb
"}
(45,1,1) = {"
Fb
Fb
Fb
Fb
Fb
Fb
Fb
Fb
Fb
Fb
Fb
Fb
Fb
Fb
Fb
Fb
Fb
Fb
Fb
Fb
Fb
Fb
Fb
Fb
Fb
Fb
Fb
Fb
Fb
Fb
Fb
Fb
Fb
Fb
Fb
Fb
Fb
Fb
Fb
Fb
Fb
Fb
Fb
Fb
Fb
Fb
Fb
Fb
Fb
Fb
Fb
Fb
Fb
Fb
Fb
Fb
Fb
Fb
Fb
Fb
"}
(46,1,1) = {"
Fb
Fb
Fb
Fb
Fb
Fb
Fb
Fb
Fb
Fb
Fb
Fb
Fb
Fb
Fb
Fb
Fb
Fb
Fb
Fb
Fb
Fb
Fb
Fb
Fb
Fb
Fb
Fb
Fb
Fb
Fb
Fb
Fb
Fb
Fb
Fb
Fb
Fb
Fb
Fb
Fb
Fb
Fb
Fb
Fb
Fb
Fb
Fb
Fb
Fb
Fb
Fb
Fb
Fb
Fb
Fb
Fb
Fb
Fb
Fb
"}
(47,1,1) = {"
Fb
Fb
Fb
Fb
Fb
Fb
Fb
Fb
Fb
Fb
Fb
Fb
Fb
Fb
Fb
Fb
Fb
Fb
Fb
Fb
Fb
Fb
Fb
Fb
Fb
Fb
Fb
Fb
Fb
Fb
Fb
Fb
Fb
Fb
Fb
Fb
Fb
Fb
Fb
Fb
Fb
Fb
Fb
Fb
Fb
Fb
Fb
Fb
Fb
Fb
Fb
Fb
Fb
Fb
Fb
Fb
Fb
Fb
Fb
Fb
"}
(48,1,1) = {"
Fb
Fb
Fb
Fb
Fb
Fb
Fb
Fb
Fb
Fb
Fb
Fb
Fb
Fb
Fb
Fb
Fb
Fb
Fb
Fb
Fb
Fb
Fb
Fb
Fb
Fb
Fb
Fb
Fb
Fb
Fb
Fb
Fb
Fb
Fb
Fb
Fb
Fb
Fb
Fb
Fb
Fb
Fb
Fb
Fb
Fb
Fb
Fb
Fb
Fb
Fb
Fb
Fb
Fb
Fb
Fb
Fb
Fb
Fb
Fb
"}
(49,1,1) = {"
Fb
Fb
Fb
Fb
Fb
Fb
Fb
Fb
Fb
Fb
Fb
Fb
Fb
Fb
Fb
Fb
Fb
Fb
Fb
Fb
Fb
Fb
Fb
Fb
Fb
Fb
Fb
Fb
Fb
Fb
Fb
Fb
Fb
Fb
Fb
Fb
Fb
Fb
Fb
Fb
Fb
Fb
Fb
Fb
Fb
Fb
Fb
Fb
Fb
Fb
Fb
Fb
Fb
Fb
Fb
Fb
Fb
Fb
Fb
Fb
"}
(50,1,1) = {"
Fb
Fb
Fb
Fb
Fb
Fb
Fb
Fb
Fb
Fb
Fb
Fb
Fb
Fb
Fb
Fb
Fb
Fb
Fb
Fb
Fb
Fb
Fb
Fb
Fb
Fb
Fb
Fb
Fb
Fb
Fb
Fb
Fb
Fb
Fb
Fb
Fb
Fb
Fb
Fb
Fb
Fb
Fb
Fb
Fb
Fb
Fb
Fb
Fb
Fb
Fb
Fb
Fb
Fb
Fb
Fb
Fb
Fb
Fb
Fb
"}
(51,1,1) = {"
Fb
Fb
Fb
Fb
Fb
Fb
Fb
Fb
Fb
Fb
Fb
Fb
Fb
Fb
Fb
Fb
Fb
Fb
Fb
Fb
Fb
Fb
Fb
Fb
Fb
Fb
Fb
Fb
Fb
Fb
Fb
Fb
Fb
Fb
Fb
Fb
Fb
Fb
Fb
Fb
Fb
Fb
Fb
Fb
Fb
Fb
Fb
Fb
Fb
Fb
Fb
Fb
Fb
Fb
Fb
Fb
Fb
Fb
Fb
Fb
"}
(52,1,1) = {"
Fb
Fb
Fb
Fb
Fb
Fb
Fb
Fb
Fb
Fb
Fb
Fb
Fb
Fb
Fb
Fb
Fb
Fb
Fb
Fb
Fb
Fb
Fb
Fb
Fb
Fb
Fb
Fb
Fb
Fb
Fb
Fb
Fb
Fb
Fb
Fb
Fb
Fb
Fb
Fb
Fb
Fb
Fb
Fb
Fb
Fb
Fb
Fb
Fb
Fb
Fb
Fb
Fb
Fb
Fb
Fb
Fb
Fb
Fb
Fb
"}
(53,1,1) = {"
Fb
Fb
Fb
Fb
Fb
Fb
Fb
Fb
Fb
Fb
Fb
Fb
Fb
Fb
Fb
Fb
Fb
Fb
Fb
Fb
Fb
Fb
Fb
Fb
Fb
Fb
Fb
Fb
Fb
Fb
Fb
Fb
Fb
Fb
Fb
Fb
Fb
Fb
Fb
Fb
Fb
Fb
Fb
Fb
Fb
Fb
Fb
Fb
Fb
Fb
Fb
Fb
Fb
Fb
Fb
Fb
Fb
Fb
Fb
Fb
"}
(54,1,1) = {"
Fb
Fb
Fb
Fb
Fb
Fb
Fb
Fb
Fb
Fb
Fb
Fb
Fb
Fb
Fb
Fb
Fb
Fb
Fb
Fb
Fb
Fb
Fb
Fb
Fb
Fb
Fb
Fb
Fb
Fb
Fb
Fb
Fb
Fb
Fb
Fb
Fb
Fb
Fb
Fb
Fb
Fb
Fb
Fb
Fb
Fb
Fb
Fb
Fb
Fb
Fb
Fb
Fb
Fb
Fb
Fb
Fb
Fb
Fb
Fb
"}
(55,1,1) = {"
Fb
Fb
Fb
Fb
Fb
Fb
Fb
Fb
Fb
Fb
Fb
Fb
Fb
Fb
Fb
Fb
Fb
Fb
Fb
Fb
Fb
Fb
Fb
Fb
Fb
Fb
Fb
Fb
Fb
Fb
Fb
Fb
Fb
Fb
Fb
Fb
Fb
Fb
Fb
Fb
Fb
Fb
Fb
Fb
Fb
Fb
Fb
Fb
Fb
Fb
Fb
Fb
Fb
Fb
Fb
Fb
Fb
Fb
Fb
Fb
"}
(56,1,1) = {"
Fb
Fb
Fb
Fb
Fb
Fb
Fb
Fb
Fb
Fb
Fb
Fb
Fb
Fb
Fb
Fb
Fb
Fb
Fb
Fb
Fb
Fb
Fb
Fb
Fb
Fb
Fb
Fb
Fb
Fb
Fb
Fb
Fb
Fb
Fb
Fb
Fb
Fb
Fb
Fb
Fb
Fb
Fb
Fb
Fb
Fb
Fb
Fb
Fb
Fb
Fb
Fb
Fb
Fb
Fb
Fb
Fb
Fb
Fb
Fb
"}
(57,1,1) = {"
Fb
Fb
Fb
Fb
Fb
Fb
Fb
Fb
Fb
Fb
Fb
Fb
Fb
Fb
Fb
Fb
Fb
Fb
Fb
Fb
Fb
Fb
Fb
Fb
Fb
Fb
Fb
Fb
Fb
Fb
Fb
Fb
Fb
Fb
Fb
Fb
Fb
Fb
Fb
Fb
Fb
Fb
Fb
Fb
Fb
Fb
Fb
Fb
Fb
Fb
Fb
Fb
Fb
Fb
Fb
Fb
Fb
Fb
Fb
Fb
"}
(58,1,1) = {"
Fb
Fb
Fb
Fb
Fb
Fb
Fb
Fb
Fb
Fb
Fb
Fb
Fb
Fb
Fb
Fb
Fb
Fb
Fb
Fb
Fb
Fb
Fb
Fb
Fb
Fb
Fb
Fb
Fb
Fb
Fb
Fb
Fb
Fb
Fb
Fb
Fb
Fb
Fb
Fb
Fb
Fb
Fb
Fb
Fb
Fb
Fb
Fb
Fb
Fb
Fb
Fb
Fb
Fb
Fb
Fb
Fb
Fb
Fb
Fb
"}
(59,1,1) = {"
Fb
Fb
Fb
Fb
Fb
Fb
Fb
Fb
Fb
Fb
Fb
Fb
Fb
Fb
Fb
Fb
Fb
Fb
Fb
Fb
Fb
Fb
Fb
Fb
Fb
Fb
Fb
Fb
Fb
Fb
Fb
Fb
Fb
Fb
Fb
Fb
Fb
Fb
Fb
Fb
Fb
Fb
Fb
Fb
Fb
Fb
Fb
Fb
Fb
Fb
Fb
Fb
Fb
Fb
Fb
Fb
Fb
Fb
Fb
Fb
"}
(60,1,1) = {"
Fb
Fb
Fb
Fb
Fb
Fb
Fb
Fb
Fb
Fb
Fb
Fb
Fb
Fb
Fb
Fb
Fb
Fb
Fb
Fb
Fb
Fb
Fb
Fb
Fb
Fb
Fb
Fb
Fb
Fb
Fb
Fb
Fb
Fb
Fb
Fb
Fb
Fb
Fb
Fb
Fb
Fb
Fb
Fb
Fb
Fb
Fb
Fb
Fb
Fb
Fb
Fb
Fb
Fb
Fb
Fb
Fb
Fb
Fb
Fb
"}
