//MAP CONVERTED BY dmm2tgm.py THIS HEADER COMMENT PREVENTS RECONVERSION, DO NOT REMOVE
"a" = (
/turf/space,
/area/allowGenerate)
"p" = (
/obj/storage/crate/loot/puzzle,
/turf/space,
/area/allowGenerate)

(1,1,1) = {"
a
a
a
"}
(2,1,1) = {"
a
p
a
"}
(3,1,1) = {"
a
a
a
"}
