"ay" = (/obj/machinery/light/incandescent/netural{dir = 8},/turf/simulated/floor/engine,/area/sequesterd_cloner_puzzle)
"aG" = (/obj/machinery/atmospherics/pipe/manifold{dir = 1},/turf/simulated/floor/plating,/area)
"bm" = (/obj/wingrille_spawn/auto/crystal,/turf/simulated/floor/plating,/area)
"co" = (/obj/machinery/power/generatorTemp{desc = "A high efficiency thermoelectric generator. How the heck did this get here?"},/obj/cable{icon_state = "0-10"},/turf/simulated/floor/plating,/area)
"cQ" = (/obj/item/wrench,/turf/simulated/floor/plating,/area)
"dm" = (/obj/machinery/atmospherics/pipe/simple/insulated/cold{dir = 9},/turf/simulated/floor/plating,/area)
"do" = (/mob/living/critter/fermid,/obj/decal/cleanable/eggsplat,/turf/variableTurf/clear,/area/noGenerate)
"dD" = (/obj/cable{icon_state = "1-6"},/turf/simulated/floor/plating,/area)
"dH" = (/turf/simulated/floor/purple/side,/area)
"er" = (/obj/decal/fakeobjects{anchored = 1; desc = "A security camera that is not on but, instead, off."; dir = 4; icon = 'icons/obj/monitors.dmi'; icon_state = "camerax"; name = "security camera"},/obj/decal/cleanable/blood/tracks,/turf/simulated/floor/red/redblackchecker,/area)
"eL" = (/obj/iv_stand,/turf/simulated/floor/red/redblackchecker,/area)
"ff" = (/obj/table/wood/auto,/obj/item/reagent_containers/iv_drip{pixel_x = 7; pixel_y = -4},/obj/item/reagent_containers/iv_drip,/obj/item/reagent_containers/iv_drip{pixel_x = -5; pixel_y = 4},/turf/simulated/floor/red/redblackchecker,/area)
"ge" = (/obj/cable{icon_state = "1-10"},/obj/cable{icon_state = "1-6"},/turf/simulated/floor/yellow/side{dir = 4},/area)
"ht" = (/obj/cable{icon_state = "5-9"},/turf/simulated/floor/purple/side,/area)
"hw" = (/obj/decal/skeleton,/turf/variableTurf/clear,/area/noGenerate)
"hB" = (/turf/variableTurf/clear,/area)
"jk" = (/obj/machinery/light/incandescent/netural,/obj/cable{icon_state = "5-9"},/turf/simulated/floor,/area)
"jJ" = (/obj/machinery/atmospherics/portables_connector{dir = 4},/turf/simulated/floor/plating,/area)
"mm" = (/obj/storage/closet/emergency{pixel_x = -8},/obj/storage/closet/fire{pixel_x = 8},/turf/simulated/floor,/area)
"mY" = (/obj/cable{icon_state = "1-2"},/obj/decal/cleanable/blood/tracks{dir = 10},/turf/simulated/floor/caution/south,/area)
"nO" = (/obj/machinery/atmospherics/binary/passive_gate{dir = 4; on = 1; pixel_y = 1; target_pressure = 1e+031},/turf/simulated/floor/plating,/area)
"nS" = (/obj/securearea{desc = "Careless use of experimental teleportation technology may be hazardous to your health."; name = "Molecular Integrity Hazard"; pixel_y = -4},/turf/simulated/wall/auto/reinforced/supernorn,/area)
"ob" = (/obj/machinery/portable_atmospherics/canister/toxins,/turf/simulated/floor/engine,/area)
"oh" = (/obj/decal/cleanable/blood/gibs/core,/turf/simulated/floor/plating,/area)
"oO" = (/obj/cable{icon_state = "9-10"},/obj/cable{icon_state = "4-9"},/turf/simulated/floor/scorched2,/area)
"oU" = (/obj/decal/fakeobjects{anchored = 1; density = 1; desc = "A large video server. Garish branding reads Subliminal Mission Implanter Mk.2! Now with fewer seizures!"; icon = 'icons/obj/networked.dmi'; icon_state = "tapedrive-p"; name = "video bank"; pixel_x = -7; pixel_y = -1},/turf/simulated/floor/red/redblackchecker,/area)
"pc" = (/obj/item/rods/steel{pixel_y = -9; pixel_x = -6},/obj/machinery/light/incandescent/netural{dir = 1},/turf/simulated/floor/plating,/area)
"pM" = (/obj/machinery/power/data_terminal,/obj/machinery/computer3/terminal/zeta{setup_os_string = "Seq_Cloner"},/obj/machinery/light/incandescent/netural{dir = 1},/obj/cable{icon_state = "0-10"},/turf/simulated/floor/purple/side{dir = 1},/area)
"pR" = (/obj/cable{icon_state = "5-10"},/turf/simulated/floor/yellow/corner,/area)
"pT" = (/obj/machinery/atmospherics/pipe/simple/insulated/cold{dir = 6},/turf/simulated/floor/plating,/area)
"qa" = (/obj/table/auto,/obj/item/storage/firstaid/regular{pixel_x = -6; pixel_y = 2},/obj/item/storage/firstaid/toxin{pixel_y = 2; pixel_x = 7},/obj/decal/fakeobjects{anchored = 1; desc = "A security camera that is not on but, instead, off."; dir = 8; icon = 'icons/obj/monitors.dmi'; icon_state = "camerax"; name = "security camera"},/obj/machinery/light/incandescent/netural{dir = 1},/turf/simulated/floor/bluewhite{dir = 5},/area)
"qk" = (/obj/table/auto,/obj/item/storage/box/butter{pixel_x = 8; pixel_y = -2},/obj/item/storage/box/butter{pixel_x = 8; pixel_y = 11},/obj/item/storage/box/diskbox{pixel_x = -7; pixel_y = 4},/turf/simulated/floor/purple/side{dir = 1},/area)
"rk" = (/turf/simulated/floor/engine,/area)
"rL" = (/obj/item/cable_coil,/turf/simulated/floor,/area)
"rW" = (/obj/storage/secure/closet/command/chief_engineer{locked = 0; pixel_x = -8},/obj/item_dispenser/idcarddispenser{pixel_x = 7},/turf/simulated/floor/yellow/side{dir = 1},/area)
"sb" = (/obj/decal/cleanable/blood/tracks,/turf/simulated/floor/red/redblackchecker,/area)
"tv" = (/obj/decal/cleanable/cobweb,/obj/machinery/networked/storage/tape_drive{bank_id = "Main"; locked = 0; read_only = 1; setup_drive_type = /obj/item/disk/data/tape/seq_cloner_logs},/obj/machinery/power/data_terminal,/obj/cable{icon_state = "0-6"},/turf/simulated/floor/purple/side{dir = 9},/area)
"tI" = (/turf/simulated/wall/auto/reinforced/supernorn,/area)
"tJ" = (/turf/simulated/floor/plating,/area)
"tK" = (/obj/machinery/atmospherics/pipe/simple/insulated{dir = 5},/turf/simulated/floor/plating,/area)
"tW" = (/obj/wingrille_spawn/auto/crystal,/obj/window_blinds/cog2{dir = 8},/turf/simulated/floor/plating,/area)
"ul" = (/obj/item/disk/data/floppy/read_only{desc = "A discarded disk. A serial number was lazily written on, now faded."; name = "discarded floppy"; pixel_y = -7; pixel_x = 3},/obj/item/disk/data/floppy/read_only{desc = "A discarded disk. A serial number was lazily written on, now faded."; name = "discarded floppy"; pixel_x = 12; pixel_y = 6},/obj/cable{icon_state = "2-10"},/obj/cable{icon_state = "4-10"},/obj/decal/cleanable/blood/tracks,/turf/simulated/floor/purple/corner{dir = 8},/area)
"uy" = (/obj/decal/cleanable/blood/tracks{dir = 9},/turf/simulated/floor/engine,/area)
"vg" = (/obj/machinery/light/incandescent/netural,/obj/cable{icon_state = "1-5"},/obj/cable{icon_state = "1-2"; pixel_x = -15},/turf/simulated/floor/purple/side,/area)
"xn" = (/obj/machinery/atmospherics/portables_connector{dir = 8},/turf/simulated/floor/plating,/area)
"xv" = (/obj/stool/chair/comfy/barber_chair{desc = "A chair with auto-release restraint straps. It's in a state of disrepair."; dir = 1; name = "strapped chair"},/turf/simulated/floor/red/redblackchecker,/area)
"xI" = (/obj/decal/fakeobjects/tallsmes,/obj/cable,/turf/simulated/floor/yellow,/area)
"xQ" = (/obj/machinery/door_control{id = "seq_cloner_exit"; name = "proceed"; pixel_x = -8; pixel_y = -22},/obj/machinery/drainage,/obj/item/sponge{pixel_x = -9; pixel_y = 9},/obj/machinery/shower{dir = 4},/turf/simulated/floor/bluewhite{dir = 6},/area)
"xY" = (/obj/item/rods/steel{pixel_x = -5; pixel_y = -4},/obj/decal/cleanable/blood,/turf/simulated/floor/plating,/area)
"ym" = (/obj/cable{icon_state = "5-8"},/turf/simulated/floor/purple/side{dir = 10},/area)
"yt" = (/obj/machinery/atmospherics/pipe/simple/insulated/cold{dir = 10},/obj/item/rods/steel{pixel_x = 7; pixel_y = -8},/turf/simulated/floor/plating,/area)
"yE" = (/obj/table/wood/auto,/obj/item/paper_bin{pixel_x = 6; pixel_y = 6},/obj/item/pen{pixel_y = -3; pixel_x = 3},/obj/item/clipboard{pixel_x = -8; pixel_y = 2},/turf/simulated/floor/red/redblackchecker,/area)
"zd" = (/obj/cable{icon_state = "6-8"},/obj/machinery/door/poddoor/pyro{desc = "An arrow points to the neighboring APC and button."; dir = 4; id = "TEG_test_exit"; name = "test exit gate"},/turf/simulated/floor/yellow/corner,/area/sequesterd_cloner_puzzle)
"zf" = (/obj/decal/fakeobjects/creepytv{desc = "It's a looping video. Instruction on how to setup a T.E.G. and iconography of the Syndicate are interlaced with happy sounds. Then it turns to curel images interlaced with NT logos..."; name = "educational television"},/obj/machinery/light{dir = 1; pixel_y = 21},/turf/simulated/floor/red/redblackchecker,/area)
"zn" = (/turf/simulated/wall/auto/reinforced/supernorn,/area/sequesterd_cloner_puzzle)
"zr" = (/obj/cable{icon_state = "1-2"},/obj/table/wood/auto{pixel_x = -3; pixel_y = 2},/obj/item/device/light/zippo/gold{pixel_x = 3; pixel_y = 6},/obj/item/paper/new_agent_note{pixel_x = -7; pixel_y = 6},/turf/simulated/floor/yellow/side{dir = 5},/area)
"Bk" = (/obj/machinery/vending/snack,/turf/simulated/floor/plating,/area)
"Bv" = (/obj/machinery/door/airlock/pyro/external{dir = 1},/turf/simulated/floor,/area)
"Bz" = (/obj/machinery/light/incandescent/netural{dir = 8},/turf/simulated/floor/yellow/side{dir = 10},/area)
"BJ" = (/obj/machinery/door/poddoor/pyro{density = 0; dir = 4; icon_state = "pdoor0"; id = "seq_privacy"; name = "lockdown gate"; opacity = 0},/obj/cable{icon_state = "4-8"},/turf/simulated/floor/purple/checker,/area)
"Cw" = (/obj/decal/fakeobjects{anchored = 1; density = 1; desc = "A large rack of server modules.  It doesn't seem to be in service."; icon = 'icons/obj/networked.dmi'; icon_state = "server0"; name = "downed server"},/obj/machinery/power/data_terminal,/obj/cable{icon_state = "0-2"},/turf/simulated/floor/purple/side{dir = 1},/area)
"Dg" = (/turf/simulated/floor/engine,/area/sequesterd_cloner_puzzle)
"El" = (/obj/machinery/atmospherics/binary/passive_gate{dir = 8; on = 1; pixel_y = 1; target_pressure = 1e+031},/turf/simulated/floor/plating,/area)
"Em" = (/obj/machinery/atmospherics/pipe/manifold{dir = 1},/obj/item/rods/steel{pixel_y = 1; pixel_x = -5},/turf/simulated/floor/plating,/area)
"EE" = (/turf/variableTurf/clear,/area/noGenerate)
"Fe" = (/obj/machinery/door_control{id = "seq_education_exit"; name = "proceed"; pixel_x = -8; pixel_y = -22},/obj/decal/cleanable/blood/tracks{dir = 6},/turf/simulated/floor/red/redblackchecker,/area)
"FE" = (/obj/machinery/light/small/floor/netural,/turf/simulated/floor,/area)
"Gc" = (/obj/machinery/computer/cloning{dir = 8},/obj/machinery/power/data_terminal,/obj/cable{icon_state = "0-8"},/turf/simulated/floor/purple/side{dir = 5},/area)
"Gg" = (/obj/machinery/sleeper{dir = 4},/turf/simulated/floor/plating,/area)
"Gw" = (/obj/storage/secure/closet/command{locked = 0; open = 1; pixel_x = -8},/turf/simulated/floor/yellow/side{dir = 8},/area)
"GF" = (/obj/cable{icon_state = "4-9"},/obj/cable{icon_state = "2-9"},/obj/decal/cleanable/oil,/turf/simulated/floor/yellow/side{dir = 6},/area)
"GG" = (/obj/storage/crate/furnacefuel,/turf/simulated/floor/engine,/area)
"GO" = (/obj/machinery/atmospherics/pipe/simple/insulated{dir = 6},/obj/item/rods/steel{pixel_x = -6; pixel_y = 6},/turf/simulated/floor/plating,/area)
"HQ" = (/obj/machinery/door/poddoor/pyro{dir = 4; id = "seq_release"; name = "exit gate"},/turf/simulated/floor/plating,/area)
"Jo" = (/obj/cable{icon_state = "6-10"},/obj/decal/cleanable/dirt,/turf/simulated/floor,/area)
"Km" = (/turf/simulated/floor,/area)
"KO" = (/obj/decal/cleanable/dirt,/turf/simulated/floor,/area)
"Lf" = (/obj/item/disk/data/floppy/read_only{desc = "A discarded disk. A serial number was lazily written on, now faded."; name = "discarded floppy"; pixel_y = 7; pixel_x = 9},/obj/item/disk/data/floppy/read_only{desc = "A discarded disk. A serial number was lazily written on, now faded."; name = "discarded floppy"; pixel_x = -1},/obj/cable{icon_state = "0-9"},/obj/cable{icon_state = "0-5"},/obj/cable{icon_state = "0-10"},/obj/cable{icon_state = "0-6"},/obj/cable,/turf/simulated/floor,/area)
"Lh" = (/obj/decal/cleanable/blood/tracks{dir = 5},/turf/simulated/floor/bluewhite{dir = 10},/area)
"Lr" = (/obj/rack,/obj/item/clothing/suit/space/emerg,/obj/item/clothing/head/emerg,/obj/item/clothing/mask/breath,/obj/item/tank/air,/obj/item/device/light/flashlight,/turf/simulated/floor/damaged2,/area)
"LF" = (/obj/machinery/atmospherics/binary/circulatorTemp,/turf/simulated/floor/plating,/area)
"LS" = (/obj/cable{icon_state = "5-9"},/turf/simulated/wall/auto/reinforced/supernorn,/area)
"Me" = (/obj/decal/cleanable/blood/tracks,/obj/machinery/door/airlock/pyro/syndicate{id = "seq_cloner_exit"; name = "reinforced airlock"},/turf/simulated/floor/red/redblackchecker,/area)
"NM" = (/obj/machinery/vending/coffee,/turf/simulated/floor/plating,/area)
"NY" = (/obj/machinery/door_control{id = "seq_cloner_containment"; name = "cloner containment toggle"; pixel_x = 8; pixel_y = -23},/obj/blind_switch/area/south{pixel_y = -22},/obj/decal/cleanable/blood/tracks{dir = 4},/turf/simulated/floor/purple/side{dir = 6},/area)
"Ob" = (/obj/machinery/door_control{id = "seq_release"; pixel_x = 24; pixel_y = 9},/obj/storage/secure/closet/fridge{locked = 0},/obj/item/plant/herb/cannabis/white/spawnable{pixel_x = 9; pixel_y = -6},/obj/item/plant/herb/cannabis/white/spawnable{pixel_x = 9; pixel_y = -1},/obj/item/plant/herb/cannabis/white/spawnable{pixel_x = 9; pixel_y = 4},/obj/item/plant/herb/cannabis/white/spawnable{pixel_y = 9; pixel_x = 9},/obj/item/plant/herb/cannabis/white/spawnable{pixel_y = -6},/obj/item/plant/herb/cannabis/white/spawnable{pixel_y = -1},/obj/item/plant/herb/cannabis/white/spawnable{pixel_y = 4},/obj/item/plant/herb/cannabis/white/spawnable{pixel_y = 9},/obj/item/plant/herb/cannabis/white/spawnable{pixel_x = -9; pixel_y = -6},/obj/item/plant/herb/cannabis/white/spawnable{pixel_x = -9; pixel_y = -1},/obj/item/plant/herb/cannabis/white/spawnable{pixel_x = -9; pixel_y = 4},/obj/item/plant/herb/cannabis/white/spawnable{pixel_x = -9; pixel_y = 9},/turf/simulated/floor/yellow/side{dir = 6},/area)
"OE" = (/obj/cable{icon_state = "5-6"},/obj/cable{icon_state = "5-10"},/turf/simulated/floor/damaged2,/area)
"OY" = (/obj/cable{icon_state = "5-6"},/turf/simulated/floor/yellow/side{dir = 8},/area)
"Pt" = (/obj/machinery/atmospherics/pipe/simple/insulated{dir = 9},/obj/item/rods/steel{pixel_x = -6; pixel_y = -6},/obj/cable{icon_state = "5-10"},/turf/simulated/floor/plating,/area)
"PD" = (/obj/machinery/atmospherics/unary/furnace_connector{dir = 1},/obj/machinery/power/furnace/thermo,/turf/simulated/floor/plating,/area)
"Qy" = (/obj/machinery/clonepod,/obj/machinery/power/data_terminal,/turf/simulated/floor/bluewhite{dir = 9},/area)
"QR" = (/obj/decal/cleanable/blood/tracks{dir = 4},/obj/machinery/door/airlock/pyro/syndicate{id = "seq_education_exit"; name = "reinforced airlock"; dir = 4},/turf/simulated/floor/engine,/area)
"Rp" = (/obj/item/rods/steel{pixel_y = 11; pixel_x = -4},/obj/machinery/light/incandescent/netural,/turf/simulated/floor/plating,/area)
"Rz" = (/obj/machinery/door_control{id = "seq_privacy"; name = "privacy door toggle"; pixel_x = -24; pixel_y = -10},/turf/simulated/floor/purple/side{dir = 8},/area)
"RZ" = (/obj/machinery/atmospherics/binary/circulatorTemp/right{pixel_x = -1},/turf/simulated/floor/plating,/area)
"Sf" = (/obj/machinery/light/incandescent/netural,/obj/cable{icon_state = "5-8"},/turf/simulated/floor/plating,/area)
"SK" = (/obj/item/disk/data/floppy/read_only{desc = "A discarded disk. A serial number was lazily written on, now faded."; name = "discarded floppy"; pixel_x = 4; pixel_y = -8},/obj/item/disk/data/floppy/read_only{desc = "A discarded disk. A serial number was lazily written on, now faded."; name = "discarded floppy"; pixel_x = -7; pixel_y = 4},/obj/cable{icon_state = "2-10"},/turf/simulated/floor,/area)
"SX" = (/obj/machinery/door/poddoor/pyro{dir = 4; id = "seq_cloner_containment"; name = "cloner containment gate"},/obj/decal/cleanable/blood/tracks{dir = 4},/turf/simulated/floor/blue/checker,/area)
"Uf" = (/obj/machinery/vending/monkey{icon_state = "monkey-broken"; status = 1},/turf/simulated/floor/engine,/area)
"Ur" = (/obj/cable{icon_state = "0-9"},/obj/cable{icon_state = "0-6"},/obj/machinery/door_control{id = "TEG_test_exit"; pixel_x = -23; pixel_y = 9},/obj/machinery/power/apc/puzzle_apc{autoname_on_spawn = 0; desc = "A note is attached: To leave, power this APC and press the neighboring button. The APC can be a little slow."; name = "Engine Test APC"; pixel_x = -24; pixel_y = -2; start_charge = 0},/turf/simulated/floor/plating,/area/sequesterd_cloner_puzzle)
"Uu" = (/obj/item/rods/steel{pixel_y = 2},/turf/simulated/floor/plating,/area)
"Ux" = (/obj/machinery/atmospherics/pipe/simple/insulated,/obj/machinery/meter,/turf/simulated/floor/plating,/area)
"Vt" = (/obj/storage/secure/closet/command{locked = 0; open = 1; pixel_x = -8},/obj/storage/secure/closet/command{locked = 0; open = 1; pixel_x = 8},/obj/machinery/light/incandescent/netural{dir = 8},/turf/simulated/floor/yellow/side{dir = 9},/area)
"VE" = (/obj/machinery/atmospherics/pipe/simple/insulated/cold{dir = 1},/obj/machinery/meter,/turf/simulated/floor/plating,/area)
"VK" = (/obj/decal/fakeobjects/teleport_pad,/obj/machinery/door/window{dir = 1},/obj/storage/secure/closet/fridge/kitchen{locked = 0},/obj/machinery/power/data_terminal,/obj/cable,/turf/simulated/floor/caution/misc,/area)
"WE" = (/obj/machinery/light/incandescent/netural{dir = 4},/obj/decal/cleanable/blood/tracks,/turf/simulated/floor/engine,/area)
"WK" = (/obj/machinery/power/data_terminal,/obj/cable{icon_state = "0-2"},/obj/cable{icon_state = "0-8"},/obj/machinery/networked/mainframe/seq_cloner{pixel_x = 5; pixel_y = -2; tag = "Seq_Cloner"},/obj/submachine/slot_machine{pixel_x = -7; pixel_y = -3},/turf/simulated/floor/yellow,/area)
"WS" = (/obj/machinery/atmospherics/pipe/manifold,/turf/simulated/floor/plating,/area)
"WX" = (/turf/simulated/floor/yellow/side{dir = 4},/area)
"XK" = (/obj/cable{icon_state = "2-9"},/obj/item/rods/steel{pixel_y = -7; pixel_x = -8},/turf/simulated/floor/plating,/area)
"XO" = (/obj/machinery/atmospherics/unary/cold_sink/freezer{dir = 1},/turf/simulated/floor/plating,/area)
"XS" = (/obj/stool/chair/yellow{dir = 1},/obj/item/disk/data/floppy/read_only{desc = "A discarded disk. A serial number was lazily written on, now faded."; name = "discarded floppy"; pixel_y = 9; pixel_x = -3},/turf/simulated/floor,/area)
"Yg" = (/obj/item/rods/steel{pixel_y = 1; pixel_x = -5},/obj/cable{icon_state = "4-9"},/turf/simulated/floor/plating,/area)
"ZR" = (/obj/machinery/light/incandescent/netural{dir = 1},/turf/simulated/floor/engine,/area)
"ZS" = (/obj/machinery/clonegrinder,/turf/simulated/floor/purple/side{dir = 5},/area)

(1,1,1) = {"
hBhBhBhBhBEEEEEEhBhBhBhBhBhBhBhBhBhBhBhB
hBhBhBhBhBhwEEdohBhBhBhBhBhBhBhBhBhBhBhB
hBhBhBhBtIbmBvbmtIhBhBhBhBhBhBhBhBhBhBhB
hBtItItItImmFELrtItItItItItItIhBhBhBhBhB
tItItIWKtIbmBvbmtItvCwpMqkZStItItItItIhB
tIVtrWzrtIKmJoKmtIRzLfXSSKulGctWQyqatIhB
tIGwKmgeHQOErLoOBJymdHhtvgmYNYSXLhxQtIhB
tIGwpRObLSKmjkKOtIGgBkNMnSVKnStIMetItItI
tIOYWXtItItItItItItItItItItItItIerzfoUtI
tIBzGFzdDgrkrkZRrkUurkpcrkobrktIsbxvyEtI
tItIxIznUrtJGOEmaGxnpTaGytcQuyQRFeeLfftI
hBtItIznDgXKUxPDLFcoRZXOVEohWEtItItItItI
hBhBtIznaydDtKElPtjJWSnOdmxYUftItIhBhBhB
hBhBhBtItIGGYgSftJtJtJRptJrktItIhBhBhBhB
hBhBhBhBtItItItItItItItItItItIhBhBhBhBhB
"}
