//MAP CONVERTED BY dmm2tgm.py THIS HEADER COMMENT PREVENTS RECONVERSION, DO NOT REMOVE
"aw" = (
/obj/lattice{
	dir = 1;
	icon_state = "lattice-dir-b"
	},
/obj/machinery/light/runway_light,
/turf/variableTurf/clear,
/area/noGenerate)
"az" = (
/obj/decal/cleanable/blood/tracks,
/turf/simulated/floor/twotone/black,
/area/space)
"bE" = (
/obj/item/storage/secure/ssafe/loot,
/turf/simulated/wall/auto/jen/green,
/area/space)
"bU" = (
/obj/lattice{
	dir = 1;
	icon_state = "lattice-dir"
	},
/obj/machinery/light/runway_light/delay2,
/turf/variableTurf/clear,
/area/noGenerate)
"cl" = (
/obj/machinery/vending/coffee,
/turf/simulated/floor/wood/three,
/area/space)
"cN" = (
/obj/lattice{
	dir = 6;
	icon_state = "lattice-dir"
	},
/turf/variableTurf/clear,
/area/noGenerate)
"eL" = (
/obj/decal/tile_edge/stripe{
	dir = 6;
	icon_state = "xtra_bigstripe-edge"
	},
/turf/simulated/floor/shuttlebay,
/area/space)
"ff" = (
/obj/machinery/light/incandescent/cool/very{
	dir = 8;
	pixel_x = -10
	},
/turf/simulated/floor,
/area/space)
"fC" = (
/turf/simulated/floor/twotone/black,
/area/space)
"fZ" = (
/obj/table/wood/auto/desk,
/turf/simulated/floor/carpet/grime,
/area/space)
"hF" = (
/obj/window/cubicle{
	dir = 4;
	icon_state = "cubicle"
	},
/turf/simulated/floor/carpet/grime,
/area/space)
"hZ" = (
/obj/decal/poster/wallsign/stencil/left/y,
/obj/decal/poster/wallsign/stencil/right/s,
/turf/simulated/wall/auto/jen/green,
/area/space)
"iD" = (
/obj/machinery/door/airlock/pyro/glass{
	name = "Larry's laundry"
	},
/turf/simulated/floor,
/area/space)
"iR" = (
/obj/machinery/light/small/floor,
/turf/simulated/floor/shuttlebay,
/area/space)
"kG" = (
/obj/stool/chair/office/blue{
	dir = 8
	},
/turf/simulated/floor/carpet/grime,
/area/space)
"kH" = (
/obj/table/wood/auto,
/obj/machinery/coffeemaker,
/obj/drink_rack/mug{
	pixel_y = 28
	},
/obj/machinery/light/incandescent/cool/very{
	dir = 4;
	pixel_x = 10
	},
/turf/simulated/floor/carpet/grime,
/area/space)
"kY" = (
/obj/machinery/door/airlock/pyro,
/turf/simulated/floor/plating,
/area/space)
"mf" = (
/obj/table/auto,
/obj/bedsheetbin,
/turf/simulated/floor/twotone/green,
/area/space)
"mx" = (
/obj/table/glass/auto,
/turf/simulated/floor/wood/three,
/area/space)
"mW" = (
/obj/submachine/laundry_machine,
/obj/machinery/light/incandescent/cool/very{
	dir = 8;
	pixel_x = -10
	},
/turf/simulated/floor/twotone/green,
/area/space)
"od" = (
/obj/decal/tile_edge/stripe{
	dir = 5;
	icon_state = "xtra_bigstripe-edge"
	},
/turf/simulated/floor/shuttlebay,
/area/space)
"om" = (
/obj/table/auto,
/turf/simulated/floor/wood/three,
/area/space)
"oH" = (
/turf/simulated/floor/carpet/grime,
/area/space)
"ph" = (
/obj/decal/poster/wallsign/stencil/left/l,
/obj/decal/poster/wallsign/stencil/right/a,
/turf/simulated/wall/auto/jen/green,
/area/space)
"pr" = (
/obj/table/wood/auto/desk,
/obj/decoration/decorativeplant/plant4{
	pixel_y = 12;
	pixel_x = 4
	},
/turf/simulated/floor/carpet/grime,
/area/space)
"pJ" = (
/obj/lattice{
	icon_state = "lattice-dir";
	dir = 9
	},
/obj/machinery/light/runway_light/delay2,
/turf/variableTurf/clear,
/area/noGenerate)
"rd" = (
/obj/decoration/decorativeplant/plant7,
/obj/machinery/light/incandescent/cool/very{
	dir = 8;
	pixel_x = -10
	},
/turf/simulated/floor/carpet/grime,
/area/space)
"rI" = (
/turf/simulated/floor/wood/three,
/area/space)
"sK" = (
/obj/table/wood/auto,
/turf/simulated/floor/carpet/grime,
/area/space)
"sT" = (
/obj/table/auto,
/turf/simulated/floor/twotone/black,
/area/space)
"tj" = (
/obj/table/wood/auto/desk,
/obj/machinery/computer3/luggable/personal{
	pixel_y = 8
	},
/turf/simulated/floor/carpet/grime,
/area/space)
"tV" = (
/obj/random_pod_spawner/random_putt_spawner,
/turf/simulated/floor/shuttlebay,
/area/space)
"wk" = (
/obj/machinery/light/small{
	dir = 4;
	pixel_x = 10
	},
/obj/decal/cleanable/blood/tracks{
	dir = 6
	},
/turf/simulated/floor/twotone/black,
/area/space)
"xm" = (
/obj/lattice{
	icon_state = "lattice-dir"
	},
/turf/variableTurf/clear,
/area/noGenerate)
"yd" = (
/obj/grille/catwalk{
	dir = 4
	},
/turf/simulated/floor/airless/plating/catwalk/auto,
/area/space)
"ye" = (
/obj/table/wood/auto/desk,
/obj/machinery/computer3/generic/personal,
/obj/machinery/light/incandescent/cool/very{
	dir = 8;
	pixel_x = -10
	},
/turf/simulated/floor/carpet/grime,
/area/space)
"yi" = (
/obj/submachine/laundry_machine,
/turf/simulated/floor/twotone/green,
/area/space)
"yA" = (
/obj/wingrille_spawn/auto/reinforced,
/obj/structure/woodwall{
	icon_state = "woodwall2"
	},
/turf/simulated/floor/plating,
/area/space)
"AI" = (
/obj/stool/chair/office/red,
/turf/simulated/floor/carpet/grime,
/area/space)
"Cs" = (
/turf/variableTurf/clear,
/area/noGenerate)
"CO" = (
/obj/machinery/light/incandescent/cool/very{
	dir = 8;
	pixel_x = -10
	},
/turf/simulated/floor/wood/three,
/area/space)
"Ej" = (
/obj/table/wood/auto/desk,
/obj/decoration/decorativeplant/plant3{
	pixel_y = 5;
	pixel_x = -5
	},
/obj/machinery/light/incandescent/cool/very{
	dir = 1;
	pixel_y = 21
	},
/turf/simulated/floor/carpet/grime,
/area/space)
"Ek" = (
/obj/lattice{
	dir = 1;
	icon_state = "lattice-dir"
	},
/turf/variableTurf/clear,
/area/noGenerate)
"Et" = (
/obj/decal/fakeobjects/skeleton{
	name = "larry";
	pixel_y = -7
	},
/obj/decal/cleanable/blood/tracks{
	dir = 4
	},
/turf/simulated/floor/twotone/black,
/area/space)
"HY" = (
/obj/submachine/laundry_machine,
/turf/simulated/floor/twotone/black,
/area/space)
"Ip" = (
/obj/submachine/laundry_machine/portable,
/obj/decal/cleanable/blood/tracks{
	icon_state = "drip5"
	},
/turf/simulated/floor/twotone/black,
/area/space)
"IG" = (
/obj/table/wood/auto/desk,
/obj/item/device/key/generic,
/turf/simulated/floor/carpet/grime,
/area/space)
"JM" = (
/obj/stool/bench/blue/auto,
/turf/simulated/floor/wood/three,
/area/space)
"JS" = (
/obj/machinery/door/airlock/pyro/external{
	name = "Larry's laundry"
	},
/turf/simulated/floor,
/area/space)
"Kn" = (
/obj/table/auto,
/obj/item/spacecash/random{
	pixel_y = -2;
	pixel_x = 5
	},
/obj/item/spacecash/random{
	pixel_y = 4;
	pixel_x = -3
	},
/obj/item/spacecash/random{
	pixel_y = 11;
	pixel_x = -5
	},
/obj/item/spacecash/random{
	pixel_y = 5;
	pixel_x = 6
	},
/obj/item/spacecash/random{
	pixel_y = 12;
	pixel_x = 4
	},
/obj/item/spacecash/random{
	pixel_y = 8;
	pixel_x = -4
	},
/obj/machinery/light/small{
	dir = 8;
	pixel_x = -10
	},
/turf/simulated/floor/twotone/black,
/area/space)
"Kp" = (
/turf/simulated/wall/auto/jen/green,
/area/space)
"KJ" = (
/obj/machinery/light/incandescent/cool/very{
	dir = 4;
	pixel_x = 10
	},
/turf/simulated/floor,
/area/space)
"Ms" = (
/obj/lattice{
	icon_state = "lattice-dir";
	dir = 8
	},
/turf/variableTurf/clear,
/area/noGenerate)
"Mw" = (
/obj/wingrille_spawn/auto/reinforced,
/obj/structure/woodwall,
/turf/simulated/floor/plating,
/area/space)
"NE" = (
/obj/submachine/laundry_machine,
/obj/machinery/light/incandescent/cool/very{
	dir = 4;
	pixel_x = 10
	},
/turf/simulated/floor/twotone/green,
/area/space)
"Op" = (
/obj/item/remote/porter/port_a_laundry,
/turf/simulated/floor/twotone/black,
/area/space)
"QD" = (
/obj/table/glass/auto,
/obj/decoration/decorativeplant/plant6{
	pixel_y = 12;
	pixel_x = 2
	},
/turf/simulated/floor/wood/three,
/area/space)
"QO" = (
/obj/decal/tile_edge/stripe{
	dir = 10;
	icon_state = "xtra_bigstripe-edge"
	},
/turf/simulated/floor/shuttlebay,
/area/space)
"QU" = (
/turf/simulated/floor/stairs{
	dir = 8
	},
/area/space)
"SG" = (
/obj/machinery/light/incandescent/cool/very{
	dir = 4;
	pixel_x = 10
	},
/turf/simulated/floor/wood/three,
/area/space)
"Tp" = (
/obj/submachine/laundry_machine,
/obj/machinery/light/small{
	dir = 8;
	pixel_x = -10
	},
/turf/simulated/floor/twotone/black,
/area/space)
"Uq" = (
/obj/stool/chair/wooden{
	dir = 1
	},
/turf/simulated/floor/carpet/grime,
/area/space)
"Uw" = (
/turf/simulated/floor/shuttlebay,
/area/space)
"UJ" = (
/obj/machinery/light/incandescent/cool/very,
/turf/simulated/floor/carpet/grime,
/area/space)
"VN" = (
/obj/machinery/door/unpowered/wood/pyro{
	dir = 4;
	locked = 1
	},
/turf/simulated/floor/plating,
/area/space)
"WC" = (
/turf/simulated/floor/twotone/green,
/area/space)
"WE" = (
/obj/decal/tile_edge/stripe{
	dir = 9;
	icon_state = "xtra_bigstripe-edge"
	},
/turf/simulated/floor/shuttlebay,
/area/space)
"WK" = (
/obj/submachine/ATM/atm_alt{
	dir = 8
	},
/turf/simulated/floor/wood/three,
/area/space)
"XT" = (
/obj/wingrille_spawn/auto/reinforced,
/turf/simulated/floor/plating,
/area/space)
"Yh" = (
/obj/decal/poster/wallsign/stencil/left/r,
/obj/decal/poster/wallsign/stencil/right/r,
/turf/simulated/wall/auto/jen/green,
/area/space)
"YK" = (
/obj/lattice,
/turf/variableTurf/clear,
/area/noGenerate)
"ZF" = (
/obj/machinery/light/small{
	dir = 4;
	pixel_x = 10
	},
/turf/simulated/floor/twotone/black,
/area/space)

(1,1,1) = {"
Cs
Cs
Cs
Cs
Cs
Cs
Cs
Cs
Cs
Cs
Cs
Cs
Cs
Cs
Cs
Cs
Cs
Cs
Cs
Cs
"}
(2,1,1) = {"
Cs
Cs
Cs
Cs
Cs
Kp
Kp
Kp
Kp
Kp
Kp
Kp
ph
Cs
Cs
Cs
pJ
Cs
Cs
Cs
"}
(3,1,1) = {"
Kp
Kp
XT
XT
Kp
Kp
mf
mW
yi
rI
CO
JM
Yh
xm
cN
WE
Uw
QO
Cs
Cs
"}
(4,1,1) = {"
Kp
ye
fZ
oH
rd
Kp
WC
WC
WC
rI
rI
JM
hZ
Cs
Ms
Uw
iR
Uw
Cs
Cs
"}
(5,1,1) = {"
Kp
kG
IG
oH
Uq
Kp
WC
WC
WC
rI
rI
JM
XT
Cs
Ms
Uw
tV
Uw
Cs
Cs
"}
(6,1,1) = {"
Kp
oH
pr
oH
Uq
Kp
yi
NE
yi
rI
rI
QD
XT
Cs
Ms
Uw
iR
Uw
Cs
Cs
"}
(7,1,1) = {"
bE
hF
hF
oH
oH
Kp
Kp
XT
XT
rI
rI
XT
XT
XT
YK
od
Uw
eL
cN
aw
"}
(8,1,1) = {"
Kp
Ej
fZ
oH
UJ
Kp
om
CO
rI
rI
rI
iD
ff
JS
yd
yd
yd
yd
yd
Cs
"}
(9,1,1) = {"
Kp
AI
tj
oH
oH
Kp
cl
rI
rI
rI
rI
iD
KJ
JS
yd
yd
yd
yd
yd
Cs
"}
(10,1,1) = {"
Kp
oH
fZ
oH
oH
kY
rI
rI
rI
rI
rI
XT
XT
XT
Ek
Ek
bU
Ek
Ek
aw
"}
(11,1,1) = {"
Kp
oH
oH
oH
oH
Kp
rI
SG
WK
WK
SG
mx
Kp
Cs
Cs
Cs
Cs
Cs
Cs
Cs
"}
(12,1,1) = {"
Kp
kH
sK
oH
oH
Kp
Kp
Kp
Kp
Kp
Kp
Kp
Kp
Cs
Cs
Cs
Cs
Cs
Cs
Cs
"}
(13,1,1) = {"
Kp
Kp
Kp
Kp
VN
Kp
HY
Tp
HY
Kn
sT
Kp
Cs
Cs
Cs
Cs
Cs
Cs
Cs
Cs
"}
(14,1,1) = {"
Cs
Cs
Cs
Kp
QU
Kp
fC
fC
fC
Op
fC
Kp
Cs
Cs
Cs
Cs
Cs
Cs
Cs
Cs
"}
(15,1,1) = {"
Cs
Cs
Cs
Kp
fC
fC
fC
fC
fC
Et
fC
Kp
Cs
Cs
Cs
Cs
Cs
Cs
Cs
Cs
"}
(16,1,1) = {"
Cs
Cs
Cs
Kp
fC
ZF
Ip
az
az
wk
fC
Kp
Cs
Cs
Cs
Cs
Cs
Cs
Cs
Cs
"}
(17,1,1) = {"
Cs
Cs
Cs
Kp
Kp
Kp
Mw
Mw
yA
Kp
Kp
Kp
Cs
Cs
Cs
Cs
Cs
Cs
Cs
Cs
"}
