"aa" = (/turf/simulated/wall/auto/reinforced/supernorn,/area/water_treatment)
"ab" = (/turf/simulated/floor/purple/side{dir = 10},/area/water_treatment)
"ac" = (/obj/machinery/light/small/warm/very{dir = 8; pixel_x = -12},/obj/fluid_spawner{amount = 20000; reagent_id = "chlorine"},/turf/simulated/floor/purple/side{dir = 9},/area/water_treatment)
"ae" = (/turf/space,/area)
"af" = (/turf/variableTurf/clear,/area)
"ai" = (/obj/decal/fakeobjects{anchored = 1; density = 1; desc = "A large rack of server modules.  It doesn't seem to be in service."; icon = 'icons/obj/networked.dmi'; icon_state = "server0"; name = "downed server"},/turf/simulated/floor/circuit/red,/area/water_treatment)
"aj" = (/obj/map/light/dimred,/turf/simulated/floor/circuit/red,/area/water_treatment)
"ak" = (/turf/simulated/floor/circuit/red,/area/water_treatment)
"al" = (/obj/wingrille_spawn/auto/crystal,/turf/simulated/floor/delivery/caution,/area/water_treatment)
"am" = (/turf/simulated/floor/redblack{icon_state = "redblack"; dir = 5},/area/water_treatment)
"an" = (/obj/fluid_spawner{amount = 1200; reagent_id = "methamphetamine"},/turf/simulated/floor/black/grime,/area/water_treatment)
"ao" = (/obj/machinery/light/small/warm/very{dir = 8; pixel_x = -12},/turf/simulated/floor/black/grime,/area/water_treatment)
"ap" = (/turf/simulated/floor/redblack{icon_state = "redblack"; dir = 10},/area/water_treatment)
"aq" = (/turf/simulated/floor/redblack/corner{dir = 4},/area/water_treatment)
"ar" = (/obj/decal/skeleton,/obj/machinery/light/small/warm/very{dir = 4; pixel_x = 12},/turf/simulated/floor/black/grime,/area/water_treatment)
"as" = (/obj/table/reinforced/chemistry/auto,/turf/simulated/floor/redblack{dir = 4},/area/water_treatment)
"at" = (/obj/table/reinforced/chemistry/auto,/turf/simulated/floor/redblack,/area/water_treatment)
"au" = (/turf/simulated/floor/redblack,/area/water_treatment)
"av" = (/obj/table/reinforced/chemistry/auto,/turf/simulated/floor/redblack{dir = 6},/area/water_treatment)
"aw" = (/turf/variableTurf/clear,/area/water_treatment)
"ax" = (/obj/forcefield/energyshield/perma,/turf/simulated/floor/delivery/caution,/area/water_treatment)
"ay" = (/obj/machinery/door_control{id = "wtp_drain"; name = "Drainage"; pixel_x = 8},/obj/machinery/door_control{id = "wtp_intake"; name = "Water Intake"; pixel_x = -8},/turf/simulated/wall/auto/reinforced/supernorn,/area/water_treatment)
"az" = (/obj/machinery/light{dir = 1; pixel_y = 10},/obj/decal/fakeobjects{anchored = 1; density = 1; desc = "Some kind of weirdo Soviet computer console.  It's probably broken."; dir = 1; icon = 'icons/misc/hospital.dmi'; icon_state = "sovcomp0"; name = "broken computer"},/turf/simulated/floor/redblack{dir = 1},/area/water_treatment)
"aA" = (/obj/table/reinforced/chemistry/auto,/obj/item/reagent_containers/glass/beaker/large,/obj/item/reagent_containers/glass/beaker/large,/obj/item/reagent_containers/glass/beaker/large,/turf/simulated/floor/purple/side{dir = 9},/area/water_treatment)
"aB" = (/obj/table/reinforced/chemistry/auto,/obj/item/clothing/glasses/spectro,/obj/machinery/light{dir = 1; pixel_y = 10},/turf/simulated/floor/purple/side{dir = 1},/area/water_treatment)
"aC" = (/obj/machinery/chem_dispenser,/turf/simulated/floor/purple/side{dir = 1},/area/water_treatment)
"aD" = (/obj/machinery/chem_heater,/turf/simulated/floor/purple/side{dir = 1},/area/water_treatment)
"aE" = (/obj/table/reinforced/chemistry/auto,/obj/item/storage/box/beakerbox,/obj/machinery/light{dir = 1; pixel_y = 10},/turf/simulated/floor/purple/side{dir = 1},/area/water_treatment)
"aF" = (/obj/table/reinforced/chemistry/auto,/obj/machinery/glass_recycler,/turf/simulated/floor/purple/side{dir = 5},/area/water_treatment)
"aG" = (/turf/simulated/wall/false_wall,/area/water_treatment)
"aH" = (/obj/machinery/drainage/big,/turf/simulated/floor/black/grime,/area/water_treatment)
"aI" = (/turf/simulated/floor/purple/side{dir = 9},/area/water_treatment)
"aJ" = (/turf/simulated/floor/purple/side{dir = 1},/area/water_treatment)
"aK" = (/turf/simulated/floor/purple/corner{dir = 1},/area/water_treatment)
"aL" = (/turf/simulated/floor/martian,/area/water_treatment)
"aM" = (/obj/machinery/drainage,/turf/simulated/floor/martian,/area/water_treatment)
"aN" = (/obj/submachine/chem_extractor{dir = 8},/turf/simulated/floor/purple/side{dir = 4},/area/water_treatment)
"aO" = (/obj/machinery/fluid_canister,/obj/machinery/light{dir = 1; pixel_y = 10},/turf/simulated/floor/black/grime,/area/water_treatment)
"aP" = (/obj/machinery/fluid_canister,/turf/simulated/floor/black/grime,/area/water_treatment)
"aQ" = (/obj/machinery/door/airlock/pyro/external{dir = 4},/turf/simulated/floor/purple/side{dir = 1},/area/water_treatment)
"aR" = (/obj/machinery/drainage,/turf/simulated/floor/purple/side{dir = 1},/area/water_treatment)
"aS" = (/obj/machinery/light/small/warm/very{dir = 1},/turf/simulated/floor/purple/side{dir = 1},/area/water_treatment)
"aT" = (/obj/machinery/door/airlock/pyro/external{dir = 8},/turf/simulated/floor/purple/side{dir = 1},/area/water_treatment)
"aU" = (/obj/machinery/light/small/floor,/turf/simulated/floor/martian,/area/water_treatment)
"aX" = (/turf/simulated/floor/purple/side{dir = 4},/area/water_treatment)
"ba" = (/obj/machinery/door/airlock/pyro/classic{dir = 4},/turf/simulated/floor/black/grime,/area/water_treatment)
"bb" = (/obj/machinery/light/small/warm/very,/turf/simulated/floor/black/grime,/area/water_treatment)
"bc" = (/obj/machinery/door/airlock/pyro/external{dir = 4},/turf/simulated/floor/purple/side,/area/water_treatment)
"bd" = (/obj/machinery/drainage,/turf/simulated/floor/purple/side,/area/water_treatment)
"bi" = (/turf/simulated/floor/redblack{icon_state = "redblack"; dir = 9},/area/water_treatment)
"bj" = (/obj/decal/fakeobjects{anchored = 1; density = 1; desc = "Some kind of weirdo Soviet computer console.  It's probably broken."; dir = 1; icon = 'icons/misc/hospital.dmi'; icon_state = "sovcomp0"; name = "broken computer"},/obj/machinery/light{dir = 1; pixel_y = 10},/turf/simulated/floor/redblack{dir = 1},/area/water_treatment)
"bk" = (/obj/machinery/light/small/warm/very,/turf/simulated/floor/purple/side,/area/water_treatment)
"bl" = (/obj/machinery/door/airlock/pyro/external{dir = 8},/turf/simulated/floor/purple/side,/area/water_treatment)
"bn" = (/obj/machinery/light/small/floor,/turf/simulated/floor/purple/side,/area/water_treatment)
"bp" = (/turf/variableTurf/clear,/area/noGenerate)
"bs" = (/obj/machinery/door/poddoor{id = "wtp_intake"},/turf/simulated/floor/black/grime,/area/water_treatment)
"bt" = (/turf/simulated/floor/redblack{dir = 8},/area/water_treatment)
"bv" = (/turf/simulated/floor/redblack{dir = 4},/area/water_treatment)
"bx" = (/obj/decal/fakeobjects{anchored = 1; density = 1; desc = "It is still kinda warm."; icon = 'icons/obj/machines/nuclear.dmi'; icon_state = "neutinj"; name = "busted machine"},/turf/simulated/floor/redblack{dir = 1},/area/water_treatment)
"bB" = (/turf/simulated/floor/red,/area/water_treatment)
"bC" = (/obj/machinery/door/poddoor{id = "wtp_drain"},/turf/simulated/floor/black/grime,/area/water_treatment)
"bD" = (/turf/simulated/floor/black/grime,/area/water_treatment)
"bE" = (/obj/machinery/light/small/floor,/turf/simulated/floor/redblack{icon_state = "redblack"; dir = 10},/area/water_treatment)
"bF" = (/obj/forcefield/energyshield/perma{name = "Permanent Liquid Forcefield"; powerlevel = 4},/turf/simulated/floor/delivery/caution,/area/water_treatment)
"bH" = (/turf/simulated/floor/purple/side,/area/water_treatment)
"bJ" = (/obj/machinery/light/small/warm/very{dir = 4; pixel_x = 12},/turf/simulated/floor/black/grime,/area/water_treatment)
"kh" = (/obj/machinery/door/poddoor{id = "wtp_mix_2"},/turf/simulated/floor/purple,/area/water_treatment)
"rn" = (/obj/machinery/door_control{id = "wtp_mix_1"; name = "Mixer Control 1"},/turf/simulated/wall/auto/reinforced/supernorn,/area/water_treatment)
"vk" = (/obj/decal/fakeobjects{name = "power conduit"; desc = "Like conventional cables, but more burly."; icon = 'icons/obj/power_cond.dmi'; icon_state = "conduit"; dir = 6; layer = 2.5; anchored = 1},/turf/simulated/floor/black/grime,/area/water_treatment)
"wt" = (/turf/simulated/floor/purple/side{dir = 6},/area/water_treatment)
"Ez" = (/obj/machinery/door_control{id = "wtp_mix_2"; name = "Mixer Control 2"},/turf/simulated/wall/auto/reinforced/supernorn,/area/water_treatment)
"GT" = (/obj/machinery/light/small/warm/very{dir = 8; pixel_x = -12},/obj/fluid_spawner{amount = 20000; reagent_id = "urine"},/turf/simulated/floor/purple/side{dir = 9},/area/water_treatment)
"Jc" = (/obj/decal/fakeobjects{name = "power conduit"; desc = "Like conventional cables, but more burly."; icon = 'icons/obj/power_cond.dmi'; icon_state = "conduit"; dir = 5; anchored = 1},/turf/simulated/floor/black/grime,/area/water_treatment)
"MD" = (/obj/machinery/power/smes/magical{desc = "A high-capacity superconducting magnetic energy storage (SMES) unit with an integral radiothermal generating core."; icon_state = "rtg"; name = "SMES-RTG"},/obj/map/light/cyan,/turf/simulated/floor/black/grime,/area/water_treatment)
"PJ" = (/obj/securearea{desc = ""; icon_state = "shock"; name = "Danger: High Voltage"},/turf/simulated/wall/auto/reinforced/supernorn,/area/water_treatment)
"Rt" = (/obj/machinery/door/poddoor{id = "wtp_mix_1"},/turf/simulated/floor/purple,/area/water_treatment)
"WO" = (/obj/decal/fakeobjects{anchored = 1; desc = "Like conventional cables, but more burly."; dir = 4; icon = 'icons/obj/power_cond.dmi'; icon_state = "conduit"; layer = 2.5; name = "power conduit"},/turf/simulated/floor/black/grime,/area/water_treatment)
"Xl" = (/obj/machinery/light/small/warm/very{dir = 4; pixel_x = 12},/turf/simulated/floor/purple/side{dir = 5},/area/water_treatment)

(1,1,1) = {"
aeaeaeaeaeaeaeaeaeaeaeaeaeaeaeaeaeaeaeaeaeaeaeaeaeaeaeaeaeaeaeaeaeaeaeaeaeaeaeaeaeaeaeaeaeaeaeaeaeae
aeaeaeaeaeaeaeaeaeaeaeaeaeaeaeaeaeaeaeaeaeaeaeaeaeaeaeaeaeaeaeaeaeaeaeaeaeaeaeaeaeaeaeaeaeaeaeaeaeae
aeaeaeaeaeaeaeaeaeaeaeaeaeaeaeaeaeaeaeaeaeaeaeaeaeaeaeaeaeaeaeaeaeaeaeaeaeaeaeaeaeaeaeaeaeaeaeaeaeae
aeaeaeaeaeaeaeaeaeaeaeaeaeaeaeaeaeaeaeaeaeaeaeaeaeaeaeaeaeaeaeaeaeaeaeaeaeaeaeaeaeaeaeaeaeaeaeaeaeae
aeaeaeaeaeaeaeaeaeaeaeaeaeaeaeaeaeaeaeaeaeaeaeaeaeaeaeaeaeaeaeaeaeaeaeaeaeaeaeaeaeaeaeaeaeaeaeaeaeae
aeaeaeaeaeaeaeaeaeaeaeaeaeaeaeaeaeaeaeaeaeaeaeaeaeaeaeaeaeaeaeaeaeaeaeaeaeaeaeaeaeaeaeaeaeaeaeaeaeae
aeaeaeaeaeaeaeaeaeaeaeaeaeaeaeaeaeaeaeaeaeaeaeaeaeaeaeaeaeaeaeaeaeaeaeaeaeaeaeaeaeaeaeaeaeaeaeaeaeae
aeaeaeaeaeaeaeaeaeaeaeaeaeaeaeaeaeaeaeaeaeaeaeaeaeaeaeaeaeaeaeaeaeaeaeaeaeaeaeaeaeaeaeaeaeaeaeaeaeae
aeaeaeaeaeaeaeaeaeaeaeaeaeaeaeaeaeaeaeaeaeaeaeaeaeaeaeaeaeaeaeaeaeaeaeaeaeaeaeaeaeaeaeaeaeaeaeaeaeae
aeaeaeaeaeaeaeaeaeaeaeaeaeaeaeaeaeaeaeaeaeaeaeaeaeaeaeaeaeaeaeaeaeaeaeaeaeaeaeaeaeaeaeaeaeaeaeaeaeae
aeaeaeaeaeaeaeaeaeaeaeaeaeaeaeaeaeaeaeaeaeaeaeaeaeaeaeaeaeaeaeaeaeaeaeaeaeaeaeaeaeaeaeaeaeaeaeaeaeae
aeaeaeaeaeaeaeaeaeaeaeaeaeaeaeaeaeaeaeaeaeaeaeaeaeaeaeaeaeaeaeaeaeaeaeaeaeaeaeaeaeaeaeaeaeaeaeaeaeae
aeaeaeaeaeaeaeaeaeaeaeaeaeaeaeaeaeaeaeaeaeaeaeaeaeaeaeaeaeaeaeaeaeaeaeaeaeaeaeaeaeaeaeaeaeaeaeaeaeae
aeaeaeaeaeaeaeaeaeaeaeaeaeaeaeaeaeaeaeaeaeaeaeaeaeaeaeaeaeaeaeaeaeaeaeaeaeaeaeaeaeaeaeaeaeaeaeaeaeae
aeaeaeaeaeaeaeaeaeaeaeaeaeaeaeaeaeaeaeaeaeaeaeaeaeaeaeaeaeaeaeaeaeaeaeaeaeaeaeaeaeaeaeaeaeaeaeaeaeae
aeaeaeaeaeaeaeaeaeaeaeaeaeaeaeaeaeaeaeaeaeaeaeaeaeaeaeaeaeaeaeaeaeaeaeaeaeaeaeaeaeaeaeaeaeaeaeaeaeae
aeaeaeaeaeaeaeaeaeaeaeaeaeaeaeaeaeaeaeaeaeaeaeaeaeaeaeaeaeaeaeaeaeaeaeaeaeaeaeaeaeaeaeaeaeaeaeaeaeae
aeaeaeaeaeaeaeaeaeaeaeaeaeaeaeaeaeaeaeaeaeaeaeaeaeaeaeaeaeaeaeaeaeaeaeaeaeaeaeaeaeaeaeaeaeaeaeaeaeae
aeaeaeaeaeaeaeaeaeaeaeaeaeaeaeaeaeaeaeaeaeaeaeaeaeaeaeaeaeaeaeaeaeaeaeaeaeaeaeaeaeaeaeaeaeaeaeaeaeae
aeaeaeaeaeaeaeaeaeaeaeaeaeaeaeaeaeaeaeaeaeaeaeaeaeaeaeaeaeaeaeaeaeaeaeaeaeaeaeaeaeaeaeaeaeaeaeaeaeae
aeaeaeaeaeaeaeaeaeaeaeaeaeaeaeaeaeaeaeaeaeaeaeaeaeaeaeaeaeaeaeaeaeaeaeaeaeaeaeaeaeaeaeaeaeaeaeaeaeae
aeaeaeaeaeaeaeaeaeaeaeaeaeaeaeaeaeaeaeaeaeaeaeaeaeaeaeaeaeaeaeaeaeaeaeaeaeaeaeaeaeaeaeaeaeaeaeaeaeae
aeaeaeaeaeaeaeaeaeaeaeaeaeaeaeaeaeaeaeaeaeaeaeaeaeaeaeaeaeaeaeaeaeaeaeaeaeaeaeaeaeaeaeaeaeaeaeaeaeae
aeaeaeaeaeaeaeaeaeaeaeaeaeaeaeaeaeaeaeaeaeaeaeaeaeaeaeaeaeaeaeaeaeaeaeaeaeaeaeaeaeaeaeaeaeaeaeaeaeae
aeaeaeaeaeaeaeaeaeaeaeaeaeaeaeaeaeaeaeaeaeaeaeaeaeaeaeaeaeaeaeaeaeaeaeaeaeaeaeaeaeaeaeaeaeaeaeaeaeae
aeaeaeaeaeaeaeaeaeaeaeaeaeaeaeaeaeaeaeaeaeaeaeaeaeaeaeaeaeaeaeaeaeaeaeaeaeaeaeaeaeaeaeaeaeaeaeaeaeae
aeaeaeaeaeaeaeaeaeaeaeaeaeaeaeaeaeaeaeaeaeaeaeaeaeaeaeaeaeaeaeaeaeaeaeaeaeaeaeaeaeaeaeaeaeaeaeaeaeae
aeaeaeaeaeaeaeaeaeaeaeaeaeaeaeaeaeaeaeaeaeaeaeaeaeaeaeaeaeaeaeaeaeaeaeaeaeaeaeaeaeaeaeaeaeaeaeaeaeae
aeaeaeaeaeaeaeaeaeaeaeaeaeaeaeaeaeaeaeaeaeaeaeaeaeaeaeaeaeaeaeaeaeaeaeaeaeaeaeaeaeaeaeaeaeaeaeaeaeae
aeaeaeaeaeaeaeaeaeaeaeaeaeaeaeaeaeaeaeaeaeaeaeaeaeaeaeaeaeaeaeaeaeaeaeaeaeaeaeaeaeaeaeaeaeaeaeaeaeae
aeaeaeaeaeaeaeaeaeaeaeaeaeaeaeaeaeaeaeaeaeaeaeaeaeaeaeaeaeaeaeaeaeaeaeaeaeaeaeaeaeaeaeaeaeaeaeaeaeae
aeaeaeaeaeaeaeaeaeaeaeaeaeaeaeaeaeaeaeaeaeaeaeaeaeaeaeaeaeaeaeaeaeaeaeaeaeaeaeaeaeaeaeaeaeaeaeaeaeae
aeaeaeaeaeaeaeaeaeaeaeaeaeaeaeaeaeaeaeaeaeaeaeaeaeaeaeaeaeaeaeaeaeaeaeaeaeaeaeaeaeaeaeaeaeaeaeaeaeae
aeaeaeaeaeaeaeaeaeaeaeaeaeaeaeaeaeaeaeaeaeaeaeaeaeaeaeaeaeaeaeaeaeaeaeaeaeaeaeaeaeaeaeaeaeaeaeaeaeae
aeaeaeaeaeaeaeaeaeaeaeaeaeaeaeaeaeaeaeaeaeaeaeaeaeaeaeaeaeaeaeaeaeaeaeaeaeaeaeaeaeaeaeaeaeaeaeaeaeae
aeaeaeaeaeaeaeaeaeaeaeaeafafafafafafafafafafafafafafafaeaeaeaeaeaeaeaeaeaeaeaeaeaeaeaeaeaeaeaeaeaeae
afafafafbpbpbpbpbpbpbpbpaaaaaaaaaaaaaaaaaaaaaaaaafafafaeaeaeaeaeaeaeaeaeaeaeaeaeaeaeaeaeaeaeaeaeaeae
afafafafbpbpbpbpbpbpbpbpaaaiajakalbibjbxbxazamaaaaaaaaaeaeaeaeaeaeaeaeaeaeaeaeaeaeaeaeaeaeaeaeaeaeae
afafafafbpbpaabsbsbsaabpaaaiajajalbtbBbBbBbBbvbFanbJaaaeaeaeaeaeaeaeaeaeaeaeaeaeaeaeaeaeaeaeaeaeaeae
afafafafaaaaaaaobDbJaaaaaaaiajakalapaqbBbBbBbvbFbDaraaaeaeaeaeaeaeaeaeaeaeaeaeaeaeaeaeaeaeaeaeaeaeae
afafafafaaaHbCbDbDbDbCaHaaaaaaaaaaaabtbBbBbBasaaaaaaaaaeaeaeaeaeaeaeaeaeaeaeaeaeaeaeaeaeaeaeaeaeaeae
afafafafaaaaaaaobDbJaaaaaaaaaaaaaaaabEatatauavaaawawawaeaeaeaeaeaeaeaeaeaeaeaeaeaeaeaeaeaeaeaeaeaeae
afafafafafafaaaxaxaxayaAaBaCaDaEaFaaaaaaaaaGaaaaafafafaeaeaeaeaeaeaeaeaeaeaeaeaeaeaeaeaeaeaeaeaeaeae
afafaaaaaaaaaaaIaJaJaJaKaLaMaLaLaNaaaaaOaPaPaaafafafafaeaeaeaeaeaeaeaeaeaeaeaeaeaeaeaeaeaeaeaeaeaeae
bpbpaQaRaSaTaJaKaLaUaLaLaLaLaLaUaXbabbbDbDbJaaafafafafaeaeaeaeaeaeaeaeaeaeaeaeaeaeaeaeaeaeaeaeaeaeae
bpbpbcbdbkblbnbHbHbHbHbHbnbHbHbHwtaaaaaaPJJcaaafafafafaeaeaeaeaeaeaeaeaeaeaeaeaeaeaeaeaeaeaeaeaeaeae
afafaaaaaaaaalbFalrnalbFalEzalbFalaaMDWOWOvkaaafafafafaeaeaeaeaeaeaeaeaeaeaeaeaeaeaeaeaeaeaeaeaeaeae
afafafafafaaacaJXlaaGTaJXlaaacaJXlaaaaaaaaaaaaafafafafaeaeaeaeaeaeaeaeaeaeaeaeaeaeaeaeaeaeaeaeaeaeae
afafafafafaaabbHwtRtabbHwtkhabbHwtaaafafafafafafafafafaeaeaeaeaeaeaeaeaeaeaeaeaeaeaeaeaeaeaeaeaeaeae
afafafafafaaaaaaaaaaaaaaaaaaaaaaaaaaafafafafafafafafafaeaeaeaeaeaeaeaeaeaeaeaeaeaeaeaeaeaeaeaeaeaeae
"}
