"aE" = (/obj/ladder{id = "saferoom"},/turf/simulated/floor/plating,/area/prefab/safehouse)
"aM" = (/obj/machinery/door/airlock/gannets/maintenance{name = "storage airlock"},/obj/access_spawn/public,/obj/decal/cleanable/dirt,/turf/simulated/floor/plating,/area/prefab/safehouse)
"cg" = (/obj/decal/cleanable/blood{icon_state = "handblood"; pixel_y = 7},/turf/unsimulated/wall/auto/reinforced/supernorn,/area/prefab/safehouse)
"cj" = (/obj/stool/chair/office/red{dir = 1},/turf/simulated/floor/carpet/red/fancy/edge/sw,/area/prefab/safehouse)
"cr" = (/obj/decal/fakeobjects/safehouse/mechcomp_cabinet{pixel_y = -2},/turf/unsimulated/floor/circuit/vintage/vintage_CO2,/area/prefab/safehouse)
"cy" = (/obj/table/wood/auto,/obj/machinery/computer3/generic/personal/safehouse,/turf/simulated/floor/carpet/red/fancy/edge/nw,/area/prefab/safehouse)
"cI" = (/obj/window/cubicle{dir = 4},/obj/machinery/bot/medbot{pixel_x = -3},/turf/simulated/floor/circuit,/area/prefab/safehouse)
"dh" = (/obj/decal/fakeobjects/safehouse/conduit{dir = 8},/turf/unsimulated/floor/circuit/vintage/vintage_CO2,/area/prefab/safehouse)
"dK" = (/obj/decal/fakeobjects/safehouse/dead_exec{dir = 10; pixel_x = 10; pixel_y = -5},/turf/unsimulated/floor/circuit/green/green_CO2,/area/prefab/safehouse)
"en" = (/obj/machinery/light{brightness = 1.4; dir = 8; layer = 9.1; name = "worn light fixture"; pixel_x = -10},/turf/simulated/floor/bluewhite{dir = 10},/area/prefab/safehouse)
"eq" = (/obj/table/auto{layer = 3},/obj/machinery/light/emergencyflashing{dir = 4},/obj/item/storage/briefcase/safehouse{layer = 3.1},/obj/item/storage/pill_bottle/methamphetamine{pixel_x = 9; pixel_y = 8; spawn_contents = list(/obj/item/reagent_containers/pill/methamphetamine = 7)},/obj/item/storage/pill_bottle/bathsalts{pixel_y = 9},/turf/unsimulated/floor/circuit/vintage/vintage_CO2,/area/prefab/safehouse)
"et" = (/obj/decal/cleanable/blood/splatter{icon_state = "floor4"},/obj/decal/fakeobjects/safehouse/cloner{dir = 1},/turf/unsimulated/floor/circuit/vintage/vintage_CO2,/area/prefab/safehouse)
"eI" = (/obj/decal/poster/wallsign/dead_exec_portrait,/turf/simulated/floor/carpet/red/fancy/edge/north,/area/prefab/safehouse)
"eX" = (/obj/machinery/optable,/turf/simulated/floor/bluewhite{dir = 5},/area/prefab/safehouse)
"fp" = (/obj/machinery/door/airlock/gannets/medical,/obj/access_spawn/public,/turf/simulated/floor/blue,/area/prefab/safehouse)
"gf" = (/obj/decal/fakeobjects/safehouse/biotube{pixel_y = 1},/obj/decal/fakeobjects/pipe{desc = "A vent. You can't feel any airflow."; dir = 8; icon = 'icons/obj/atmospherics/pipe_vent.dmi'; icon_state = "hvent"; name = "grimy vent"; tag = ""},/obj/decal/cleanable/dirt/dirt5,/turf/unsimulated/floor/circuit/vintage/vintage_CO2,/area/prefab/safehouse)
"gh" = (/obj/decal/fakeobjects/safehouse/biomatter_tank{dir = 1},/turf/unsimulated/floor/circuit/vintage/vintage_CO2,/area/prefab/safehouse)
"gj" = (/obj/decal/fakeobjects/safehouse/cloning_console,/obj/decal/cleanable/blood,/obj/item/raw_material/shard/glass{layer = 3.2; pixel_x = -3},/obj/decal/cleanable/blood/splatter{icon_state = "floor3"},/obj/item/raw_material/shard/glass{layer = 3.2; pixel_x = 6; pixel_y = -3},/turf/unsimulated/floor/circuit/vintage/vintage_CO2,/area/prefab/safehouse)
"go" = (/obj/decal/fakeobjects/safehouse/dead_exec{dir = 9; pixel_x = 2; pixel_y = 7},/obj/decal/fakeobjects/safehouse/dead_exec/bloody{dir = 8; pixel_y = 6},/obj/decal/fakeobjects/safehouse/dead_exec{dir = 5; pixel_y = -5},/obj/decal/cleanable/blood/splatter{icon_state = "floor4"},/turf/unsimulated/floor/circuit/green/green_CO2,/area/prefab/safehouse)
"gz" = (/obj/storage/crate/bin{layer = 2.9},/obj/item/paper{pixel_x = 2; pixel_y = -2},/obj/item/paper,/obj/item/chem_pill_bottle,/obj/decal/cleanable/paper,/turf/simulated/floor/wood/two,/area/prefab/safehouse)
"hp" = (/obj/decal/fakeobjects/safehouse/dead_exec{dir = 4; pixel_y = -10},/turf/unsimulated/floor/circuit/green/green_CO2,/area/prefab/safehouse)
"hx" = (/obj/decal/fakeobjects/safehouse/reclaimer,/turf/unsimulated/floor/circuit/vintage/vintage_CO2,/area/prefab/safehouse)
"id" = (/obj/decal/fakeobjects/safehouse/dead_exec/bloody{dir = 10; pixel_y = -5},/obj/decal/cleanable/blood/splatter{icon_state = "floor4"},/obj/item/raw_material/shard/glass{pixel_x = 9; pixel_y = 9},/obj/item/implant/health/exp_health_implant{pixel_x = -6; pixel_y = 9},/obj/machinery/light/emergencyflashing{dir = 8},/turf/unsimulated/floor/circuit/vintage/vintage_CO2,/area/prefab/safehouse)
"ii" = (/obj/machinery/bio_handscanner{pixel_x = 7; pixel_y = -32},/obj/decal/fakeobjects/safehouse/dead_exec{dir = 4; pixel_x = 14; pixel_y = -8},/turf/unsimulated/floor/circuit/green/green_CO2,/area/prefab/safehouse)
"iL" = (/turf/simulated/floor/bluewhite{dir = 1},/area/prefab/safehouse)
"jj" = (/obj/table/auto,/obj/machinery/microwave,/turf/simulated/floor/plating,/area/prefab/safehouse)
"kl" = (/obj/decal/fakeobjects/safehouse/dead_exec{dir = 9; pixel_x = 2; pixel_y = 7},/obj/decal/fakeobjects/safehouse/dead_exec{dir = 9; pixel_x = 2; pixel_y = 7},/obj/decal/fakeobjects/safehouse/dead_exec{dir = 4; pixel_y = 14},/obj/decal/fakeobjects/safehouse/dead_exec{pixel_x = 15; pixel_y = 11},/obj/decal/fakeobjects/safehouse/dead_exec{dir = 8; layer = 3.2; pixel_x = 9; pixel_y = -8},/obj/decal/fakeobjects/safehouse/dead_exec/bloody{dir = 5; pixel_x = -2; pixel_y = 4},/obj/decal/fakeobjects/safehouse/dead_exec/bloody{dir = 9; pixel_y = -3},/obj/decal/cleanable/blood/splatter,/turf/unsimulated/floor/circuit/green/green_CO2,/area/prefab/safehouse)
"kB" = (/obj/rack,/obj/item/tank/oxygen,/obj/item/device/light/flashlight{pixel_x = 6},/obj/item/clothing/mask/gas/emergency,/turf/simulated/floor/neutral,/area/prefab/safehouse)
"kC" = (/obj/decal/fakeobjects/safehouse/dead_exec{dir = 5; pixel_x = -3; pixel_y = 7},/obj/decal/fakeobjects/safehouse/dead_exec{dir = 4},/obj/decal/fakeobjects/safehouse/dead_exec{dir = 1; pixel_y = -6},/obj/decal/fakeobjects/safehouse/dead_exec{dir = 6; pixel_x = -7; pixel_y = 18},/obj/decal/fakeobjects/safehouse/dead_exec/bloody{dir = 8; layer = 3.2; pixel_x = -10},/obj/decal/cleanable/blood/splatter,/turf/unsimulated/floor/circuit/green/green_CO2,/area/prefab/safehouse)
"kL" = (/obj/table/wood/round,/obj/decal/statue/dead_exec_bust,/turf/simulated/floor/wood,/area/prefab/safehouse)
"kN" = (/obj/item/clothing/shoes/dress_shoes{pixel_y = -8},/obj/storage/closet/dresser,/obj/item/clothing/under/suit,/obj/decal/cleanable/wardrobe_scuff_marks,/obj/item/clothing/under/suit{pixel_x = 5},/obj/item/clothing/under/suit{pixel_x = 2},/obj/item/clothing/shoes/dress_shoes{pixel_x = 2; pixel_y = -8},/obj/item/clothing/shoes/dress_shoes{pixel_x = -3; pixel_y = -9},/turf/simulated/floor/carpet/red/fancy/edge/north,/area/prefab/safehouse)
"kP" = (/obj/decal/floatingtiles{dir = 8; icon_state = "floattiles3"},/turf/space,/area/noGenerate)
"lh" = (/obj/decal/tile_edge/line/grey{icon_state = "line1"},/turf/simulated/floor/specialroom/bar,/area/prefab/safehouse)
"lj" = (/turf/simulated/floor/carpet/red/standard/narrow/west,/area/prefab/safehouse)
"lv" = (/obj/decal/cleanable/dirt,/obj/machinery/light{brightness = 1.4; dir = 1; layer = 9.1; name = "worn light fixture"; pixel_y = 14},/turf/simulated/floor/wood,/area/prefab/safehouse)
"lF" = (/obj/item/reagent_containers/syringe{pixel_x = 2; pixel_y = 11},/obj/item/reagent_containers/syringe{pixel_y = 3},/obj/item/reagent_containers/syringe{pixel_x = 1; pixel_y = 7},/obj/table/auto,/obj/item/reagent_containers/syringe/morphine{pixel_y = -1},/turf/simulated/floor/bluewhite{dir = 6},/area/prefab/safehouse)
"lG" = (/obj/machinery/door/airlock/gannets/maintenance,/obj/access_spawn/public,/turf/simulated/floor/wood/two,/area/prefab/safehouse)
"lO" = (/obj/machinery/door/airlock/external,/obj/access_spawn/public,/turf/simulated/floor/neutral,/area/prefab/safehouse)
"lY" = (/obj/decal/cleanable/dirt/dirt2,/obj/machinery/light{brightness = 1.4; dir = 1; layer = 9.1; name = "worn light fixture"; pixel_y = 14},/turf/simulated/floor/neutral,/area/prefab/safehouse)
"mf" = (/obj/table/auto,/obj/machinery/glass_recycler{glass_amt = 10; pixel_y = 6},/obj/decal/cleanable/dirt/jen,/turf/simulated/floor/plating,/area/prefab/safehouse)
"my" = (/obj/machinery/door/airlock/gannets/alt,/obj/access_spawn/public,/turf/simulated/floor/specialroom/bar,/area/prefab/safehouse)
"mB" = (/obj/table/wood/auto,/obj/decoration/clock{pixel_y = 6},/turf/simulated/floor/carpet/red/fancy/edge/ne,/area/prefab/safehouse)
"mM" = (/turf/simulated/floor/carpet/red/standard/narrow/T_south,/area/prefab/safehouse)
"np" = (/obj/stool/bed{pixel_y = 11},/obj/stool/bed,/obj/item/clothing/suit/bedsheet/royal{pixel_y = 11},/obj/item/clothing/suit/bedsheet/royal,/obj/machinery/light{brightness = 1.4; dir = 4; layer = 9.1; name = "worn light fixture"; pixel_x = 10},/turf/simulated/floor/carpet/red/fancy/edge/se,/area/prefab/safehouse)
"ns" = (/obj/stool/chair/couch/red{dir = 5},/turf/simulated/floor/carpet/red/fancy/narrow/se,/area/prefab/safehouse)
"nz" = (/obj/decal/fakeobjects/pipe{desc = "Part of the area's air supply system."; dir = 10},/obj/decal/cleanable/dirt/dirt5,/turf/simulated/floor/plating,/area/prefab/safehouse)
"nF" = (/obj/reagent_dispensers/fueltank,/turf/simulated/floor/airless,/area/prefab/safehouse)
"nK" = (/obj/decal/cleanable/dirt/dirt4,/turf/simulated/floor/specialroom/bar,/area/prefab/safehouse)
"nQ" = (/obj/storage/crate/wooden{layer = 2.9},/obj/item/reagent_containers/food/drinks/bottle/hobo_wine{pixel_x = -2; pixel_y = -2},/obj/item/reagent_containers/food/drinks/bottle/hobo_wine{pixel_x = -5},/obj/item/reagent_containers/food/drinks/bottle/hobo_wine{pixel_x = 7},/obj/item/reagent_containers/food/drinks/bottle/hobo_wine{pixel_x = 1},/obj/decal/cleanable/dirt,/turf/simulated/floor/plating,/area/prefab/safehouse)
"nW" = (/obj/item/reagent_containers/pill/cyberpunk{pixel_x = 2; pixel_y = -8},/obj/decal/cleanable/vomit{pixel_x = -1; pixel_y = 5},/turf/simulated/floor/plating,/area/prefab/safehouse)
"or" = (/obj/machinery/door/poddoor{id = "clone room"; name = "lab doors"},/turf/simulated/floor/neutral,/area/prefab/safehouse)
"ot" = (/obj/table/reinforced/auto,/obj/item/scalpel,/obj/item/circular_saw{pixel_x = 3; pixel_y = 12},/obj/item/staple_gun,/obj/item/hemostat,/obj/item/surgical_spoon,/obj/item/suture,/obj/item/reagent_containers/syringe/calomel,/obj/item/implanter{pixel_x = -5},/obj/machinery/light{brightness = 1.4; dir = 4; layer = 9.1; name = "worn light fixture"; pixel_x = 10},/turf/simulated/floor/bluewhite{dir = 6},/area/prefab/safehouse)
"ou" = (/obj/submachine/chef_oven,/obj/decal/tile_edge/stripe/extra_big,/turf/simulated/floor/black,/area/prefab/safehouse)
"ox" = (/obj/decal/tile_edge/stripe/extra_big,/obj/machinery/light{brightness = 1.4; dir = 1; layer = 9.1; name = "worn light fixture"; pixel_y = 14},/obj/submachine/chef_sink,/turf/simulated/floor/black,/area/prefab/safehouse)
"oM" = (/obj/decal/cleanable/dirt,/turf/simulated/floor/wood,/area/prefab/safehouse)
"oY" = (/obj/item/storage/wall/medical{dir = 1; pixel_y = 32},/turf/simulated/floor/bluewhite{dir = 1},/area/prefab/safehouse)
"pl" = (/obj/decal/cleanable/dirt,/turf/simulated/floor/carpet/red/standard/narrow/west{dir = 1},/area/prefab/safehouse)
"pA" = (/obj/table/auto,/obj/item/storage/toolbox/mechanical,/turf/simulated/floor/plating,/area/prefab/safehouse)
"pJ" = (/obj/decal/tile_edge/stripe/extra_big,/obj/machinery/chem_dispenser/alcohol,/turf/simulated/floor/black,/area/prefab/safehouse)
"pT" = (/obj/machinery/chem_dispenser/soda,/obj/decal/tile_edge/stripe/extra_big,/turf/simulated/floor/black,/area/prefab/safehouse)
"rf" = (/obj/storage/closet/fire,/turf/simulated/floor/neutral,/area/prefab/safehouse)
"rm" = (/obj/item/storage/toilet{dir = 4},/obj/machinery/light/small{dir = 1; pixel_y = 21},/turf/simulated/floor/blue,/area/prefab/safehouse)
"rq" = (/obj/item/cigbutt{pixel_x = -4; pixel_y = -8},/turf/simulated/floor/airless,/area/prefab/safehouse)
"rI" = (/obj/shrub/dead,/turf/simulated/floor/wood,/area/prefab/safehouse)
"rK" = (/obj/machinery/chem_master,/obj/decal/cleanable/cobweb,/turf/simulated/floor/plating,/area/prefab/safehouse)
"sN" = (/obj/table/auto,/obj/item/storage/firstaid/hangover{pixel_y = 3},/turf/simulated/floor/bluewhite{dir = 10},/area/prefab/safehouse)
"tJ" = (/obj/decal/cleanable/dirt/dirt5,/turf/simulated/floor/airless,/area/prefab/safehouse)
"ue" = (/turf/simulated/floor/airless,/area/prefab/safehouse)
"uv" = (/turf/simulated/floor/bluewhite/corner{dir = 4},/area/prefab/safehouse)
"uQ" = (/obj/machinery/door/airlock/gannets/alt{name = "bedroom airlock"},/obj/access_spawn/public,/turf/simulated/floor/wood/two,/area/prefab/safehouse)
"vP" = (/obj/decal/fakeobjects/safehouse/airfilter,/obj/decal/cleanable/dirt/dirt3,/turf/simulated/floor/plating,/area/prefab/safehouse)
"wc" = (/obj/machinery/door_control/podbay/suspiciousdebris,/obj/item/parts/robot_parts/arm/right/light{pixel_x = -7},/turf/simulated/floor/plating/airless/asteroid,/area/noGenerate)
"wp" = (/obj/machinery/door_control{id = "podbay_safehouse"; name = "Safehouse Hangar Door Control"; pixel_x = -24},/obj/decal/cleanable/dirt/dirt5,/turf/simulated/floor/shuttlebay,/area/prefab/safehouse)
"wy" = (/obj/ladder{icon_state = "ladder_wall"; id = "safehouse_storage"; pixel_y = 20},/obj/decal/cleanable/dirt/jen,/obj/decal/cleanable/dirt,/turf/simulated/floor/plating,/area/prefab/safehouse)
"wA" = (/turf/simulated/floor/carpet/red/fancy/narrow/sw,/area/prefab/safehouse)
"wI" = (/turf/simulated/floor/wood/two,/area/prefab/safehouse)
"xm" = (/turf/simulated/floor/carpet/red/fancy/narrow/nw,/area/prefab/safehouse)
"xI" = (/obj/storage/secure/closet/fridge/kitchen{layer = 2.9; locked = 0; pixel_x = -4},/obj/decal/tile_edge/stripe/extra_big{dir = 6},/obj/window/east,/obj/item/reagent_containers/food/drinks/bottle/champagne/cristal_champagne,/turf/simulated/floor/black,/area/prefab/safehouse)
"ym" = (/obj/stool/bar,/turf/simulated/floor/carpet/red/standard/narrow/eastwest,/area/prefab/safehouse)
"yx" = (/obj/table/auto,/obj/item/paper_bin,/turf/simulated/floor/blue,/area/prefab/safehouse)
"yH" = (/obj/cable{d1 = 2; d2 = 8; icon_state = "2-8"},/turf/simulated/floor/plating,/area/prefab/safehouse)
"zo" = (/obj/decal/fakeobjects/safehouse/dead_exec/bloody,/obj/decal/cleanable/blood/splatter{icon_state = "gibbl2"; pixel_y = 9},/turf/unsimulated/floor/circuit/green/green_CO2,/area/prefab/safehouse)
"zK" = (/obj/submachine/chef_sink/chem_sink{dir = 8},/turf/simulated/floor/blue,/area/prefab/safehouse)
"As" = (/obj/decal/fakeobjects/safehouse/airhandlingunit,/turf/simulated/floor/plating,/area/prefab/safehouse)
"CW" = (/obj/ladder{id = "safehouse_storage"},/obj/machinery/light/small{dir = 4; pixel_x = 12},/obj/decal/cleanable/dirt,/turf/simulated/floor/plating,/area/prefab/safehouse)
"Dc" = (/obj/machinery/door/poddoor/blast/asteroid/podbay_autoclose/asteroid_horizontal{id = "podbay_safehouse"},/obj/forcefield/energyshield/perma/doorlink{desc = "A door-linked force field that prevents gasses from passing through it."; dir = 4; name = "Door-linked Atmospheric Forcefield"; powerlevel = 1},/turf/simulated/floor/plating/airless/asteroid,/area/prefab/safehouse/asteroiddoors)
"Dj" = (/obj/table/reinforced/bar/auto,/obj/decal/tile_edge/line/grey{icon_state = "line1"},/turf/simulated/floor/specialroom/bar,/area/prefab/safehouse)
"Dl" = (/turf/simulated/floor/carpet/red/standard/narrow/eastwest,/area/prefab/safehouse)
"Dm" = (/obj/decal/fakeobjects/safehouse/dead_exec{dir = 1; pixel_y = -6},/turf/unsimulated/floor/circuit/green/green_CO2,/area/prefab/safehouse)
"Du" = (/obj/table/wood/auto,/obj/item/reagent_containers/food/drinks/drinkingglass/oldf{pixel_x = -6},/obj/item/reagent_containers/food/drinks/bottle/soda/lithiawater{pixel_x = 5; pixel_y = 9},/turf/simulated/floor/wood/two,/area/prefab/safehouse)
"DA" = (/obj/machinery/light{brightness = 1.4; dir = 8; layer = 9.1; name = "worn light fixture"; pixel_x = -10},/turf/simulated/floor/shuttlebay,/area/prefab/safehouse)
"Ed" = (/turf/simulated/floor/shuttlebay,/area/prefab/safehouse)
"EM" = (/obj/item/paper/safehouse/delivery_note{pixel_x = -5; pixel_y = -1},/obj/decal/fakeobjects/beacon{pixel_x = 1},/turf/simulated/floor/plating/airless/asteroid,/area/noGenerate)
"EN" = (/obj/ladder{icon_state = "ladder_wall"; id = "saferoom"; pixel_y = 20},/obj/decal/fakeobjects/lighttube_broken{pixel_y = -10},/turf/simulated/floor/neutral,/area/prefab/safehouse)
"Fa" = (/obj/machinery/bio_handscanner{pixel_y = 29},/turf/simulated/floor/neutral,/area/prefab/safehouse)
"Fn" = (/turf/simulated/floor/carpet/red/fancy/narrow/T_west,/area/prefab/safehouse)
"Fs" = (/turf/simulated/floor/airless/stairs,/area/prefab/safehouse)
"Gp" = (/turf/simulated/wall/false_wall/reinforced,/area/prefab/safehouse)
"GD" = (/obj/machinery/power/terminal,/obj/cable,/turf/simulated/floor/plating,/area/prefab/safehouse)
"Hm" = (/obj/storage/crate/packing{layer = 2.9},/obj/item/storage/box/lightbox/bulbs{pixel_x = 5},/obj/decal/fakeobjects/lighttube_broken{desc = "This light might be broken.  It's probably not wired up, though."; dir = 4; icon_state = "tube0"; layer = 4; name = "inactive light tube"; pixel_x = 10; tag = "icon-tube-broken (NORTH)"},/obj/item/paper/safehouse/contractors_note{layer = 3.2; pixel_x = -5; pixel_y = -9},/obj/decal/cleanable/dirt,/obj/item/device/reagentscanner{pixel_x = -5},/turf/simulated/floor/plating,/area/prefab/safehouse)
"HL" = (/turf/simulated/floor/specialroom/bar,/area/prefab/safehouse)
"Il" = (/turf/unsimulated/wall/auto/reinforced/supernorn,/area/prefab/safehouse)
"IS" = (/obj/decal/cleanable/paper,/turf/simulated/floor/plating,/area/prefab/safehouse)
"Ke" = (/obj/table/reinforced/bar/auto,/obj/item/device/light/zippo/gold,/obj/decal/tile_edge/line/grey{icon_state = "line1"},/turf/simulated/floor/specialroom/bar,/area/prefab/safehouse)
"Kz" = (/turf/simulated/floor/bluewhite/corner,/area/prefab/safehouse)
"MT" = (/obj/table/reinforced/bar/auto,/obj/item/plate{desc = "You bet your grandma would like this."; name = "antique plate"},/obj/item/kitchen/utensil/fork{pixel_x = 10},/obj/item/reagent_containers/food/snacks/burger/moldy,/obj/item/reagent_containers/food/drinks/drinkingglass/random_style{pixel_x = -11; pixel_y = 12},/obj/decal/tile_edge/line/grey{icon_state = "line1"},/turf/simulated/floor/specialroom/bar,/area/prefab/safehouse)
"Nd" = (/obj/decal/floatingtiles,/turf/space,/area/noGenerate)
"NB" = (/obj/stool/chair/couch/red{dir = 8},/turf/simulated/floor/carpet/red/fancy/narrow/T_north,/area/prefab/safehouse)
"Op" = (/obj/machinery/door/unpowered/wood/pyro,/turf/simulated/floor/wood/two,/area/prefab/safehouse)
"Ou" = (/obj/stool/chair/couch/red{dir = 4},/turf/simulated/floor/carpet/red/fancy/narrow/ne,/area/prefab/safehouse)
"Pn" = (/obj/decal/fakeobjects/pipe{desc = "Part of the area's air supply system."},/obj/item/device/analyzer/atmospheric/upgraded,/turf/simulated/floor/plating,/area/prefab/safehouse)
"Pv" = (/obj/decal/fakeobjects{anchored = 1; desc = "A vent. You can't feel any airflow."; icon = 'icons/obj/atmospherics/pipe_vent.dmi'; icon_state = "hvent"; name = "air vent"},/obj/decal/cleanable/dirt/dirt3,/turf/simulated/floor/airless,/area/prefab/safehouse)
"Qc" = (/obj/decal/cleanable/oil/streak,/obj/machinery/light{brightness = 1.4; dir = 4; layer = 9.1; name = "worn light fixture"; pixel_x = 10},/turf/simulated/floor/shuttlebay,/area/prefab/safehouse)
"RE" = (/obj/machinery/r_door_control{id = "podbay_safehouse"},/turf/simulated/wall/auto/reinforced/supernorn,/area/prefab/safehouse)
"RR" = (/turf/space,/area/noGenerate)
"Sr" = (/obj/machinery/door/poddoor/blast/asteroid/podbay_autoclose/asteroid_horizontal{id = "podbay_safehouse"},/obj/forcefield/energyshield/perma/doorlink{desc = "A door-linked force field that prevents gasses from passing through it."; name = "Door-linked Atmospheric Forcefield"; powerlevel = 1},/turf/simulated/floor/plating/airless/asteroid,/area/prefab/safehouse/asteroiddoors)
"SW" = (/obj/stool/bar,/turf/simulated/floor/carpet/red/standard/narrow/west,/area/prefab/safehouse)
"TW" = (/obj/table/wood/round,/obj/decal/fakeobjects/recordplayer{pixel_y = 4},/obj/machinery/light{brightness = 1.4; dir = 8; layer = 9.1; name = "worn light fixture"; pixel_x = -10},/turf/simulated/floor/carpet/red/decal/outercross,/area/prefab/safehouse)
"UL" = (/obj/machinery/shower,/obj/window/cubicle{dir = 8},/obj/machinery/door/window/eastleft{dir = 1},/obj/machinery/drainage,/turf/simulated/floor/blue,/area/prefab/safehouse)
"UM" = (/turf/space,/area/allowGenerate)
"UV" = (/obj/decal/cleanable/fungus,/turf/simulated/wall/auto/reinforced/supernorn,/area/prefab/safehouse)
"Vt" = (/turf/simulated/floor/plating/airless/asteroid,/area/noGenerate)
"Wi" = (/turf/simulated/floor/neutral,/area/prefab/safehouse)
"Wl" = (/obj/stool/bar,/turf/simulated/floor/carpet/red/standard/narrow/east,/area/prefab/safehouse)
"Wt" = (/obj/table/wood/auto,/obj/item/reagent_containers/food/drinks/drinkingglass/oldf{pixel_x = 4},/turf/unsimulated/floor/carpet/red/fancy/innercorner/omni,/area/prefab/safehouse)
"WS" = (/obj/table/wood/auto,/obj/item/decoration/ashtray,/obj/item/clothing/mask/cigarette/cigar{pixel_y = 6},/obj/machinery/light{brightness = 1.4; dir = 4; layer = 9.1; name = "worn light fixture"; pixel_x = 10},/turf/simulated/floor/carpet/red/fancy/narrow/T_east,/area/prefab/safehouse)
"WZ" = (/turf/simulated/floor/wood,/area/prefab/safehouse)
"XO" = (/obj/machinery/atmospherics/pipe/tank/air{volume = 0},/obj/decal/fakeobjects/lighttube_broken{dir = 1; pixel_y = 10},/turf/simulated/floor/plating,/area/prefab/safehouse)
"Yk" = (/obj/storage/secure/closet/fridge,/obj/item/reagent_containers/iv_drip/dead_exec{layer = 3.1; pixel_x = 5},/obj/item/reagent_containers/iv_drip/dead_exec{layer = 3.1},/turf/simulated/floor/bluewhite{dir = 9},/area/prefab/safehouse)
"Yq" = (/obj/decal/cleanable/cobweb{icon_state = "cobweb2"},/turf/simulated/floor/neutral,/area/prefab/safehouse)
"YA" = (/turf/simulated/wall/auto/reinforced/supernorn,/area/prefab/safehouse)
"YK" = (/obj/machinery/power/smes{charge = 1e7; chargelevel = 1e5},/turf/simulated/floor/plating,/area/prefab/safehouse)
"YZ" = (/obj/machinery/power/apc/autoname_north,/obj/cable{d2 = 4; icon_state = "0-4"},/turf/simulated/floor/plating,/area/prefab/safehouse)
"Zb" = (/obj/machinery/door/airlock/external,/obj/access_spawn/public,/obj/decal/cleanable/dirt/dirt5,/turf/simulated/floor/neutral,/area/prefab/safehouse)
"Zd" = (/turf/simulated/wall/asteroid,/area/noGenerate)
"Zf" = (/turf/simulated/floor/carpet/red/standard/narrow/east,/area/prefab/safehouse)
"Zm" = (/turf/simulated/floor/carpet/red/fancy/edge,/area/prefab/safehouse)
"Zw" = (/obj/stool/chair/couch/red{dir = 9},/turf/simulated/floor/carpet/red/fancy/narrow/T_south,/area/prefab/safehouse)

(1,1,1) = {"
UMUMUMUMZdUMUMUMZdZdUMUMUMUMUMUMUMUMUMUMUMUMUMUMUMUMUMUMUMUMUMUMUM
UMUMUMZdZdZdUMZdZdZdZdUMUMUMUMUMUMUMUMUMUMUMUMUMUMUMUMUMZdUMUMUMUM
UMUMZdZdZdZdZdZdZdZdZdZdUMZdZdUMUMUMUMUMUMUMUMUMUMUMUMZdZdZdUMUMUM
UMVtZdIlIlIlIlIlIlIlZdZdZdZdZdVtUMUMUMZdUMUMUMUMZdUMZdZdZdZdUMUMUM
ZdZdZdIlcrdhetgfghIlZdYAYAYAZdZdVtVtVtZdZdZdZdUMZdZdZdZdZdZdZdUMUM
UMZdZdIlgjhpzoDmhxIlZdYAaEYAZdZdVtZdZdZdZdZdZdZdZdZdZdZdZdZdZdUMUM
UMUMZdIlidiigodKeqIlYAYAGpYAYAYAZdZdZdZdYAYAYAYAYAYAYAYAYAYAZdZdUM
UMZdZdIlIlcgklkCIlIlYAcykNeImBYAYAYAYAYAYAWiZblYWilOuePvnFYAYAZdZd
UMUMZdZdZdIlIlorIlYAYAcjZmZmnpYAouoxpJpTxIFsYAkBrfYAueuetJrqYAZdUM
UMUMUMZdZdYAFaWiYqYAYAwIwIgzDuYAnKHLHLHLHLHLYAYAYAYAwpEdEdEdYAZdZd
UMRRRREMZdYAWiENWiYAYAYAuQYAYAYADjMTDjKelhxmNBOuYAYADAEdEdQcYAZdZd
UMRRRRVtZdYAYAYAYAYAkLWZpllvkLYASWymymWlWZFnWtWSYAYAEdEdEdEdREZdZd
UMUMUMZdZdYAXOYZyHlGljDlmMDlZfmyWZWZWZWZWZwAZwnsYAZdDcDcDcSrZdZdUM
UMUMUMVtZdYAvPnzGDYAYAOpYAYAYAYAYAWZWZWZoMYAYAYAYAZdRRRRRRRRZdZdZd
UMUMUMZdZdYAAsPnYKYArmzKYArKwynQYATWrIWZoMaMCWYAZdZdRRRRRRRRRRZdUM
UMUMZdZdZdYAYAYAYAYAyxULYAnWISHmYAYAYAfpYAYAYAYAZdRRRRRRRRRRRRUMUM
UMUMUMUMZdZdZdZdZdYAYAUVYAmfjjpAYAYkoYiLeXYAZdZdZdRRRRRRRRkPRRUMUM
UMUMUMUMUMUMZdZdZdZdZdZdYAYAYAYAYAenuvKzotYAZdZdZdVtVtRRRRRRRRUMUM
UMUMUMUMUMUMUMZdZdVtZdUMZdZdZdZdYAcIsNlFYAYAZdVtZdwcZdZdUMUMUMUMUM
UMUMUMUMUMUMUMUMZdVtUMUMUMUMUMZdYAYAYAYAYAZdZdUMZdZdZdZdUMUMUMUMUM
UMUMUMUMUMUMUMUMZdZdZdUMUMUMUMUMZdZdZdZdZdZdUMUMNdZdZdUMUMUMUMUMUM
UMUMUMUMUMUMUMUMUMZdUMUMUMUMUMUMUMUMZdZdUMUMUMUMUMUMUMUMUMUMUMUMUM
"}
