//MAP CONVERTED BY dmm2tgm.py THIS HEADER COMMENT PREVENTS RECONVERSION, DO NOT REMOVE
"a" = (
/turf/space,
/area/allowGenerate)
"r" = (
/obj/decal/cleanable/blood/gibs,
/turf/space,
/area/allowGenerate)
"V" = (
/obj/item/mine/stun/armed,
/obj/dialogueobj/syndiecorpse2,
/turf/space,
/area/allowGenerate)
"Z" = (
/obj/decal/cleanable/blood/gibs/body,
/turf/space,
/area/allowGenerate)

(1,1,1) = {"
a
a
a
a
"}
(2,1,1) = {"
a
r
r
a
"}
(3,1,1) = {"
a
V
r
a
"}
(4,1,1) = {"
a
a
a
Z
"}
