//MAP CONVERTED BY dmm2tgm.py THIS HEADER COMMENT PREVENTS RECONVERSION, DO NOT REMOVE
"a" = (
/turf/variableTurf/clear,
/area/space)
"b" = (
/turf/unsimulated/floor/setpieces/bloodfloor)
"d" = (
/obj/neon_lining{
	color = "#AA0000";
	dir = 1
	},
/turf/unsimulated/wall/auto/adventure/meat/meatier,
/area/space)
"h" = (
/obj/lattice{
	dir = 10;
	icon_state = "lattice-dir"
	},
/turf/variableTurf/clear,
/area/space)
"j" = (
/obj/neon_lining{
	color = "#AA0033";
	dir = 4
	},
/turf/unsimulated/floor/stairs/wide/other)
"k" = (
/turf/unsimulated/wall/auto/adventure/meat,
/area/space)
"l" = (
/obj/machinery/vending/meat/prefab_grill,
/turf/unsimulated/floor/setpieces/bloodfloor)
"m" = (
/obj/neon_lining{
	color = "#AA0033";
	dir = 4
	},
/turf/unsimulated/floor/setpieces/bloodfloor{
	icon_state = "bloodfloor_3"
	})
"n" = (
/turf/unsimulated/wall/auto/adventure/meat/meatier,
/area/space)
"p" = (
/obj/neon_lining{
	color = "#AA0000";
	dir = 1
	},
/turf/unsimulated/floor/setpieces/bloodfloor)
"v" = (
/obj/neon_lining{
	color = "#AA0033";
	dir = 8
	},
/turf/unsimulated/floor/stairs/wide)
"w" = (
/obj/lattice,
/turf/variableTurf/clear,
/area/space)
"x" = (
/obj/railing/red/reinforced{
	dir = 4
	},
/turf/unsimulated/floor/scorched2)
"A" = (
/obj/neon_lining{
	color = "#AA0000";
	dir = 1
	},
/turf/unsimulated/floor/setpieces/bloodfloor{
	icon_state = "bloodfloor_2";
	name = "Fleshy Floor"
	})
"B" = (
/turf/unsimulated/floor/stairs/wide/middle)
"C" = (
/obj/railing/red/reinforced{
	dir = 8
	},
/turf/unsimulated/floor/scorched2)
"G" = (
/turf/unsimulated/floor/scorched2)
"H" = (
/obj/neon_lining{
	color = "#AA0033";
	dir = 8
	},
/turf/unsimulated/floor/setpieces/bloodfloor{
	icon_state = "bloodfloor_3"
	})
"I" = (
/obj/railing/red/reinforced{
	dir = 4
	},
/turf/unsimulated/floor/stairs/wide/other)
"J" = (
/turf/unsimulated/floor/setpieces/bloodfloor{
	icon_state = "bloodfloor_3"
	})
"K" = (
/turf/unsimulated/floor/setpieces/bloodfloor{
	icon_state = "bloodfloor_2";
	name = "Fleshy Floor"
	})
"R" = (
/obj/railing/red/reinforced{
	dir = 8
	},
/turf/unsimulated/floor/stairs/wide)
"X" = (
/obj/ladder{
	icon_state = "ladder_wall";
	id = "fartnasium5";
	pixel_y = 20
	},
/turf/unsimulated/floor/setpieces/bloodfloor)
"Y" = (
/obj/neon_lining{
	color = "#AA0000";
	dir = 1
	},
/obj/machinery/shitty_grill{
	anchored = 0;
	name = "unchained shitty grill"
	},
/turf/unsimulated/floor/setpieces/bloodfloor{
	icon_state = "bloodfloor_2";
	name = "Fleshy Floor"
	})
"Z" = (
/turf/unsimulated/wall/auto/adventure/meat/eyes,
/area/space)

(1,1,1) = {"
a
k
k
k
a
a
a
a
a
a
"}
(2,1,1) = {"
k
d
J
k
k
k
k
k
k
a
"}
(3,1,1) = {"
k
J
J
J
J
J
v
G
k
k
"}
(4,1,1) = {"
k
p
J
n
b
J
I
x
G
k
"}
(5,1,1) = {"
k
k
X
Z
A
b
H
v
G
G
"}
(6,1,1) = {"
a
Z
n
n
Y
K
J
B
G
G
"}
(7,1,1) = {"
a
a
n
Z
A
b
m
j
G
G
"}
(8,1,1) = {"
a
a
n
l
b
J
R
C
G
k
"}
(9,1,1) = {"
a
a
k
k
J
J
j
G
w
a
"}
(10,1,1) = {"
a
a
a
k
k
k
k
k
h
a
"}
