"bM" = (/obj/decoration/bookcase{pixel_y = 28},/turf/simulated/floor/carpet/purple/standard/edge/nw,/area/prefab/furniture_store)
"cT" = (/turf/simulated/floor/carpet/purple/standard/innercorner/east,/area/prefab/furniture_store)
"db" = (/obj/table/reinforced/industrial,/turf/simulated/floor/blackwhite{dir = 1},/area/prefab/furniture_store)
"dj" = (/obj/stool/chair/wooden{dir = 1},/obj/machinery/light/incandescent/harsh/very{dir = 4},/turf/simulated/floor/blackwhite/side,/area/prefab/furniture_store)
"dA" = (/obj/railing/purple{dir = 8},/turf/simulated/floor/carpet/purple/standard/edge/west,/area/prefab/furniture_store)
"dY" = (/turf/simulated/floor/sanitary/blue,/area/prefab/furniture_store)
"eH" = (/obj/table/auto{name = "tabell"},/turf/simulated/floor/blackwhite{dir = 1},/area/prefab/furniture_store)
"eQ" = (/obj/decoration/decorativeplant/plant5,/turf/simulated/floor/grey,/area/prefab/furniture_store)
"fw" = (/obj/machinery/vending/cola/red,/obj/machinery/light/worn{dir = 4},/turf/simulated/floor/wood/three,/area/prefab/furniture_store)
"fz" = (/obj/table/round{name = "An almost circular table"},/turf/simulated/floor/blackwhite{dir = 1},/area/prefab/furniture_store)
"fK" = (/turf/simulated/floor/wood,/area/prefab/furniture_store)
"gj" = (/obj/decoration/decorativeplant/plant3,/obj/machinery/light/small/floor/harsh/very,/turf/simulated/floor/grey,/area/prefab/furniture_store)
"gK" = (/obj/decoration/decorativeplant/plant2,/obj/railing/orange,/obj/railing/orange{dir = 4},/turf/simulated/floor/wood,/area/prefab/furniture_store)
"hb" = (/obj/rack,/obj/item/constructioncone,/obj/item/constructioncone,/obj/item/constructioncone,/obj/item/constructioncone,/turf/simulated/floor/industrial,/area/prefab/furniture_store)
"hl" = (/obj/decoration/decorativeplant/plant4,/turf/simulated/floor/wood/three,/area/prefab/furniture_store)
"hw" = (/obj/lattice,/turf/space,/area/prefab/furniture_store)
"hN" = (/obj/item/plant/flower/rose,/obj/item/plant/flower/rose,/obj/item/plant/flower/rose,/obj/table/glass/auto,/obj/railing/green{dir = 8},/obj/railing/green,/turf/simulated/grass,/area/prefab/furniture_store)
"ii" = (/obj/machinery/light/incandescent/harsh/very{dir = 1},/turf/simulated/floor/white,/area/prefab/furniture_store)
"ir" = (/obj/rack/lunar,/obj/item/robot_module/construction_worker,/turf/simulated/floor/industrial,/area/prefab/furniture_store)
"ix" = (/obj/machinery/light/small/floor/warm/very,/turf/simulated/floor/carpet/purple,/area/prefab/furniture_store)
"iR" = (/obj/rack/lunar,/obj/item/clothing/head/helmet/space/engineer/april_fools{pixel_x = -8; pixel_y = 7},/obj/item/clothing/suit/space/engineer/april_fools{pixel_x = 2; pixel_y = -4},/turf/simulated/floor/industrial,/area/prefab/furniture_store)
"ja" = (/turf/simulated/grass,/area/prefab/furniture_store)
"jh" = (/obj/decoration/decorativeplant/plant5,/turf/simulated/floor/wood/three,/area/prefab/furniture_store)
"jq" = (/obj/potted_plant/potted_plant2,/turf/simulated/grass,/area/prefab/furniture_store)
"jD" = (/obj/rack,/obj/random_item_spawner/furniture_parts/some,/turf/simulated/floor/industrial,/area/prefab/furniture_store)
"kG" = (/obj/item/decoration/flower_vase/vase7{name = "växt"},/obj/machinery/light/small/floor/netural,/obj/table/reinforced/bar/auto,/turf/simulated/floor/wood,/area/prefab/furniture_store)
"lb" = (/obj/machinery/vending/snack,/turf/simulated/floor/wood/three,/area/prefab/furniture_store)
"li" = (/obj/table/reinforced/industrial,/obj/item/reagent_containers/food/snacks/burger/moldy,/turf/simulated/floor/industrial,/area/prefab/furniture_store)
"lw" = (/obj/stool/chair/pew,/turf/simulated/floor/blackwhite,/area/prefab/furniture_store)
"lD" = (/turf/simulated/floor/carpet/purple/standard/innercorner/west,/area/prefab/furniture_store)
"lI" = (/obj/machinery/light/worn,/turf/simulated/floor/setpieces/hivefloor,/area/prefab/furniture_store)
"mf" = (/obj/railing/yellow/reinforced{dir = 1},/turf/simulated/floor/setpieces/hivefloor,/area/prefab/furniture_store)
"mL" = (/turf/space,/area/allowGenerate)
"nm" = (/obj/item/clothing/suit/cardboard_box,/obj/machinery/light/incandescent/warm,/turf/simulated/floor/industrial,/area/prefab/furniture_store)
"oo" = (/turf/simulated/floor/specialroom/cafeteria,/area/prefab/furniture_store)
"op" = (/turf/space,/area/noGenerate)
"oL" = (/obj/rack/lunar,/obj/item/lamp_manufacturer/organic,/turf/simulated/floor/industrial,/area/prefab/furniture_store)
"pH" = (/obj/stool/chair/office/blue,/obj/machinery/light/worn{dir = 1},/obj/critter/parrot/kea/ikea,/turf/simulated/floor/wood/three,/area/prefab/furniture_store)
"pM" = (/obj/machinery/light/flamp,/turf/simulated/floor/grey,/area/prefab/furniture_store)
"pX" = (/turf/simulated/floor/wood/three,/area/prefab/furniture_store)
"rj" = (/turf/simulated/floor/industrial,/area/prefab/furniture_store)
"rl" = (/turf/simulated/floor/carpet/purple,/area/prefab/furniture_store)
"rN" = (/obj/potted_plant/potted_plant3,/turf/simulated/grass,/area/prefab/furniture_store)
"sw" = (/obj/table/wood/auto/desk,/obj/machinery/light/small/floor/harsh/very,/turf/simulated/floor/wood/three,/area/prefab/furniture_store)
"ta" = (/obj/table/reinforced/industrial,/obj/random_item_spawner/furniture_parts/one,/turf/simulated/floor/industrial,/area/prefab/furniture_store)
"tp" = (/obj/machinery/light/worn{dir = 8},/turf/simulated/floor/grey,/area/prefab/furniture_store)
"tq" = (/obj/table/folding,/obj/machinery/light/worn,/turf/simulated/floor/blackwhite{dir = 1},/area/prefab/furniture_store)
"tz" = (/obj/lattice{dir = 9; icon_state = "lattice-dir"},/turf/space,/area/prefab/furniture_store)
"tH" = (/obj/machinery/light/incandescent/harsh/very{dir = 4},/obj/table/glass/reinforced,/turf/simulated/floor/blackwhite,/area/prefab/furniture_store)
"ua" = (/obj/stool/chair/comfy/barber_chair,/obj/machinery/light/worn{dir = 1},/turf/simulated/floor/blackwhite,/area/prefab/furniture_store)
"um" = (/obj/stool/chair/wooden,/turf/simulated/floor/wood,/area/prefab/furniture_store)
"un" = (/obj/machinery/light/small/floor/cool/very,/turf/simulated/floor/specialroom/cafeteria,/area/prefab/furniture_store)
"uu" = (/turf/simulated/floor/stairs,/area/prefab/furniture_store)
"vx" = (/obj/table/wood/auto/desk,/obj/machinery/light/lamp/green,/obj/railing/purple,/obj/machinery/light/small/floor/warm,/turf/simulated/floor/carpet/purple/standard/edge/south,/area/prefab/furniture_store)
"vG" = (/obj/rack/lunar,/obj/item/sheet/steel/fullstack,/turf/simulated/floor/industrial,/area/prefab/furniture_store)
"vX" = (/obj/submachine/chef_sink/chem_sink{dir = 1},/turf/simulated/floor/specialroom/cafeteria,/area/prefab/furniture_store)
"wh" = (/obj/stool/chair/office/red{dir = 1},/turf/simulated/floor/blackwhite/side,/area/prefab/furniture_store)
"wj" = (/obj/lattice{dir = 9; icon_state = "lattice-dir-b"},/turf/space,/area/prefab/furniture_store)
"xq" = (/obj/machinery/light/small/floor/greenish,/obj/table/reinforced/bar/auto,/turf/simulated/floor/wood,/area/prefab/furniture_store)
"xu" = (/obj/machinery/coffeemaker,/obj/railing/cyan{dir = 1},/obj/machinery/light/small/floor/warm,/obj/table/reinforced/chemistry/auto,/turf/simulated/floor/specialroom/cafeteria,/area/prefab/furniture_store)
"yf" = (/obj/machinery/light/worn{dir = 8},/turf/simulated/floor/wood/three,/area/prefab/furniture_store)
"yk" = (/obj/machinery/door/airlock/pyro/glass{dir = 8},/turf/simulated/floor/white,/area/prefab/furniture_store)
"yx" = (/obj/machinery/microwave,/obj/railing/cyan{dir = 8},/obj/railing/cyan{dir = 1},/obj/table/reinforced/chemistry/auto,/turf/simulated/floor/specialroom/cafeteria,/area/prefab/furniture_store)
"yI" = (/obj/table/wood/auto/desk,/obj/item/reagent_containers/food/snacks/swedishmeatball,/turf/simulated/floor/wood/three,/area/prefab/furniture_store)
"yL" = (/obj/decoration/decorativeplant/plant7,/obj/railing/green,/turf/simulated/grass,/area/prefab/furniture_store)
"yP" = (/obj/stool/chair/red{dir = 1},/obj/machinery/light/incandescent/harsh/very{dir = 8},/turf/simulated/floor/blackwhite/side,/area/prefab/furniture_store)
"yQ" = (/obj/decoration/bookcase{pixel_y = 28},/turf/simulated/floor/carpet/purple/standard/edge/ne,/area/prefab/furniture_store)
"zn" = (/obj/railing{dir = 4},/turf/simulated/floor/sanitary/blue,/area/prefab/furniture_store)
"zN" = (/obj/table/reinforced/chemistry,/turf/simulated/floor/blackwhite,/area/prefab/furniture_store)
"zP" = (/obj/stool/chair/office/blue{dir = 1; tag = "icon-office_chair_blue (NORTH)"},/turf/simulated/floor/blackwhite/side,/area/prefab/furniture_store)
"zU" = (/obj/table/wood/auto/desk,/obj/random_item_spawner/desk_stuff/seven,/obj/railing/purple,/obj/railing/purple{dir = 4},/turf/simulated/floor/carpet/purple/standard/edge/se,/area/prefab/furniture_store)
"Aa" = (/obj/lattice{dir = 10; icon_state = "lattice-dir"},/turf/space,/area/prefab/furniture_store)
"Ax" = (/mob/living/critter/small_animal/bee/beestation,/obj/railing/yellow/reinforced{dir = 1},/obj/railing/yellow/reinforced{dir = 4},/turf/simulated/floor/setpieces/hivefloor,/area/prefab/furniture_store)
"AY" = (/obj/machinery/light/small/floor/harsh/very,/turf/simulated/floor/industrial,/area/prefab/furniture_store)
"Bk" = (/obj/decoration/decorativeplant/plant3,/turf/simulated/grass,/area/prefab/furniture_store)
"Bu" = (/obj/machinery/light/small/floor/greenish,/turf/simulated/grass,/area/prefab/furniture_store)
"BA" = (/obj/table/reinforced,/obj/machinery/computer/security/wooden_tv{desc = "Looks like it's tuned to your station."},/obj/railing/orange{dir = 4},/obj/machinery/light/small/floor/netural,/turf/simulated/floor/wood,/area/prefab/furniture_store)
"BC" = (/obj/stool/chair/wooden{dir = 1},/obj/railing/orange,/turf/simulated/floor/wood,/area/prefab/furniture_store)
"BN" = (/obj/railing/green{dir = 8},/obj/machinery/light/incandescent/harsh/very{dir = 1},/turf/simulated/grass,/area/prefab/furniture_store)
"Cx" = (/obj/potted_plant/potted_plant4,/obj/railing/green,/turf/simulated/grass,/area/prefab/furniture_store)
"DF" = (/obj/machinery/light/worn,/turf/simulated/floor/wood/three,/area/prefab/furniture_store)
"DI" = (/obj/lattice{dir = 4; icon_state = "lattice-dir"; tag = "icon-lattice-dir (EAST)"},/turf/space,/area/prefab/furniture_store)
"DJ" = (/obj/submachine/chef_oven,/turf/simulated/floor/specialroom/cafeteria,/area/prefab/furniture_store)
"FW" = (/obj/item/kitchen/food_box,/obj/railing/cyan{dir = 1},/obj/table/reinforced/chemistry/auto,/turf/simulated/floor/specialroom/cafeteria,/area/prefab/furniture_store)
"Gc" = (/obj/machinery/light/incandescent/warm,/turf/simulated/floor/industrial,/area/prefab/furniture_store)
"Gd" = (/turf/simulated/wall/r_wall,/area/prefab/furniture_store)
"GS" = (/obj/machinery/light/worn{dir = 4},/obj/decoration/decorativeplant/plant7,/turf/simulated/floor/grey,/area/prefab/furniture_store)
"He" = (/obj/stool/bee_bed,/obj/railing/yellow/reinforced{dir = 4},/turf/simulated/floor/setpieces/hivefloor,/area/prefab/furniture_store)
"HN" = (/obj/submachine/chef_sink/chem_sink{desc = "A water-filled unit intended for hand-washing purposes."; dir = 4; pixel_x = -5},/obj/machinery/light/small/floor/blueish,/turf/simulated/floor/sanitary/blue,/area/prefab/furniture_store)
"If" = (/obj/table/reinforced/industrial,/obj/item/clothing/ears/earmuffs,/turf/simulated/floor/industrial,/area/prefab/furniture_store)
"Ip" = (/obj/decoration/decorativeplant/plant5,/obj/machinery/light/small/floor/harsh/very,/turf/simulated/floor/grey,/area/prefab/furniture_store)
"JN" = (/obj/table/reinforced/industrial,/turf/simulated/floor/industrial,/area/prefab/furniture_store)
"JV" = (/obj/machinery/light/small/floor/netural,/obj/table/reinforced/bar/auto,/turf/simulated/floor/wood,/area/prefab/furniture_store)
"Kd" = (/obj/decoration/decorativeplant/plant6,/turf/simulated/grass,/area/prefab/furniture_store)
"Km" = (/obj/potted_plant/potted_plant5,/obj/railing/green,/turf/simulated/grass,/area/prefab/furniture_store)
"Kn" = (/obj/machinery/door/airlock/pyro/glass/engineering{name = "storage room airlock"},/turf/simulated/floor/industrial,/area/prefab/furniture_store)
"Ls" = (/obj/storage/secure/closet/fridge/kitchen{locked = 0},/turf/simulated/floor/specialroom/cafeteria,/area/prefab/furniture_store)
"LW" = (/obj/stool/chair/office,/obj/railing/purple{dir = 4},/turf/simulated/floor/carpet/purple/standard/edge/east,/area/prefab/furniture_store)
"Mt" = (/obj/stool/chair/comfy/green,/turf/simulated/floor/blackwhite,/area/prefab/furniture_store)
"MC" = (/obj/lattice{dir = 5; icon_state = "lattice-dir"},/turf/space,/area/prefab/furniture_store)
"MV" = (/obj/item/item_box/swedish_bag,/obj/railing/cyan{dir = 1},/obj/table/reinforced/chemistry/auto,/turf/simulated/floor/specialroom/cafeteria,/area/prefab/furniture_store)
"Nv" = (/obj/table/hibachi{name = "A totally swedish table!"},/turf/simulated/floor/blackwhite{dir = 1},/area/prefab/furniture_store)
"Nw" = (/obj/railing/cyan{dir = 8},/obj/table/reinforced/chemistry/auto,/turf/simulated/floor/specialroom/cafeteria,/area/prefab/furniture_store)
"Ny" = (/mob/living/critter/small_animal/bee/beestation,/obj/stool/bee_bed,/obj/railing/yellow/reinforced{dir = 8},/turf/simulated/floor/setpieces/hivefloor,/area/prefab/furniture_store)
"NC" = (/obj/decoration/decorativeplant/plant2,/obj/railing/green,/turf/simulated/grass,/area/prefab/furniture_store)
"NM" = (/obj/machinery/light/small/floor/harsh,/turf/simulated/floor/white,/area/prefab/furniture_store)
"NS" = (/obj/railing/orange,/turf/simulated/floor/wood,/area/prefab/furniture_store)
"Ox" = (/obj/rack,/obj/item/storage/toolbox/electrical,/turf/simulated/floor/industrial,/area/prefab/furniture_store)
"OY" = (/obj/decoration/decorativeplant/plant4,/obj/machinery/light/small/floor/harsh/very,/turf/simulated/floor/grey,/area/prefab/furniture_store)
"Pd" = (/turf/simulated/floor/grey,/area/prefab/furniture_store)
"Pw" = (/obj/machinery/vending/kitchen,/turf/simulated/floor/specialroom/cafeteria,/area/prefab/furniture_store)
"PG" = (/turf/simulated/floor/white,/area/prefab/furniture_store)
"Ql" = (/obj/machinery/shower{dir = 8; pixel_y = 6},/obj/machinery/drainage,/turf/simulated/floor/sanitary/blue,/area/prefab/furniture_store)
"Qw" = (/turf/simulated/floor/blackwhite,/area/prefab/furniture_store)
"QG" = (/turf/simulated/floor/blackwhite/side,/area/prefab/furniture_store)
"Rj" = (/obj/table/reinforced/industrial,/obj/random_item_spawner/furniture_parts/lots,/turf/simulated/floor/industrial,/area/prefab/furniture_store)
"Se" = (/obj/rack,/obj/item/reagent_containers/food/snacks/swedishmeatball,/turf/simulated/floor/industrial,/area/prefab/furniture_store)
"Sm" = (/turf/simulated/wall/auto/reinforced/supernorn,/area/prefab/furniture_store)
"Sv" = (/obj/table/wood,/turf/simulated/floor/blackwhite,/area/prefab/furniture_store)
"Sy" = (/obj/railing{dir = 1},/obj/railing{dir = 4},/obj/submachine/laundry_machine,/turf/simulated/floor/sanitary/blue,/area/prefab/furniture_store)
"SB" = (/obj/rack,/obj/random_item_spawner/furniture_parts/one,/turf/simulated/floor/industrial,/area/prefab/furniture_store)
"SC" = (/obj/machinery/light/small/floor/greenish,/obj/item/storage/box/plates,/obj/table/reinforced/bar/auto,/turf/simulated/floor/wood,/area/prefab/furniture_store)
"SJ" = (/obj/decoration/decorativeplant/plant7,/turf/simulated/floor/grey,/area/prefab/furniture_store)
"SM" = (/obj/item/storage/toilet,/obj/railing{dir = 1},/turf/simulated/floor/sanitary/blue,/area/prefab/furniture_store)
"SS" = (/obj/random_item_spawner/tableware,/obj/railing/cyan{dir = 8},/obj/table/reinforced/chemistry/auto,/turf/simulated/floor/specialroom/cafeteria,/area/prefab/furniture_store)
"Tw" = (/obj/stool/bed,/obj/item/clothing/suit/bedsheet/black,/obj/railing/purple{dir = 8},/obj/railing/purple,/turf/simulated/floor/carpet/purple/standard/edge/sw,/area/prefab/furniture_store)
"Uf" = (/obj/railing{dir = 4},/obj/machinery/bathtub{anchored = 1; dir = 4},/turf/simulated/floor/sanitary/blue,/area/prefab/furniture_store)
"Uv" = (/obj/table/reinforced/industrial,/obj/random_item_spawner/furniture_parts/some,/turf/simulated/floor/industrial,/area/prefab/furniture_store)
"UX" = (/obj/table/reinforced/auto{name = "A table reinforced with swedium"},/obj/machinery/light/incandescent/harsh/very{dir = 8},/turf/simulated/floor/blackwhite,/area/prefab/furniture_store)
"Vc" = (/obj/machinery/recharge_station,/turf/simulated/floor/wood/three,/area/prefab/furniture_store)
"VE" = (/obj/table/reinforced/industrial,/obj/item/storage/toolbox/mechanical,/turf/simulated/floor/industrial,/area/prefab/furniture_store)
"VF" = (/obj/lattice{dir = 5; icon_state = "lattice-dir-b"},/turf/space,/area/prefab/furniture_store)
"VK" = (/obj/machinery/door/airlock/pyro/external,/turf/simulated/floor/wood/three,/area/prefab/furniture_store)
"VS" = (/turf/simulated/floor/black,/area/prefab/furniture_store)
"VW" = (/obj/machinery/light/small/floor/warm,/turf/simulated/floor/white,/area/prefab/furniture_store)
"Wb" = (/obj/railing/yellow/reinforced{dir = 1},/obj/railing/yellow/reinforced{dir = 8},/turf/simulated/floor/setpieces/hivefloor,/area/prefab/furniture_store)
"Wd" = (/obj/submachine/ice_cream_dispenser,/turf/simulated/floor/specialroom/cafeteria,/area/prefab/furniture_store)
"Wj" = (/obj/item/clothing/suit/cardboard_box,/turf/simulated/floor/industrial,/area/prefab/furniture_store)
"Wl" = (/obj/stool/chair/comfy/yellow,/turf/simulated/floor/blackwhite,/area/prefab/furniture_store)
"WI" = (/obj/decoration/bookcase{pixel_y = 28},/obj/machinery/light/small/floor/warm/very,/turf/simulated/floor/carpet/purple,/area/prefab/furniture_store)
"WN" = (/turf/space,/area/prefab/furniture_store)
"Xw" = (/obj/rack,/turf/simulated/floor/industrial,/area/prefab/furniture_store)
"Yg" = (/obj/table/wood/auto/desk,/obj/item/paper/ikea_catalogue,/turf/simulated/floor/wood/three,/area/prefab/furniture_store)
"YR" = (/obj/machinery/door/airlock/pyro/glass,/turf/simulated/floor/white,/area/prefab/furniture_store)
"Za" = (/obj/stool/chair/yellow,/turf/simulated/floor/blackwhite,/area/prefab/furniture_store)
"Ze" = (/obj/table/reinforced,/obj/machinery/computer/security/wooden_tv{desc = "These channels seem to mostly be about robuddies. What is this, some kind of reality show?"; name = "Television"; network = "Zeta"},/obj/railing/orange{dir = 4},/obj/machinery/light/small/floor/netural,/turf/simulated/floor/wood,/area/prefab/furniture_store)
"Zs" = (/obj/critter/domestic_bee/buddy,/turf/simulated/floor/airless/grass/leafy,/area/prefab/furniture_store)

(1,1,1) = {"
mLmLmLmLmLmLmLmLmLmLmLmLmLmLmLmLmLmLmLmLmLmLmLmLmL
mLmLopopopopopopopopopopopopopopopopopmLmLmLmLmLmL
mLopopSmSmSmSmSmSmSmSmSmSmSmSmSmSmSmopopmLmLmLmLmL
mLopopSmoLnmhbjDOxSeXwXwSBXwjDGcvGSmopopmLmLmLmLmL
mLopopSmWjAYrjrjAYrjrjrjAYrjrjAYrjSmopopmLmLmLmLmL
mLopopSmirGcRjJNrjVEUvIfrjtaliGciRSmopopopopopopop
mLopSmSmSmSmSmSmKnGdGdGdKnSmSmSmSmSmSmSmSmSmSmSmSm
mLopSmumumfKfKiiPGbMWIyQPGBNKdrNBkjqSmMtlwuaWlZaSm
mLopSmJVxqfKZeSJPGlDrlcTPGBujaZsjaBuSmVSVSVSVSVSSm
mLopSmSCkGfKBAPdPGdAixLWPGhNyLKmNCCxSmyPzPQGwhdjSm
mLopSmBCBCNSgKPdPGTwvxzUPGPGPGPGPGPGykPGPGVWPGPGSm
mLopSmtpPdPdpMPdNMPGPGPGNMPdpMPdPdGSSmUXzNQwSvtHSm
mLopSmSMSyPdPdPdPGPdPGPdPGPdyxFWMVxuSmVSVSVSVSVSSm
mLopSmHNznOYPdPdPGeQPGIpPGgjNwooooDJSmfzdbtqeHNvSm
mLopSmdYdYPGPGPGPGWbmfAxPGPGoooounLsSmSmSmSmSmSmSm
mLopSmQlUfPdPdpMPGNylIHePGpMSSWdvXPwSmopopopopopop
mLopSmSmSmSmSmSmYRSmSmSmYRSmSmSmSmSmSmopopopopopop
mLopopopopopSmVcpXpXpHYgpXlbSmopopopopopopmLmLmLmL
mLopopopopopSmyfpXswyIswpXfwSmopopopopopopmLmLmLmL
mLmLmLmLmLopSmjhpXpXpXpXpXhlSmopopopmLmLmLmLmLmLmL
mLmLmLmLmLopSmSmSmuuuuuuSmSmSmopopopmLmLmLmLmLmLmL
mLmLmLmLmLopopWNSmpXDFpXSmWNopopopmLmLmLmLmLmLmLmL
mLmLmLmLmLopopWNSmVKSmVKSmWNopopopmLmLmLmLmLmLmLmL
mLmLmLmLmLopoptzDIhwhwhwDIMCopopopmLmLmLmLmLmLmLmL
mLmLmLmLmLopopWNWNwjAaVFWNWNopopopmLmLmLmLmLmLmLmL
"}
