"ab" = (/obj/decoration/bookcase{pixel_y = 23},/turf/unsimulated/floor/airless/plating{icon = 'icons/turf/shuttle.dmi'; icon_state = "floor3"},/area/prefab)
"aM" = (/obj/stool/chair/couch{dir = 5; icon_state = "chair_couch-blue"; name = "ratty blue couch"},/obj/decal/cleanable/dirt/jen,/turf/unsimulated/floor/airless/plating{icon = 'icons/turf/shuttle.dmi'; icon_state = "floor3"},/area/prefab)
"cs" = (/obj/decal/fakeobjects/pipe/heat{desc = "A radiator, used to remove heat from a spaceship"; dir = 9; name = "radiator pipe"},/turf/variableTurf/clear,/area/prefab)
"cy" = (/obj/decal/fakeobjects/pipe/heat{dir = 6; name = "radiator pipe"},/turf/variableTurf/clear,/area/prefab)
"ga" = (/obj/table/reinforced,/obj/item/device/light/lava_lamp/activated{pixel_x = 7; pixel_y = 20},/obj/random_item_spawner/desk_stuff/g_clip_bin_pen/maybe_few,/turf/unsimulated/floor/airless/plating{icon = 'icons/turf/shuttle.dmi'; icon_state = "floor3"},/area/prefab)
"gq" = (/obj/decal/cleanable/dirt/dirt3,/obj/map/light/secretblue,/turf/unsimulated/floor/airless/plating{icon = 'icons/turf/shuttle.dmi'; icon_state = "floor3"},/area/prefab)
"kb" = (/obj/rack,/obj/item/clothing/head/helmet/space/soviet{pixel_x = -5},/obj/item/clothing/head/helmet/space/soviet,/obj/item/clothing/head/helmet/space/soviet{pixel_x = 5},/obj/decal/cleanable/dirt/jen,/turf/unsimulated/floor/airless/plating{icon = 'icons/turf/shuttle.dmi'; icon_state = "floor3"},/area/prefab)
"lE" = (/obj/decal/cleanable/dirt/dirt3,/obj/decal/cleanable/dirt/jen,/turf/unsimulated/floor/airless/plating{icon = 'icons/turf/shuttle.dmi'; icon_state = "floor3"},/area/prefab)
"mS" = (/obj/table/reinforced,/obj/decal/cleanable/dirt/dirt3,/turf/unsimulated/floor/airless/plating{icon = 'icons/turf/shuttle.dmi'; icon_state = "floor3"},/area/prefab)
"nt" = (/obj/decal/cleanable/dirt/dirt3,/turf/unsimulated/floor/airless/plating{icon = 'icons/turf/shuttle.dmi'; icon_state = "floor3"},/area/prefab)
"nG" = (/obj/decal/fakeobjects/pipe/heat{dir = 10; name = "radiator pipe"},/turf/variableTurf/clear,/area/prefab)
"op" = (/obj/decal/cleanable/dirt/dirt4,/turf/unsimulated/floor/airless/plating{icon = 'icons/turf/shuttle.dmi'; icon_state = "floor3"},/area/prefab)
"oD" = (/obj/storage/closet/wardrobe,/obj/random_item_spawner/dressup/one_or_zero,/obj/random_item_spawner/hat/one_or_zero,/obj/map/light/secretblue,/turf/unsimulated/floor/airless/plating{icon = 'icons/turf/shuttle.dmi'; icon_state = "floor3"},/area/prefab)
"pm" = (/obj/stool/chair/comfy/shuttle{dir = 8},/obj/decal/cleanable/dirt/dirt3,/turf/unsimulated/floor/airless/plating{icon = 'icons/turf/shuttle.dmi'; icon_state = "floor3"},/area/prefab)
"qD" = (/obj/decal/fakeobjects/pipe/heat{dir = 5; name = "radiator pipe"},/turf/variableTurf/clear,/area/prefab)
"qY" = (/obj/rack,/obj/item/clothing/head/helmet/space/soviet{pixel_x = -5},/obj/item/clothing/head/helmet/space/soviet,/obj/item/clothing/head/helmet/space/soviet{pixel_x = 5},/turf/unsimulated/floor/airless/plating{icon = 'icons/turf/shuttle.dmi'; icon_state = "floor3"},/area/prefab)
"rf" = (/obj/decal/cleanable/dirt/jen,/obj/map/light/secretblue,/turf/unsimulated/floor/airless/plating{icon = 'icons/turf/shuttle.dmi'; icon_state = "floor3"},/area/prefab)
"rg" = (/turf/unsimulated/wall/auto/lead/white{name = "Armored Wall"},/area/prefab)
"rx" = (/obj/stool/chair/couch{dir = 9; icon_state = "chair_couch-blue"; name = "ratty blue couch"},/obj/decal/cleanable/dirt/jen,/turf/unsimulated/floor/airless/plating{icon = 'icons/turf/shuttle.dmi'; icon_state = "floor3"},/area/prefab)
"rJ" = (/obj/map/light/secretblue,/turf/unsimulated/floor/airless/plating{icon = 'icons/turf/shuttle.dmi'; icon_state = "floor3"},/area/prefab)
"rS" = (/obj/decal/cleanable/dirt/dirt4{dir = 1},/turf/unsimulated/floor/airless/plating{icon = 'icons/turf/shuttle.dmi'; icon_state = "floor3"},/area/prefab)
"tJ" = (/obj/machinery/atmospherics/pipe/vent{dir = 1},/obj/decal/cleanable/dirt/jen,/turf/unsimulated/floor/airless/plating{icon = 'icons/turf/shuttle.dmi'; icon_state = "floor3"},/area/prefab)
"vb" = (/obj/table/reinforced,/turf/unsimulated/floor/airless/plating{icon = 'icons/turf/shuttle.dmi'; icon_state = "floor3"},/area/prefab)
"vr" = (/obj/decal/fakeobjects/pipe/heat,/turf/variableTurf/clear,/area/prefab)
"xd" = (/obj/decal/cleanable/dirt/jen,/obj/decal/cleanable/dirt/jen,/turf/unsimulated/wall/auto/lead/white{name = "Armored Wall"},/area/prefab)
"xm" = (/turf/unsimulated/wall/setpieces/leadwindow/white/full{desc = "Doesnt this defeat the purpose of armor?"; dir = 4; name = "Armored Window"},/area/prefab)
"xs" = (/obj/machinery/door/unpowered/shuttle,/turf/unsimulated/floor/airless/plating{icon = 'icons/turf/shuttle.dmi'; icon_state = "floor3"},/area/prefab)
"yh" = (/obj/stool/bed,/obj/item/clothing/suit/bedsheet/red,/turf/unsimulated/floor/airless/plating{icon = 'icons/turf/shuttle.dmi'; icon_state = "floor3"},/area/prefab)
"zj" = (/turf/unsimulated/wall/setpieces/leadwindow/white/full{dir = 4},/area/prefab)
"zs" = (/obj/decal/cleanable/dirt/dirt4,/obj/decal/cleanable/dirt/jen,/turf/unsimulated/floor/airless/plating{icon = 'icons/turf/shuttle.dmi'; icon_state = "floor3"},/area/prefab)
"zD" = (/obj/decal/fakeobjects/pipe/heat{name = "radiator pipe"},/turf/variableTurf/clear,/area/prefab)
"AU" = (/obj/stool/bed,/obj/item/clothing/suit/bedsheet/red,/obj/decal/cleanable/dirt/jen,/turf/unsimulated/floor/airless/plating{icon = 'icons/turf/shuttle.dmi'; icon_state = "floor3"},/area/prefab)
"Bo" = (/obj/stool/bed{interesting = "The scanner displays another unknown chemical. A readout of some of it's basic properites look strangly like a ore...if only you could remember what that ore is."; name = "Operating Bed"},/obj/map/light/secretblue,/turf/unsimulated/floor/airless/plating{icon = 'icons/turf/shuttle.dmi'; icon_state = "floor3"},/area/prefab)
"Ed" = (/obj/storage/closet/wardrobe,/obj/random_item_spawner/dressup/one_or_zero,/obj/random_item_spawner/hat/one_or_zero,/turf/unsimulated/floor/airless/plating{icon = 'icons/turf/shuttle.dmi'; icon_state = "floor3"},/area/prefab)
"Fc" = (/obj/stool/bed,/turf/unsimulated/floor/airless/plating{icon = 'icons/turf/shuttle.dmi'; icon_state = "floor3"},/area/prefab)
"FN" = (/obj/ladder/broken{id = "3151_2"; pixel_y = 14},/obj/ladder{id = "3151_2"},/obj/map/light/cyan,/turf/unsimulated/floor/airless/plating{icon = 'icons/turf/shuttle.dmi'; icon_state = "floor3"},/area/prefab)
"FO" = (/obj/surgery_tray,/obj/random_item_spawner/med_tool/maybe_few,/turf/unsimulated/floor/airless/plating{icon = 'icons/turf/shuttle.dmi'; icon_state = "floor3"},/area/prefab)
"GC" = (/obj/table/reinforced/auto,/obj/item/medical/bruise_pack,/obj/item/medical/bruise_pack{pixel_x = 4; pixel_y = 4},/turf/unsimulated/floor/airless/plating{icon = 'icons/turf/shuttle.dmi'; icon_state = "floor3"},/area/prefab)
"GP" = (/obj/decal/fakeobjects/pipe/heat{dir = 9; name = "radiator pipe"},/turf/variableTurf/clear,/area/prefab)
"IA" = (/obj/ladder/broken{pixel_y = 14},/obj/ladder{id = "3151_1"},/obj/map/light/cyan,/turf/unsimulated/floor/airless/plating{icon = 'icons/turf/shuttle.dmi'; icon_state = "floor3"},/area/prefab)
"Jo" = (/turf/unsimulated/floor/airless/plating{icon = 'icons/turf/shuttle.dmi'; icon_state = "floor3"},/area/prefab)
"JB" = (/obj/table/reinforced,/obj/decal/cleanable/dirt/jen,/turf/unsimulated/floor/airless/plating{icon = 'icons/turf/shuttle.dmi'; icon_state = "floor3"},/area/prefab)
"KY" = (/turf/variableTurf/clear,/area/prefab)
"Lf" = (/obj/decal/cleanable/dirt/jen,/turf/unsimulated/wall/setpieces/leadwindow/white/full{desc = "Doesnt this defeat the purpose of armor?"; dir = 4; name = "Armored Window"},/area/prefab)
"LM" = (/obj/table/reinforced,/obj/deskclutter,/turf/unsimulated/floor/airless/plating{icon = 'icons/turf/shuttle.dmi'; icon_state = "floor3"},/area/prefab)
"MY" = (/obj/decal/cleanable/dirt/dirt3,/turf/unsimulated/wall/auto/lead/white{name = "Armored Wall"},/area/prefab)
"Pm" = (/obj/machinery/door/unpowered/shuttle,/obj/decal/cleanable/dirt/jen,/turf/unsimulated/floor/airless/plating{icon = 'icons/turf/shuttle.dmi'; icon_state = "floor3"},/area/prefab)
"QA" = (/obj/decal/cleanable/dirt/jen,/turf/unsimulated/floor/airless/plating{icon = 'icons/turf/shuttle.dmi'; icon_state = "floor3"},/area/prefab)
"Se" = (/obj/decal/cleanable/dirt/jen,/obj/decal/cleanable/dirt/jen,/turf/unsimulated/floor/airless/plating{icon = 'icons/turf/shuttle.dmi'; icon_state = "floor3"},/area/prefab)
"SL" = (/obj/storage/closet,/obj/item/reagent_containers/glass/bucket/red,/obj/item/reagent_containers/glass/bucket/red,/obj/item/reagent_containers/glass/bucket/red,/obj/item/mop/orange,/obj/item/mop/orange,/obj/item/spraybottle{desc = "A spray bottle labeled Чистящий спрей. Seems what ever was in it is all gone now"; name = "old spray bottle"},/obj/item/spraybottle{desc = "A spray bottle labeled Чистящий спрей. Seems what ever was in it is all gone now"; name = "old spray bottle"},/turf/unsimulated/floor/airless/plating{icon = 'icons/turf/shuttle.dmi'; icon_state = "floor3"},/area/prefab)
"Tf" = (/obj/machinery/shuttle/engine/propulsion{dir = 4; icon_state = "alt_propulsion"},/turf/variableTurf/clear,/area/prefab)
"Ts" = (/turf/unsimulated/wall/setpieces/leadwindow/white/full{desc = "Doesnt this defeat the purpose of armor?"; name = "Armored Window"},/area/prefab)
"UC" = (/obj/decal/cleanable/dirt/jen,/turf/unsimulated/wall/auto/lead/white{name = "Armored Wall"},/area/prefab)
"Vo" = (/obj/iv_stand,/turf/unsimulated/floor/airless/plating{icon = 'icons/turf/shuttle.dmi'; icon_state = "floor3"},/area/prefab)
"Wi" = (/obj/rack,/obj/item/clothing/mask/breath,/obj/item/clothing/head/helmet/space/soviet{pixel_x = -6},/obj/item/clothing/head/helmet/space/soviet,/obj/item/clothing/head/helmet/space/soviet{pixel_x = 5},/turf/unsimulated/floor/airless/plating{icon = 'icons/turf/shuttle.dmi'; icon_state = "floor3"},/area/prefab)
"Ys" = (/obj/stool/bed,/obj/decal/cleanable/blood/splatter{icon_state = "gibbl2"},/turf/unsimulated/floor/airless/plating{icon = 'icons/turf/shuttle.dmi'; icon_state = "floor3"},/area/prefab)
"YV" = (/obj/table/reinforced/auto,/obj/item/bloodslide{pixel_x = 8},/obj/item/bloodslide{pixel_x = 2; pixel_y = 10},/obj/machinery/microscope{pixel_x = -6; pixel_y = 3},/turf/unsimulated/floor/airless/plating{icon = 'icons/turf/shuttle.dmi'; icon_state = "floor3"},/area/prefab)
"Ze" = (/obj/decal/cleanable/dirt/jen,/obj/decal/cleanable/dirt/dirt3,/turf/unsimulated/floor/airless/plating{icon = 'icons/turf/shuttle.dmi'; icon_state = "floor3"},/area/prefab)

(1,1,1) = {"
KYKYKYKYKYKYKYKYKYKYKYKYKYKYKYKYKYKYKYKYKYKYKYKYKYKYKYKYKYKYKYKYKYKY
KYKYKYKYKYKYKYKYKYKYKYKYKYKYKYKYKYKYKYKYKYKYKYKYKYcynGKYKYKYKYKYKYKY
KYKYKYKYKYKYKYKYKYcynGcynGKYKYKYKYKYKYKYKYKYKYcynGzDzDcynGKYKYKYKYKY
KYKYKYKYKYKYKYcynGzDzDzDzDKYKYKYKYKYKYKYKYKYKYzDzDzDzDzDzDKYKYKYKYKY
KYKYKYKYKYKYKYzDqDcsqDGPzDKYrgrgrgrgrgrgKYKYKYzDqDGPqDGPzDKYKYKYKYKY
KYKYKYKYcynGKYrgrgxmrgxmrgrgrgIAQAJoFNrgrgKYKYzDrgxmxmrgzDKYKYKYKYKY
KYKYKYKYrgrgrgrgyhJBrgyhvbUClEJoopJoJolErgrgzjrgrgJoZergrgxmrgKYKYKY
KYKYrgxmrgrgrgEdrfJorgntoDrgJorJSeJorJJoxsJoJorfntJoJoTsJoFOrgrgKYKY
KYrgrgLMababxdrgUCxsrgxsrgrgQAJoJoopJoJoxsSeJoJoJoJontxsJoBoVorgTfKY
KYTsgapmrfJoxsQAJoJoJoQAJoPmntJoJoJoJoQArgUCMYrgrgzsJoTsJoQAntrgKYKY
KYTsmSpmrfJoxsQASeJorJntJoxsJontopJoJoJorgntJoSLrgxsxmrgrgrgrgrgKYKY
KYrgrgntJontrgrgrgxsrgxsrgrgJogqJoJorfZexsntrJntUCJoJoxsrSrJFcrgTfKY
KYKYrgxmrgrgrgEdrfQArgJooDrgrxaMQAzsJoZergWikbqYrgrJJoTsJoYsrgrgKYKY
KYKYKYKYrgrgrgrgyhvbrgAUvbrgrgrgxsxsrgrgrgrgLfUCUCYVGCrgrgxmrgKYKYKY
KYKYKYKYqDGPKYrgrgxmrgxmrgrgrgtJJoQAtJrgrgKYKYvrrgxmxmrgvrKYKYKYKYKY
KYKYKYKYKYKYKYzDcynGcynGzDKYrgrgxsxsrgrgKYKYKYvrcynGcynGvrKYKYKYKYKY
KYKYKYKYKYKYKYqDGPzDzDzDzDKYKYKYKYKYKYKYKYKYKYvrvrvrvrvrvrKYKYKYKYKY
KYKYKYKYKYKYKYKYKYqDGPqDGPKYKYKYKYKYKYKYKYKYKYqDGPvrvrqDGPKYKYKYKYKY
KYKYKYKYKYKYKYKYKYKYKYKYKYKYKYKYKYKYKYKYKYKYKYKYKYqDGPKYKYKYKYKYKYKY
KYKYKYKYKYKYKYKYKYKYKYKYKYKYKYKYKYKYKYKYKYKYKYKYKYKYKYKYKYKYKYKYKYKY
"}
