//MAP CONVERTED BY dmm2tgm.py THIS HEADER COMMENT PREVENTS RECONVERSION, DO NOT REMOVE
"ab" = (
/obj/table/reinforced,
/obj/random_item_spawner/desk_stuff/g_clip_bin_pen/maybe_few,
/turf/unsimulated/floor/airless/plating{
	icon = 'icons/turf/shuttle.dmi';
	icon_state = "floor3"
	},
/area/prefab)
"aM" = (
/obj/decal/fakeobjects/pipe/heat{
	desc = "A radiator used to dispose of waste heat from space ships.";
	dir = 6;
	name = "radiator pipe"
	},
/turf/variableTurf/clear,
/area/prefab)
"bC" = (
/turf/unsimulated/wall/setpieces/leadwall/white_2/junction{
	desc = "The only thing keeping the vaccum out and you alive.";
	icon = 'icons/turf/walls_tempus-white.dmi';
	icon_state = "6";
	name = "Ship Armor"
	},
/area/prefab)
"cy" = (
/obj/decal/fakeobjects/pipe/heat{
	dir = 6;
	name = "radiator pipe"
	},
/turf/variableTurf/clear,
/area/prefab)
"dO" = (
/obj/decal/cleanable/dirt/jen,
/obj/stool/chair/comfy/shuttle{
	dir = 1
	},
/turf/unsimulated/floor/airless/plating{
	icon = 'icons/turf/shuttle.dmi';
	icon_state = "floor3"
	},
/area/prefab)
"fO" = (
/turf/unsimulated/wall/setpieces/leadwall/white_2/junction{
	desc = "The only thing keeping the vaccum out and you alive.";
	icon = 'icons/turf/walls_tempus-white.dmi';
	icon_state = "13";
	name = "Ship Armor"
	},
/area/prefab)
"ga" = (
/obj/item/storage/toilet,
/obj/decal/cleanable/dirt/jen,
/turf/unsimulated/floor/airless/plating{
	icon = 'icons/turf/shuttle.dmi';
	icon_state = "floor3"
	},
/area/prefab)
"hc" = (
/obj/machinery/door/unpowered/shuttle{
	icon = 'icons/Testing/newicons/obj/NEWdoors/door_command.dmi';
	icon_state = "sdoor"
	},
/turf/space,
/area/prefab)
"hm" = (
/obj/table/reinforced,
/obj/item/device/light/lava_lamp/activated{
	pixel_x = 7;
	pixel_y = 20
	},
/obj/random_item_spawner/desk_stuff/g_clip_bin_pen/maybe_few,
/turf/unsimulated/floor/airless/plating{
	icon = 'icons/turf/shuttle.dmi';
	icon_state = "floor3"
	},
/area/prefab)
"lE" = (
/obj/decal/cleanable/dirt/dirt3,
/obj/decal/cleanable/dirt/jen,
/turf/unsimulated/floor/airless/plating{
	icon = 'icons/turf/shuttle.dmi';
	icon_state = "floor3"
	},
/area/prefab)
"mS" = (
/obj/stool/chair/comfy/shuttle{
	dir = 4
	},
/obj/decal/cleanable/dirt/dirt3,
/turf/unsimulated/floor/airless/plating{
	icon = 'icons/turf/shuttle.dmi';
	icon_state = "floor3"
	},
/area/prefab)
"nt" = (
/obj/decal/cleanable/dirt/dirt3,
/turf/unsimulated/floor/airless/plating{
	icon = 'icons/turf/shuttle.dmi';
	icon_state = "floor3"
	},
/area/prefab)
"nG" = (
/obj/decal/fakeobjects/pipe/heat{
	desc = "A radiator used to dispose of waste heat from space ships.";
	dir = 10;
	name = "radiator pipe"
	},
/turf/variableTurf/clear,
/area/prefab)
"op" = (
/obj/decal/cleanable/dirt/dirt4,
/obj/decal/cleanable/dirt/dirt3,
/turf/unsimulated/floor/airless/plating{
	icon = 'icons/turf/shuttle.dmi';
	icon_state = "floor3"
	},
/area/prefab)
"oD" = (
/obj/storage/closet/wardrobe,
/obj/random_item_spawner/dressup/one_or_zero,
/obj/random_item_spawner/hat/one_or_zero,
/obj/map/light/secretblue,
/turf/unsimulated/floor/airless/plating{
	icon = 'icons/turf/shuttle.dmi';
	icon_state = "floor3"
	},
/area/prefab)
"qD" = (
/obj/decal/fakeobjects/pipe/heat{
	desc = "A radiator used to dispose of waste heat from space ships.";
	dir = 5;
	name = "radiator pipe"
	},
/turf/variableTurf/clear,
/area/prefab)
"qY" = (
/obj/rack,
/obj/item/clothing/head/helmet/space/soviet{
	pixel_x = -5
	},
/obj/item/clothing/head/helmet/space/soviet,
/obj/item/clothing/head/helmet/space/soviet{
	pixel_x = 5
	},
/obj/decal/cleanable/dirt/jen,
/turf/unsimulated/floor/airless/plating{
	icon = 'icons/turf/shuttle.dmi';
	icon_state = "floor3"
	},
/area/prefab)
"rf" = (
/obj/decal/cleanable/dirt/jen,
/obj/map/light/secretblue,
/turf/unsimulated/floor/airless/plating{
	icon = 'icons/turf/shuttle.dmi';
	icon_state = "floor3"
	},
/area/prefab)
"rg" = (
/turf/unsimulated/wall/setpieces/leadwall/white_2/junction{
	desc = "The only thing keeping the vaccum out and you alive.";
	icon = 'icons/turf/walls_tempus-white.dmi';
	icon_state = "10";
	name = "Ship Armor"
	},
/area/prefab)
"rx" = (
/turf/unsimulated/wall/setpieces/leadwall/white_2/junction{
	desc = "The only thing keeping the vaccum out and you alive.";
	icon = 'icons/turf/walls_tempus-white.dmi';
	icon_state = "9";
	name = "Ship Armor"
	},
/area/prefab)
"rJ" = (
/obj/map/light/secretblue,
/turf/unsimulated/floor/airless/plating{
	icon = 'icons/turf/shuttle.dmi';
	icon_state = "floor3"
	},
/area/prefab)
"rS" = (
/obj/decal/cleanable/dirt/dirt4{
	dir = 1
	},
/obj/decal/cleanable/dirt/jen,
/turf/unsimulated/floor/airless/plating{
	icon = 'icons/turf/shuttle.dmi';
	icon_state = "floor3"
	},
/area/prefab)
"rT" = (
/obj/table,
/turf/unsimulated/floor/airless/plating{
	icon = 'icons/turf/shuttle.dmi';
	icon_state = "floor3"
	},
/area/prefab)
"tJ" = (
/obj/machinery/atmospherics/pipe/vent{
	dir = 1
	},
/obj/decal/cleanable/dirt/jen,
/turf/unsimulated/floor/airless/plating{
	icon = 'icons/turf/shuttle.dmi';
	icon_state = "floor3"
	},
/area/prefab)
"vb" = (
/obj/table/reinforced,
/turf/unsimulated/floor/airless/plating{
	icon = 'icons/turf/shuttle.dmi';
	icon_state = "floor3"
	},
/area/prefab)
"xs" = (
/obj/machinery/door/unpowered/shuttle{
	dir = 4;
	icon = 'icons/Testing/newicons/obj/NEWdoors/door_command.dmi';
	icon_state = "sdoor"
	},
/turf/unsimulated/floor/airless/plating{
	icon = 'icons/turf/shuttle.dmi';
	icon_state = "floor3"
	},
/area/prefab)
"yh" = (
/obj/stool/bed,
/obj/item/clothing/suit/bedsheet/red,
/turf/unsimulated/floor/airless/plating{
	icon = 'icons/turf/shuttle.dmi';
	icon_state = "floor3"
	},
/area/prefab)
"yB" = (
/turf/unsimulated/wall/setpieces/leadwall/white_2/junction{
	desc = "The only thing keeping the vaccum out and you alive.";
	icon = 'icons/turf/walls_tempus-white.dmi';
	icon_state = "11";
	name = "Ship Armor"
	},
/area/prefab)
"yL" = (
/obj/decoration/bookcase{
	pixel_y = 23
	},
/obj/decal/cleanable/dirt/jen,
/turf/unsimulated/floor/airless/plating{
	icon = 'icons/turf/shuttle.dmi';
	icon_state = "floor3"
	},
/area/prefab)
"zs" = (
/obj/decal/cleanable/dirt/dirt4,
/obj/decal/cleanable/dirt/jen,
/turf/unsimulated/floor/airless/plating{
	icon = 'icons/turf/shuttle.dmi';
	icon_state = "floor3"
	},
/area/prefab)
"zD" = (
/obj/decal/fakeobjects/pipe/heat{
	desc = "A radiator used to dispose of waste heat from space ships.";
	dir = 1;
	name = "radiator pipe"
	},
/turf/variableTurf/clear,
/area/prefab)
"zY" = (
/obj/map/light/secretblue,
/obj/decal/cleanable/dirt/jen,
/turf/unsimulated/floor/airless/plating{
	icon = 'icons/turf/shuttle.dmi';
	icon_state = "floor3"
	},
/area/prefab)
"Al" = (
/obj/rack,
/obj/item/clothing/head/helmet/space/soviet{
	pixel_x = -5
	},
/obj/item/clothing/head/helmet/space/soviet,
/obj/item/clothing/head/helmet/space/soviet{
	pixel_x = 5
	},
/turf/unsimulated/floor/airless/plating{
	icon = 'icons/turf/shuttle.dmi';
	icon_state = "floor3"
	},
/area/prefab)
"AU" = (
/obj/stool/bed,
/obj/item/clothing/suit/bedsheet/red,
/obj/decal/cleanable/dirt/jen,
/turf/unsimulated/floor/airless/plating{
	icon = 'icons/turf/shuttle.dmi';
	icon_state = "floor3"
	},
/area/prefab)
"Bo" = (
/obj/stool/bed{
	interesting = "The scanner displays another unknown chemical. A readout of some of it's basic properites look strangly like a ore...if only you could remember what that ore is.";
	name = "Operating Bed"
	},
/obj/map/light/secretblue,
/turf/unsimulated/floor/airless/plating{
	icon = 'icons/turf/shuttle.dmi';
	icon_state = "floor3"
	},
/area/prefab)
"Ed" = (
/obj/storage/closet/wardrobe,
/obj/random_item_spawner/dressup/one_or_zero,
/obj/random_item_spawner/hat/one_or_zero,
/turf/unsimulated/floor/airless/plating{
	icon = 'icons/turf/shuttle.dmi';
	icon_state = "floor3"
	},
/area/prefab)
"Eo" = (
/turf/unsimulated/wall/setpieces/leadwall/white_2/junction{
	desc = "The only thing keeping the vaccum out and you alive.";
	icon = 'icons/turf/walls_tempus-white.dmi';
	icon_state = "15";
	name = "Ship Armor"
	},
/area/prefab)
"Fc" = (
/obj/stool/bed,
/obj/decal/cleanable/dirt/jen,
/turf/unsimulated/floor/airless/plating{
	icon = 'icons/turf/shuttle.dmi';
	icon_state = "floor3"
	},
/area/prefab)
"FN" = (
/obj/ladder/broken{
	id = "3151_2";
	pixel_y = 14
	},
/obj/ladder{
	id = "3151_2"
	},
/obj/ladder/broken{
	pixel_y = 23
	},
/obj/decal/cleanable/dirt/jen,
/turf/unsimulated/floor/airless/plating{
	icon = 'icons/turf/shuttle.dmi';
	icon_state = "floor3"
	},
/area/prefab)
"FO" = (
/obj/surgery_tray,
/obj/random_item_spawner/med_tool/maybe_few,
/turf/unsimulated/floor/airless/plating{
	icon = 'icons/turf/shuttle.dmi';
	icon_state = "floor3"
	},
/area/prefab)
"GC" = (
/obj/table/reinforced/auto,
/obj/item/medical/bruise_pack,
/obj/item/medical/bruise_pack{
	pixel_x = 8;
	pixel_y = 1
	},
/obj/item/medical/bruise_pack{
	pixel_x = 4;
	pixel_y = 4
	},
/turf/unsimulated/floor/airless/plating{
	icon = 'icons/turf/shuttle.dmi';
	icon_state = "floor3"
	},
/area/prefab)
"GP" = (
/obj/decal/fakeobjects/pipe/heat{
	desc = "A radiator used to dispose of waste heat from space ships.";
	dir = 9;
	name = "radiator pipe"
	},
/turf/variableTurf/clear,
/area/prefab)
"IA" = (
/obj/ladder/broken{
	pixel_y = 14
	},
/obj/ladder{
	id = "3151_1"
	},
/obj/ladder/broken{
	pixel_y = 23
	},
/turf/unsimulated/floor/airless/plating{
	icon = 'icons/turf/shuttle.dmi';
	icon_state = "floor3"
	},
/area/prefab)
"Jo" = (
/turf/unsimulated/floor/airless/plating{
	icon = 'icons/turf/shuttle.dmi';
	icon_state = "floor3"
	},
/area/prefab)
"JB" = (
/obj/table/reinforced,
/obj/decal/cleanable/dirt/jen,
/turf/unsimulated/floor/airless/plating{
	icon = 'icons/turf/shuttle.dmi';
	icon_state = "floor3"
	},
/area/prefab)
"Kr" = (
/turf/unsimulated/wall/setpieces/leadwall/white_2/junction{
	desc = "The only thing keeping the vaccum out and you alive.";
	icon = 'icons/turf/walls_tempus-white.dmi';
	icon_state = "14";
	name = "Ship Armor"
	},
/area/prefab)
"KY" = (
/turf/variableTurf/clear,
/area/prefab)
"MU" = (
/turf/unsimulated/wall/setpieces/leadwall/white_2/junction{
	desc = "The only thing keeping the vaccum out and you alive.";
	icon = 'icons/turf/walls_tempus-white.dmi';
	icon_state = "12";
	name = "Ship Armor"
	},
/area/prefab)
"MY" = (
/obj/decal/cleanable/dirt/dirt4,
/obj/decal/cleanable/dirt/dirt3,
/obj/decal/cleanable/dirt/jen,
/turf/unsimulated/floor/airless/plating{
	icon = 'icons/turf/shuttle.dmi';
	icon_state = "floor3"
	},
/area/prefab)
"NM" = (
/turf/unsimulated/wall/setpieces/leadwall/white_2/junction{
	desc = "The only thing keeping the vaccum out and you alive.";
	icon = 'icons/turf/walls_tempus-white.dmi';
	icon_state = "5";
	name = "Ship Armor"
	},
/area/prefab)
"OA" = (
/obj/machinery/door/unpowered/shuttle{
	icon = 'icons/Testing/newicons/obj/NEWdoors/door_command.dmi';
	icon_state = "sdoor"
	},
/turf/unsimulated/floor/airless/plating{
	icon = 'icons/turf/shuttle.dmi';
	icon_state = "floor3"
	},
/area/prefab)
"Pm" = (
/obj/decal/cleanable/dirt/jen,
/obj/machinery/door/unpowered/shuttle{
	dir = 4;
	icon = 'icons/Testing/newicons/obj/NEWdoors/door_command.dmi';
	icon_state = "sdoor"
	},
/turf/unsimulated/floor/airless/plating{
	icon = 'icons/turf/shuttle.dmi';
	icon_state = "floor3"
	},
/area/prefab)
"Qe" = (
/turf/unsimulated/wall/setpieces/leadwall/white_2/junction{
	desc = "The only thing keeping the vaccum out and you alive.";
	icon = 'icons/turf/walls_tempus-white.dmi';
	icon_state = "7";
	name = "Ship Armor"
	},
/area/prefab)
"QA" = (
/obj/decal/cleanable/dirt/jen,
/turf/unsimulated/floor/airless/plating{
	icon = 'icons/turf/shuttle.dmi';
	icon_state = "floor3"
	},
/area/prefab)
"Se" = (
/obj/decal/cleanable/dirt/jen,
/obj/decal/cleanable/dirt/jen,
/turf/unsimulated/floor/airless/plating{
	icon = 'icons/turf/shuttle.dmi';
	icon_state = "floor3"
	},
/area/prefab)
"SL" = (
/obj/rack,
/obj/item/clothing/mask/breath,
/obj/item/clothing/head/helmet/space/soviet{
	pixel_x = -6
	},
/obj/item/clothing/head/helmet/space/soviet,
/obj/item/clothing/head/helmet/space/soviet{
	pixel_x = 5
	},
/obj/decal/cleanable/dirt/jen,
/turf/unsimulated/floor/airless/plating{
	icon = 'icons/turf/shuttle.dmi';
	icon_state = "floor3"
	},
/area/prefab)
"Tf" = (
/obj/machinery/shuttle/engine/propulsion{
	dir = 4;
	icon_state = "alt_propulsion"
	},
/turf/variableTurf/clear,
/area/prefab)
"Ts" = (
/turf/unsimulated/wall/setpieces/leadwall/white_2/junction{
	desc = "The only thing keeping the vaccum out and you alive.";
	icon = 'icons/turf/walls_tempus-white.dmi';
	icon_state = "3";
	name = "Ship Armor"
	},
/area/prefab)
"Un" = (
/obj/decal/cleanable/dirt/dirt3,
/obj/decal/cleanable/dirt/jen,
/obj/stool/chair/comfy/shuttle,
/turf/unsimulated/floor/airless/plating{
	icon = 'icons/turf/shuttle.dmi';
	icon_state = "floor3"
	},
/area/prefab)
"UC" = (
/obj/stool/chair/comfy/shuttle{
	dir = 1
	},
/turf/unsimulated/floor/airless/plating{
	icon = 'icons/turf/shuttle.dmi';
	icon_state = "floor3"
	},
/area/prefab)
"Vo" = (
/obj/iv_stand,
/turf/unsimulated/floor/airless/plating{
	icon = 'icons/turf/shuttle.dmi';
	icon_state = "floor3"
	},
/area/prefab)
"Wi" = (
/obj/storage/closet,
/obj/item/reagent_containers/glass/bucket/red,
/obj/item/reagent_containers/glass/bucket/red,
/obj/item/reagent_containers/glass/bucket/red,
/obj/item/mop/orange,
/obj/item/mop/orange,
/obj/item/spraybottle{
	desc = "A spray bottle labeled Чистящий спрей. Seems what ever was in it is all gone now";
	name = "old spray bottle"
	},
/obj/item/spraybottle{
	desc = "A spray bottle labeled Чистящий спрей. Seems what ever was in it is all gone now";
	name = "old spray bottle"
	},
/turf/unsimulated/floor/airless/plating{
	icon = 'icons/turf/shuttle.dmi';
	icon_state = "floor3"
	},
/area/prefab)
"Ys" = (
/obj/stool/bed,
/obj/decal/cleanable/blood/splatter{
	icon_state = "gibbl2"
	},
/turf/unsimulated/floor/airless/plating{
	icon = 'icons/turf/shuttle.dmi';
	icon_state = "floor3"
	},
/area/prefab)
"YV" = (
/obj/table/reinforced/auto,
/obj/item/bloodslide{
	interesting = "Almost completly turned into some purplelike material. High traces of something like radioactivity.";
	pixel_x = 8
	},
/obj/item/bloodslide{
	interesting = "Almost completly turned into some purplelike material. High traces of something like radioactivity.";
	pixel_x = 2;
	pixel_y = 8
	},
/obj/machinery/microscope{
	pixel_x = -6;
	pixel_y = 3
	},
/turf/unsimulated/floor/airless/plating{
	icon = 'icons/turf/shuttle.dmi';
	icon_state = "floor3"
	},
/area/prefab)
"Ze" = (
/obj/decal/cleanable/dirt/jen,
/obj/decal/cleanable/dirt/dirt3,
/turf/unsimulated/floor/airless/plating{
	icon = 'icons/turf/shuttle.dmi';
	icon_state = "floor3"
	},
/area/prefab)

(1,1,1) = {"
KY
KY
KY
KY
KY
KY
KY
KY
KY
KY
KY
KY
KY
KY
KY
KY
KY
KY
KY
KY
"}
(2,1,1) = {"
KY
KY
KY
KY
KY
KY
KY
KY
bC
Ts
Ts
NM
KY
KY
KY
KY
KY
KY
KY
KY
"}
(3,1,1) = {"
KY
KY
KY
KY
KY
KY
KY
bC
fO
ga
Jo
Kr
NM
KY
KY
KY
KY
KY
KY
KY
"}
(4,1,1) = {"
KY
KY
KY
KY
KY
KY
KY
Kr
yB
Ts
xs
yB
fO
KY
KY
KY
KY
KY
KY
KY
"}
(5,1,1) = {"
KY
KY
KY
KY
KY
aM
bC
fO
yL
rf
rf
mS
Kr
NM
qD
KY
KY
KY
KY
KY
"}
(6,1,1) = {"
KY
KY
KY
KY
KY
nG
Kr
fO
ab
UC
Jo
hm
Kr
fO
GP
KY
KY
KY
KY
KY
"}
(7,1,1) = {"
KY
KY
KY
KY
KY
KY
Kr
yB
Qe
Ts
xs
Qe
yB
fO
KY
KY
KY
KY
KY
KY
"}
(8,1,1) = {"
KY
KY
KY
aM
zD
bC
rx
Ed
MU
QA
QA
MU
Ed
rg
NM
zD
qD
KY
KY
KY
"}
(9,1,1) = {"
KY
KY
KY
nG
qD
MU
yh
rf
MU
Jo
Se
MU
rf
yh
MU
cy
GP
KY
KY
KY
"}
(10,1,1) = {"
KY
KY
aM
zD
GP
MU
JB
Jo
OA
QA
Jo
OA
QA
vb
MU
nG
zD
qD
KY
KY
"}
(11,1,1) = {"
KY
KY
nG
zD
qD
Kr
Ts
Ts
fO
Jo
rJ
Kr
Ts
Ts
fO
cy
zD
GP
KY
KY
"}
(12,1,1) = {"
KY
KY
aM
zD
GP
MU
yh
lE
OA
QA
lE
OA
Jo
AU
MU
nG
zD
qD
KY
KY
"}
(13,1,1) = {"
KY
KY
nG
zD
zD
MU
vb
oD
MU
QA
Jo
MU
oD
vb
MU
zD
zD
GP
KY
KY
"}
(14,1,1) = {"
KY
KY
KY
KY
KY
Kr
Ts
Ts
yB
Pm
Ts
yB
Ts
Qe
fO
KY
KY
KY
KY
KY
"}
(15,1,1) = {"
KY
KY
KY
KY
bC
rx
Un
rT
dO
lE
Jo
QA
lE
Kr
yB
NM
KY
KY
KY
KY
"}
(16,1,1) = {"
KY
KY
KY
KY
MU
IA
Jo
rJ
Jo
QA
lE
rf
Jo
hc
tJ
OA
KY
KY
KY
KY
"}
(17,1,1) = {"
KY
KY
KY
KY
MU
QA
MY
Se
Jo
Jo
MY
Jo
QA
MU
nt
MU
KY
KY
KY
KY
"}
(18,1,1) = {"
KY
KY
KY
KY
MU
Jo
Jo
QA
op
Jo
Jo
Jo
zs
MU
QA
MU
KY
KY
KY
KY
"}
(19,1,1) = {"
KY
KY
KY
KY
MU
FN
Jo
rJ
QA
Jo
Jo
rJ
Jo
hc
tJ
OA
KY
KY
KY
KY
"}
(20,1,1) = {"
KY
KY
KY
KY
rg
NM
lE
Jo
Jo
QA
Jo
QA
Jo
Kr
Qe
rx
KY
KY
KY
KY
"}
(21,1,1) = {"
KY
KY
KY
KY
KY
rg
Qe
Ts
xs
Qe
Ts
Ts
Ts
Eo
rx
KY
KY
KY
KY
KY
"}
(22,1,1) = {"
KY
KY
KY
KY
KY
KY
MU
Jo
Se
OA
lE
lE
Wi
MU
KY
KY
KY
KY
KY
KY
"}
(23,1,1) = {"
KY
KY
KY
KY
KY
KY
MU
Jo
QA
MU
Jo
zY
QA
MU
KY
KY
KY
KY
KY
KY
"}
(24,1,1) = {"
KY
KY
aM
zD
zD
zD
MU
rf
Jo
MU
SL
Al
qY
MU
zD
zD
zD
qD
KY
KY
"}
(25,1,1) = {"
KY
KY
nG
zD
qD
bC
rx
lE
Jo
rg
Qe
Ts
Ts
yB
NM
cy
zD
GP
KY
KY
"}
(26,1,1) = {"
KY
aM
zD
zD
GP
MU
Jo
Jo
Jo
zs
OA
Jo
zY
YV
MU
nG
zD
zD
qD
KY
"}
(27,1,1) = {"
KY
nG
zD
zD
qD
MU
Ze
Jo
lE
Jo
MU
QA
Jo
GC
MU
cy
zD
zD
GP
KY
"}
(28,1,1) = {"
KY
KY
aM
zD
GP
rg
Qe
Ts
xs
Ts
Eo
xs
Ts
Qe
rx
nG
zD
qD
KY
KY
"}
(29,1,1) = {"
KY
KY
nG
zD
zD
zD
MU
QA
Jo
Jo
MU
rS
Jo
MU
zD
zD
zD
GP
KY
KY
"}
(30,1,1) = {"
KY
KY
KY
KY
KY
KY
MU
FO
Bo
QA
MU
rJ
Ys
MU
KY
KY
KY
KY
KY
KY
"}
(31,1,1) = {"
KY
KY
KY
KY
KY
KY
rg
NM
Vo
lE
MU
Fc
bC
rx
KY
KY
KY
KY
KY
KY
"}
(32,1,1) = {"
KY
KY
KY
KY
KY
KY
KY
rg
Ts
Ts
yB
Ts
rx
KY
KY
KY
KY
KY
KY
KY
"}
(33,1,1) = {"
KY
KY
KY
KY
KY
KY
KY
KY
Tf
KY
KY
Tf
KY
KY
KY
KY
KY
KY
KY
KY
"}
(34,1,1) = {"
KY
KY
KY
KY
KY
KY
KY
KY
KY
KY
KY
KY
KY
KY
KY
KY
KY
KY
KY
KY
"}
