"aa" = (/turf/variableTurf/wall,/area)
"ab" = (/turf/variableTurf/clear,/area)
"ac" = (/obj/wingrille_spawn/auto/crystal,/turf/simulated/floor/plating/random,/area/raceway)
"ad" = (/obj/decal/tile_edge/check/white{icon_state = "check1"; dir = 6},/obj/machinery/light/incandescent/warm,/turf/simulated/floor/grass{name = "astroturf"},/area/raceway)
"ae" = (/obj/decal/tile_edge/check/white{icon_state = "check1"},/turf/simulated/floor/grass{name = "astroturf"},/area/raceway)
"af" = (/obj/shrub{icon_state = "shrub"; dir = 1},/obj/decal/tile_edge/check/white{icon_state = "check1"},/obj/item/old_grenade/banana,/turf/simulated/floor/grass{name = "astroturf"},/area/raceway)
"ag" = (/obj/decal/tile_edge/check/white{icon_state = "check1"},/obj/machinery/light/incandescent/warm,/turf/simulated/floor/grass{name = "astroturf"},/area/raceway)
"ah" = (/obj/decal/tile_edge/check/white{icon_state = "check1"; dir = 10},/turf/simulated/floor/grass{name = "astroturf"},/area/raceway)
"ai" = (/turf/variableTurf/floor,/area)
"aj" = (/obj/decal/tile_edge/check/white{icon_state = "check1"; dir = 6},/turf/simulated/floor/grass{name = "astroturf"},/area/raceway)
"ak" = (/obj/decal/tile_edge/check/white{icon_state = "check2"; dir = 6},/turf/simulated/floor/grass{name = "astroturf"},/area/raceway)
"al" = (/turf/simulated/floor/shuttlebay{name = "reinforced plating"},/area/raceway)
"am" = (/obj/shrub,/obj/decal/tile_edge/check/white{icon_state = "check2"; dir = 10},/obj/item/old_grenade/banana,/turf/simulated/floor/grass{name = "astroturf"},/area/raceway)
"an" = (/obj/decal/tile_edge/check/white{icon_state = "check1"; dir = 4},/turf/simulated/floor/grass{name = "astroturf"},/area/raceway)
"ao" = (/obj/decal/tile_edge/line/white{icon_state = "line3"; dir = 8},/turf/simulated/floor/shuttlebay{name = "reinforced plating"},/area/raceway)
"ap" = (/obj/decal/tile_edge/check/white{icon_state = "check1"; dir = 8},/obj/machinery/light/incandescent/warm,/turf/simulated/floor/grass{name = "astroturf"},/area/raceway)
"aq" = (/turf/simulated/wall/auto/reinforced/supernorn,/area/raceway)
"ar" = (/obj/item/shipcomponent/locomotion/wheels,/obj/item/shipcomponent/locomotion/wheels,/turf/simulated/floor/shuttlebay{name = "reinforced plating"},/area/raceway)
"as" = (/obj/decal/tile_edge/check/white{icon_state = "check1"; dir = 8},/turf/simulated/floor/grass{name = "astroturf"},/area/raceway)
"at" = (/obj/decal/cleanable/dirt,/turf/simulated/floor/black,/area/raceway)
"au" = (/obj/machinery/light/incandescent/cool,/turf/simulated/floor/black,/area/raceway)
"av" = (/obj/submachine/chef_sink/chem_sink{layer = 3; pixel_y = 8},/turf/simulated/floor/black,/area/raceway)
"aw" = (/turf/variableTurf/clear,/area/noGenerate)
"ax" = (/turf/simulated/floor/black,/area/raceway)
"ay" = (/obj/reagent_dispensers/fueltank,/turf/simulated/floor/black,/area/raceway)
"az" = (/obj/storage/crate,/obj/item/reagent_containers/food/drinks/fueltank,/obj/item/weldingtool,/obj/item/weldingtool,/obj/item/reagent_containers/glass/oilcan,/obj/machinery/light/incandescent/cool,/obj/item/reagent_containers/glass/bucket,/turf/simulated/floor/black,/area/raceway)
"aA" = (/obj/decal/tile_edge/check/white{icon_state = "check1"; dir = 4},/obj/machinery/light/incandescent/warm,/turf/simulated/floor/grass{name = "astroturf"},/area/raceway)
"aB" = (/obj/machinery/light/small/floor/warm,/turf/simulated/floor/shuttlebay{name = "reinforced plating"},/area/raceway)
"aC" = (/obj/decal/tile_edge/check/white{icon_state = "check2"; dir = 9},/turf/simulated/floor/grass{name = "astroturf"},/area/raceway)
"aD" = (/obj/decal/tile_edge/check/white{icon_state = "check1"; dir = 1},/obj/item/seed/grass,/turf/simulated/floor/grass{name = "astroturf"},/area/raceway)
"aE" = (/obj/decal/tile_edge/check/white{icon_state = "check2"; dir = 5},/turf/simulated/floor/grass{name = "astroturf"},/area/raceway)
"aF" = (/obj/wingrille_spawn/auto,/turf/simulated/floor/plating/random,/area/raceway)
"aG" = (/obj/item/sheet/steel/fullstack,/obj/item/rods/steel/fullstack,/turf/simulated/floor/black,/area/raceway)
"aH" = (/obj/decal/cleanable/oil/streak,/turf/simulated/floor/black,/area/raceway)
"aI" = (/obj/decal/cleanable/dirt,/obj/rack,/obj/item/paint_can/random,/obj/item/paint_can/random,/obj/item/paint_can/random,/turf/simulated/floor/black,/area/raceway)
"aJ" = (/obj/decal/tile_edge/check/white{icon_state = "check1"; dir = 9},/turf/simulated/floor/grass{name = "astroturf"},/area/raceway)
"aK" = (/obj/decal/tile_edge/check/white{icon_state = "check3"; dir = 8},/turf/simulated/floor/grass{name = "astroturf"},/area/raceway)
"aL" = (/obj/decal/tile_edge/check/white{icon_state = "check1"; dir = 5},/obj/item/seed/alien,/obj/machinery/light/small/floor/warm,/turf/simulated/floor/grass{name = "astroturf"},/area/raceway)
"aM" = (/obj/machinery/door/airlock/pyro{dir = 4},/turf/simulated/floor/plating/random,/area/raceway)
"aN" = (/obj/table/auto,/obj/critter/mimic,/turf/simulated/floor/black,/area/raceway)
"aO" = (/obj/table/auto,/obj/item/shipcomponent/secondary_system/lock,/obj/item/shipcomponent/secondary_system/lock,/turf/simulated/floor/black,/area/raceway)
"aP" = (/obj/wingrille_spawn/auto/crystal,/obj/wingrille_spawn/auto/crystal,/turf/simulated/floor/plating/random,/area/raceway)
"aQ" = (/obj/shrub{icon_state = "shrub"; dir = 6},/obj/decal/tile_edge/check/white{icon_state = "check1"; dir = 4},/obj/item/old_grenade/banana,/turf/simulated/floor/grass{name = "astroturf"},/area/raceway)
"aR" = (/obj/shrub{icon_state = "shrub"; dir = 6},/obj/item/seed/alien,/turf/simulated/floor/grass{name = "astroturf"},/area/raceway)
"aS" = (/turf/simulated/floor/grass{name = "astroturf"},/area/raceway)
"aT" = (/obj/critter/spacebee,/obj/shrub{icon_state = "shrub"; dir = 6},/turf/simulated/floor/grass{name = "astroturf"},/area/raceway)
"aU" = (/obj/critter/mimic,/turf/simulated/floor/shuttlebay{name = "reinforced plating"},/area/raceway)
"aV" = (/obj/decal/tile_edge/check/white{icon_state = "check1"; dir = 8},/obj/shrub,/obj/machinery/light/incandescent/warm,/obj/item/old_grenade/banana,/turf/simulated/floor/grass{name = "astroturf"},/area/raceway)
"aW" = (/obj/decal/cleanable/oil,/obj/item/storage/belt/utility,/turf/simulated/floor/black,/area/raceway)
"aX" = (/obj/decal/cleanable/oil,/turf/simulated/floor/black,/area/raceway)
"aY" = (/obj/table/auto,/obj/item/shipcomponent/mainweapon/taser,/obj/item/shipcomponent/mainweapon/taser,/turf/simulated/floor/black,/area/raceway)
"aZ" = (/obj/table/auto,/obj/item/shipcomponent/locomotion/treads,/obj/item/shipcomponent/locomotion/treads,/turf/simulated/floor/black,/area/raceway)
"ba" = (/obj/machinery/light/small/floor/warm,/turf/simulated/floor/grass{name = "astroturf"},/area/raceway)
"bb" = (/obj/critter/spacebee,/turf/simulated/floor/grass{name = "astroturf"},/area/raceway)
"bc" = (/obj/decal/skeleton,/turf/simulated/floor/grass{name = "astroturf"},/area/raceway)
"bd" = (/obj/decal/cleanable/dirt,/obj/item/mop,/turf/simulated/floor/black,/area/raceway)
"be" = (/obj/machinery/manufacturer/hangar,/obj/machinery/light/incandescent/cool,/turf/simulated/floor/black,/area/raceway)
"bf" = (/obj/item/parts/robot_parts/chest/light,/turf/simulated/floor/grass{name = "astroturf"},/area/raceway)
"bg" = (/obj/stool/bench/green,/obj/item/storage/toolbox/mechanical,/turf/simulated/floor/grass{name = "astroturf"},/area/raceway)
"bh" = (/obj/machinery/door/airlock/pyro,/turf/simulated/floor/black,/area/raceway)
"bi" = (/obj/item/parts/robot_parts/head/antique,/turf/simulated/floor/grass{name = "astroturf"},/area/raceway)
"bj" = (/obj/machinery/vending/coffee,/obj/machinery/light/incandescent/warm,/turf/simulated/floor/black,/area/raceway)
"bk" = (/obj/machinery/vending/cigarette,/turf/simulated/floor/black,/area/raceway)
"bl" = (/obj/shrub{icon_state = "shrub"; dir = 6},/obj/landmark/artifact,/turf/simulated/floor/grass{name = "astroturf"},/area/raceway)
"bm" = (/obj/decal/tile_edge/line/white{icon_state = "line1"; dir = 2},/obj/decal/tile_edge/line/white{icon_state = "line3"; dir = 2},/obj/decal/tile_edge/line/white{icon_state = "line1"; dir = 1},/turf/simulated/floor/shuttlebay{name = "reinforced plating"},/area/raceway)
"bn" = (/obj/wingrille_spawn/auto,/turf/simulated/floor/black,/area/raceway)
"bo" = (/obj/stool/bench/red,/turf/simulated/floor/black,/area/raceway)
"bp" = (/turf/simulated/floor,/area/raceway)
"bq" = (/obj/table/auto,/obj/item/reagent_containers/food/snacks/cereal_box,/obj/item/reagent_containers/food/snacks/chips,/obj/item/reagent_containers/food/snacks/chips,/obj/item/reagent_containers/food/snacks/corndog/banana,/obj/item/reagent_containers/food/snacks/corndog/banana,/obj/item/reagent_containers/food/snacks/corndog/banana,/turf/simulated/floor/black,/area/raceway)
"br" = (/obj/table/auto,/obj/item/material_piece/gold,/obj/machinery/light/incandescent/warm,/turf/simulated/floor/black,/area/raceway)
"bs" = (/obj/shrub,/obj/decal/tile_edge/check/white{icon_state = "check1"; dir = 4},/obj/item/old_grenade/banana,/turf/simulated/floor/grass{name = "astroturf"},/area/raceway)
"bt" = (/obj/shrub{icon_state = "shrub"; dir = 10},/obj/item/old_grenade/banana/cheese_sandwich,/turf/simulated/floor/grass{name = "astroturf"},/area/raceway)
"bu" = (/obj/shrub{icon_state = "shrub"; dir = 1},/obj/item/old_grenade/banana,/turf/simulated/floor/grass{name = "astroturf"},/area/raceway)
"bv" = (/obj/table/auto,/obj/item/reagent_containers/food/snacks/cookie/chocolate_chip,/obj/item/reagent_containers/food/snacks/cookie/chocolate_chip,/obj/item/reagent_containers/food/snacks/cookie/chocolate_chip,/obj/item/reagent_containers/food/snacks/cookie/chocolate_chip,/obj/item/reagent_containers/food/snacks/cookie/chocolate_chip,/turf/simulated/floor/black,/area/raceway)
"bw" = (/obj/decal/tile_edge/check/white{icon_state = "check2"; dir = 10},/turf/simulated/floor/grass{name = "astroturf"},/area/raceway)
"bx" = (/obj/decal/tile_edge/check/white{icon_state = "check1"; dir = 10},/obj/machinery/light/small/floor/warm,/turf/simulated/floor/grass{name = "astroturf"},/area/raceway)
"by" = (/obj/table/auto,/obj/item/sticker/ribbon/participant,/obj/item/sticker/ribbon/third_place,/obj/item/sticker/ribbon/second_place,/obj/item/sticker/ribbon/first_place,/turf/simulated/floor/black,/area/raceway)
"bz" = (/obj/decal/tile_edge/check/white{icon_state = "check1"},/obj/decal/tile_edge/check/white{icon_state = "check3"; dir = 8},/turf/simulated/floor/grass{name = "astroturf"},/area/raceway)
"bA" = (/obj/machinery/light/incandescent/netural,/turf/simulated/floor,/area/raceway)
"bB" = (/obj/machinery/door/airlock/pyro/external,/turf/simulated/floor/red/checker,/area/raceway)
"bC" = (/obj/decal/tile_edge/check/white{icon_state = "check1"; dir = 5},/turf/simulated/floor/grass{name = "astroturf"},/area/raceway)
"bD" = (/obj/shrub{icon_state = "shrub"; dir = 1},/obj/decal/tile_edge/check/white{icon_state = "check1"; dir = 9},/obj/item/old_grenade/banana,/turf/simulated/floor/grass{name = "astroturf"},/area/raceway)
"bE" = (/obj/machinery/drainage/big,/turf/simulated/floor,/area/raceway)
"bF" = (/obj/decal/tile_edge/check/white{icon_state = "check1"; dir = 1},/turf/simulated/floor/grass{name = "astroturf"},/area/raceway)
"bG" = (/obj/shrub{icon_state = "shrub"; dir = 6},/obj/decal/tile_edge/check/white{icon_state = "check1"; dir = 1},/obj/item/old_grenade/banana,/turf/simulated/floor/grass{name = "astroturf"},/area/raceway)
"bH" = (/obj/decal/tile_edge/check/white{icon_state = "check1"; dir = 1},/obj/machinery/light/incandescent/warm,/turf/simulated/floor/grass{name = "astroturf"},/area/raceway)
"bI" = (/obj/machinery/door/airlock/pyro/external,/turf/simulated/floor/blackwhite/whitegrime,/area/raceway)
"bJ" = (/obj/machinery/vehicle/tank/car/blue,/turf/simulated/floor/shuttlebay{name = "reinforced plating"},/area/raceway)
"bK" = (/obj/machinery/vehicle/tank/car/red,/turf/simulated/floor/shuttlebay{name = "reinforced plating"},/area/raceway)

(1,1,1) = {"
abababababababababababababababababababababababab
ababacacacacacacacacacacacacacabababaaaaaaaaabab
abacacadaeafaeagaeaeaeagaeahacacabaiaiaiaaaaabab
abacajakalalalalalalalalalamahacabaiaiaaaaaaabab
abacanalalaoalalaoalalaoalalapaqaqaqaqaqaqaqaqab
abacanalalalalalalalaralalalasaqatauavaxayazaqab
abacaAalaoalaBaCaDaEalbJaoalasaFaxaGaHaxaxaIaqab
abacanalalalaCaJaKaLaEalbKalasaMaxaxaxaxaNaOaqab
abaPaQalaralasaRaSaTanaUalalaVaMaxaWaxaXaYaZaqab
abaPanalaoalasbabbbcanalaoalasaFaxaxaxaxaxaxaqab
abacaAalalalasaSaKbbanalalalasaqaxauaxaxbdbeaqab
abaPanalaoalasbfbgbaanalaoalasaqaqaqbhbhaqaqaqab
abacanalalalasaSaKbianalalalasaqaxaxaxaxbjbkaqab
abacanalalalasbablaSanbmbmbmasbnboaxaxaxaxaxaqab
abacaAalaoalasaSaSaSanalaoalapbnboaxbpbpaxbqaqab
abacanalalalasaSaKbaanalalalasbnboaxbpbpaxbraqab
abacbsalalalasbtaSbuanalalalasbnboaxbpbpaxbvaqab
abacanalaoalbwbxaSajakalaoalasbnboaxbpbpaxbyaqab
abacanalalalalbwbzakaBalalalasaqaxaxbpbpaxaxaqab
abacaAalalalalalalalalalalalapaqbpbAbpbpbpbAaqab
abacanalalaoalalaoalalaoalalasaqaqaqbBbBaqaqaqab
abacbCaEalalalalalalalalalaCbDaqabaqbEbEaqababab
abacacbCbFbGbHbFbFbFbFbHbFaJacacabaqbpbpaqababab
ababacacacacacacacacacacacacacababaqbIbIaqababab
abababababababababababababababababawawawawababab
"}
