//MAP CONVERTED BY dmm2tgm.py THIS HEADER COMMENT PREVENTS RECONVERSION, DO NOT REMOVE
"a" = (
/turf/simulated/wall/auto/supernorn/wood,
/area/noGenerate)
"f" = (
/turf/variableTurf/clear,
/area/allowGenerate)
"y" = (
/obj/machinery/door/unpowered/wood/pyro{
	pixel_y = -9
	},
/turf/unsimulated/outdoors/concrete,
/area/noGenerate)
"E" = (
/obj/machinery/light/small{
	dir = 1
	},
/turf/unsimulated/outdoors/concrete,
/area/noGenerate)
"R" = (
/turf/unsimulated/outdoors/concrete,
/area/noGenerate)
"U" = (
/obj/deployable_turret/outpost/active/south,
/turf/unsimulated/outdoors/concrete,
/area/noGenerate)

(1,1,1) = {"
f
f
f
f
f
f
f
f
f
f
"}
(2,1,1) = {"
f
a
a
a
a
a
f
f
f
f
"}
(3,1,1) = {"
f
a
R
R
R
a
a
a
a
f
"}
(4,1,1) = {"
f
a
E
U
R
y
R
R
y
f
"}
(5,1,1) = {"
f
a
R
R
R
a
a
a
a
f
"}
(6,1,1) = {"
f
a
a
a
a
a
f
f
f
f
"}
(7,1,1) = {"
f
f
f
f
f
f
f
f
f
f
"}
