//MAP CONVERTED BY dmm2tgm.py THIS HEADER COMMENT PREVENTS RECONVERSION, DO NOT REMOVE
"a" = (
/turf/variableTurf/clear,
/area/allowGenerate)
"K" = (
/mob/living/critter/small_animal/bird/random,
/turf/variableTurf/clear,
/area/allowGenerate)

(1,1,1) = {"
a
a
a
"}
(2,1,1) = {"
a
K
a
"}
(3,1,1) = {"
a
a
a
"}
(4,1,1) = {"
a
K
a
"}
(5,1,1) = {"
a
a
a
"}
