//MAP CONVERTED BY dmm2tgm.py THIS HEADER COMMENT PREVENTS RECONVERSION, DO NOT REMOVE
"a" = (
/turf/variableTurf/clear,
/area/allowGenerate)
"g" = (
/obj/storage/crate,
/obj/random_item_spawner/junk/some,
/obj/random_item_spawner/snacks/some,
/turf/unsimulated/outdoors/concrete,
/area/noGenerate)
"i" = (
/obj/storage/crate,
/obj/random_item_spawner/junk/some,
/obj/random_item_spawner/tools_w_igloves/some,
/obj/machinery/light/small{
	dir = 1
	},
/turf/unsimulated/outdoors/concrete,
/area/noGenerate)
"s" = (
/obj/machinery/door/unpowered/wood/pyro{
	pixel_y = -9
	},
/turf/unsimulated/outdoors/concrete,
/area/noGenerate)
"z" = (
/obj/storage/crate,
/obj/random_item_spawner/junk/some,
/turf/unsimulated/outdoors/concrete,
/area/noGenerate)
"P" = (
/obj/storage/crate,
/obj/random_item_spawner/junk/some,
/obj/random_item_spawner/med_tool/some,
/turf/unsimulated/outdoors/concrete,
/area/noGenerate)
"R" = (
/obj/storage/crate,
/obj/random_item_spawner/junk/some,
/obj/random_item_spawner/med_kit/one,
/turf/unsimulated/outdoors/concrete,
/area/noGenerate)
"U" = (
/turf/unsimulated/outdoors/concrete,
/area/noGenerate)
"Y" = (
/turf/simulated/wall/auto/supernorn/wood,
/area/noGenerate)

(1,1,1) = {"
a
a
a
a
a
a
a
a
a
a
"}
(2,1,1) = {"
a
Y
Y
Y
Y
Y
a
a
a
a
"}
(3,1,1) = {"
a
Y
R
z
U
Y
Y
Y
Y
a
"}
(4,1,1) = {"
a
Y
i
P
U
s
U
U
s
a
"}
(5,1,1) = {"
a
Y
g
z
U
Y
Y
Y
Y
a
"}
(6,1,1) = {"
a
Y
Y
Y
Y
Y
a
a
a
a
"}
(7,1,1) = {"
a
a
a
a
a
a
a
a
a
a
"}
