//MAP CONVERTED BY dmm2tgm.py THIS HEADER COMMENT PREVENTS RECONVERSION, DO NOT REMOVE
"a" = (
/turf/variableTurf/clear,
/area/allowGenerate)
"d" = (
/mob/living/carbon/human/npc/monkey/angry,
/turf/variableTurf/clear,
/area/allowGenerate)
"D" = (
/obj/fakeobject/skeleton/decomposed_corpse{
	icon_state = "body5"
	},
/obj/item/device/radio/signaler{
	pixel_x = -11;
	pixel_y = 14
	},
/turf/variableTurf/clear,
/area/allowGenerate)
"F" = (
/mob/living/carbon/human/npc/monkey,
/turf/variableTurf/clear,
/area/allowGenerate)
"R" = (
/obj/storage/crate,
/obj/item/reagent_containers/food/snacks/plant/banana,
/obj/item/reagent_containers/food/snacks/plant/banana,
/obj/item/reagent_containers/food/snacks/plant/banana,
/obj/item/clothing/glasses/blindfold,
/obj/item/device/radio/electropack,
/obj/item/device/radio/electropack,
/obj/item/device/radio/electropack,
/turf/variableTurf/clear,
/area/allowGenerate)
"V" = (
/obj/item/bananapeel,
/turf/variableTurf/clear,
/area/allowGenerate)

(1,1,1) = {"
a
a
a
a
"}
(2,1,1) = {"
a
F
V
a
"}
(3,1,1) = {"
a
D
a
F
"}
(4,1,1) = {"
a
d
R
a
"}
(5,1,1) = {"
a
a
a
a
"}
