"a" = (/turf/simulated/floor/plating,/area/dmm_suite/clear_area)
"h" = (/obj/machinery/manufacturer/hangar,/obj/railing/orange/reinforced,/turf/simulated/floor/caution/corner/sw,/area/dmm_suite/clear_area)
"i" = (/obj/railing/orange/reinforced,/obj/table/reinforced/industrial/auto,/obj/item/cable_coil/black,/turf/simulated/floor/caution/corner/se,/area/dmm_suite/clear_area)
"o" = (/obj/reagent_dispensers/fueltank,/turf/simulated/floor/shuttlebay,/area/dmm_suite/clear_area)
"q" = (/obj/table/reinforced/industrial/auto,/obj/item/decoration/ashtray{pixel_x = 1; pixel_y = -2},/turf/simulated/floor/caution/east,/area/dmm_suite/clear_area)
"v" = (/obj/machinery/shieldgenerator/energy_shield,/obj/storage/crate/wooden,/obj/beaconkit,/turf/simulated/floor/shuttlebay,/area/dmm_suite/clear_area)
"w" = (/obj/cable/black{icon_state = "1-2"},/turf/simulated/floor/stairs,/area/dmm_suite/clear_area)
"A" = (/obj/cable/black,/obj/machinery/light/small/floor,/turf/simulated/floor/plating/damaged3,/area/dmm_suite/clear_area)
"C" = (/turf/simulated/floor/shuttlebay,/area/dmm_suite/clear_area)
"E" = (/obj/machinery/portable_atmospherics/canister/air,/turf/simulated/floor/plating/damaged1,/area/dmm_suite/clear_area)
"T" = (/obj/cable/black{icon_state = "0-2"},/obj/item/tile/steel{pixel_x = 3; pixel_y = 1},/turf/simulated/floor/plating,/area/dmm_suite/clear_area)
"V" = (/obj/cable/black{icon_state = "1-2"},/obj/item/crowbar/red{pixel_x = 5; pixel_y = -5},/obj/item/device/t_scanner{pixel_x = -7},/turf/simulated/floor/shuttlebay,/area/dmm_suite/clear_area)
"W" = (/obj/item/rods/steel{amount = 12; pixel_x = -5; pixel_y = -3},/turf/simulated/floor/plating,/area/dmm_suite/clear_area)
"Z" = (/obj/rack,/obj/item/clothing/suit/space/emerg,/obj/item/clothing/head/emerg,/obj/item/clothing/mask/breath,/obj/item/tank/air,/obj/item/device/light/flashlight,/turf/simulated/floor/caution/west,/area/dmm_suite/clear_area)

(1,1,1) = {"
ZTq
hwi
oVv
CAW
aaE
"}
