//MAP CONVERTED BY dmm2tgm.py THIS HEADER COMMENT PREVENTS RECONVERSION, DO NOT REMOVE
"a" = (
/obj/rack,
/obj/item/clothing/gloves/long{
	pixel_x = 5;
	pixel_y = -4
	},
/turf/simulated/floor/plating/random,
/area/dmm_suite/clear_area)
"b" = (
/obj/table/reinforced/bar/auto,
/obj/item/storage/box/plates{
	spawn_contents = null;
	pixel_y = 8
	},
/turf/simulated/floor/plating/random,
/area/dmm_suite/clear_area)
"i" = (
/turf/simulated/floor/plating/random,
/area/dmm_suite/clear_area)
"m" = (
/obj/table/reinforced/industrial/auto,
/obj/item/plate{
	pixel_x = 1;
	pixel_y = 9
	},
/obj/item/plate{
	pixel_x = -5;
	pixel_y = 1
	},
/obj/item/reagent_containers/food/drinks/bowl{
	pixel_x = 8;
	pixel_y = 6
	},
/turf/simulated/floor/plating/random,
/area/dmm_suite/clear_area)
"p" = (
/obj/decal/cleanable/dirt,
/obj/item/raw_material/shard/glass{
	pixel_x = 5;
	pixel_y = 9
	},
/obj/decal/cleanable/blood/tracks,
/turf/simulated/floor/plating/random,
/area/dmm_suite/clear_area)
"x" = (
/obj/table/reinforced/industrial/auto,
/obj/item/plate{
	pixel_y = -2;
	pixel_x = 5
	},
/obj/item/reagent_containers/food/drinks/bowl{
	pixel_y = 9;
	pixel_x = -5
	},
/turf/simulated/floor/plating/random,
/area/dmm_suite/clear_area)
"A" = (
/obj/table/reinforced/bar/auto,
/obj/decal/cleanable/dirt/dirt4,
/obj/item/reagent_containers/food/drinks/bowl{
	pixel_x = -4;
	pixel_y = 12
	},
/obj/item/reagent_containers/food/drinks/bowl{
	pixel_x = -8;
	pixel_y = 3
	},
/obj/item/reagent_containers/food/drinks/bowl{
	pixel_y = -1;
	pixel_x = 4
	},
/turf/simulated/floor/plating/random,
/area/dmm_suite/clear_area)
"G" = (
/obj/decal/cleanable/blood/tracks,
/turf/simulated/floor/plating/random,
/area/dmm_suite/clear_area)
"J" = (
/obj/decal/cleanable/dirt,
/obj/item/raw_material/shard/glass,
/obj/item/raw_material/shard/glass{
	pixel_x = -8;
	pixel_y = 9
	},
/turf/simulated/floor/plating/random,
/area/dmm_suite/clear_area)
"K" = (
/obj/decal/cleanable/dirt/dirt2,
/turf/simulated/floor/plating/random,
/area/dmm_suite/clear_area)
"M" = (
/obj/table/reinforced/industrial/auto,
/obj/item/spraybottle/cleaner{
	pixel_x = -6;
	pixel_y = 11
	},
/obj/item/decoration/flower_vase{
	pixel_x = 5;
	pixel_y = 23
	},
/obj/item/cloth/towel/yellow{
	pixel_x = 6
	},
/turf/simulated/floor/plating/random,
/area/dmm_suite/clear_area)
"O" = (
/obj/submachine/chef_sink,
/obj/decal/cleanable/cobweb2,
/turf/simulated/floor/plating/random,
/area/dmm_suite/clear_area)
"Y" = (
/obj/decal/cleanable/dirt/dirt5,
/turf/simulated/floor/plating/random,
/area/dmm_suite/clear_area)

(1,1,1) = {"
M
x
i
Y
b
"}
(2,1,1) = {"
m
K
J
i
A
"}
(3,1,1) = {"
O
p
G
i
a
"}
