//MAP CONVERTED BY dmm2tgm.py THIS HEADER COMMENT PREVENTS RECONVERSION, DO NOT REMOVE
"a" = (
/obj/machinery/drainage,
/obj/item/reagent_containers/food/fish/random,
/obj/decal/stage_edge,
/turf/simulated/floor/twotone/blue,
/area/dmm_suite/clear_area)
"c" = (
/obj/machinery/light/incandescent{
	dir = 1
	},
/obj/item/paper/folded/ball{
	pixel_y = -11;
	pixel_x = 8
	},
/turf/simulated/floor/swampgrass,
/area/dmm_suite/clear_area)
"h" = (
/obj/machinery/light/incandescent,
/turf/simulated/floor/blue,
/area/dmm_suite/clear_area)
"i" = (
/turf/simulated/floor/stairs/wood2,
/area/dmm_suite/clear_area)
"o" = (
/obj/machinery/light/incandescent{
	dir = 1
	},
/turf/simulated/floor/swampgrass,
/area/dmm_suite/clear_area)
"t" = (
/obj/item/fishing_rod/basic{
	pixel_x = 6;
	pixel_y = 3
	},
/obj/item/fishing_rod/basic{
	pixel_y = 7;
	pixel_x = -2
	},
/obj/item/reagent_containers/glass/bucket{
	pixel_y = -5;
	pixel_x = 12
	},
/turf/simulated/floor/wood,
/area/dmm_suite/clear_area)
"w" = (
/obj/decal/cleanable/paper,
/turf/simulated/floor/twotone/blue,
/area/dmm_suite/clear_area)
"B" = (
/obj/item/cigbutt{
	pixel_x = 2;
	pixel_y = -3
	},
/obj/item/cigbutt{
	pixel_y = 3;
	pixel_x = 8
	},
/turf/simulated/floor/swampgrass,
/area/dmm_suite/clear_area)
"E" = (
/turf/simulated/floor/swampgrass,
/area/dmm_suite/clear_area)
"I" = (
/turf/simulated/floor/swampgrass_edging,
/area/dmm_suite/clear_area)
"Q" = (
/obj/storage/crate/freezer{
	desc = "A cooler to keep your fresh catches in.";
	name = "cooler"
	},
/turf/simulated/floor/swampgrass,
/area/dmm_suite/clear_area)
"R" = (
/turf/simulated/floor/twotone/blue,
/area/dmm_suite/clear_area)
"Z" = (
/obj/item/reagent_containers/food/drinks/bottle/fancy_beer{
	pixel_y = -3
	},
/obj/item/reagent_containers/food/drinks/bottle/fancy_beer{
	pixel_x = -10
	},
/obj/item/reagent_containers/food/drinks/bottle/fancy_beer{
	pixel_y = -6;
	pixel_x = -12
	},
/turf/simulated/floor/wood,
/area/dmm_suite/clear_area)

(1,1,1) = {"
c
B
I
R
h
"}
(2,1,1) = {"
E
i
Z
t
a
"}
(3,1,1) = {"
o
Q
I
w
h
"}
