//MAP CONVERTED BY dmm2tgm.py THIS HEADER COMMENT PREVENTS RECONVERSION, DO NOT REMOVE
"a" = (
/obj/surgery_tray,
/obj/random_item_spawner/med_tool/few,
/turf/simulated/floor/plating/random,
/area/dmm_suite/clear_area)
"e" = (
/obj/machinery/drainage,
/obj/item/parts/human_parts/arm/left,
/turf/simulated/floor/plating/random,
/area/dmm_suite/clear_area)
"i" = (
/obj/decal/cleanable/blood/gibs/body,
/obj/decal/cleanable/blood/splatter,
/obj/item/parts/human_parts/leg/left,
/turf/simulated/floor/plating/random,
/area/dmm_suite/clear_area)
"l" = (
/obj/storage/crate/bloody,
/obj/random_item_spawner/organs/bloody/one_to_three,
/turf/simulated/floor/plating/random,
/area/dmm_suite/clear_area)
"m" = (
/obj/machinery/computer3/generic/med_data,
/obj/machinery/light/incandescent/harsh{
	dir = 1
	},
/turf/simulated/floor/plating/random,
/area/dmm_suite/clear_area)
"s" = (
/obj/surgery_tray,
/obj/random_item_spawner/med_kit,
/obj/random_item_spawner/medicine/few,
/turf/simulated/floor/plating/random,
/area/dmm_suite/clear_area)
"u" = (
/obj/decal/cleanable/blood,
/obj/machinery/light/incandescent/harsh,
/turf/simulated/floor/plating/random,
/area/dmm_suite/clear_area)
"w" = (
/obj/iv_stand,
/obj/item/reagent_containers/iv_drip/blood,
/turf/simulated/floor/plating/random,
/area/dmm_suite/clear_area)
"x" = (
/turf/simulated/floor/plating/random,
/area/dmm_suite/clear_area)
"A" = (
/obj/item/parts/human_parts/leg/right,
/turf/simulated/floor/plating/random,
/area/dmm_suite/clear_area)
"O" = (
/obj/decal/cleanable/blood/tracks,
/turf/simulated/floor/plating/random,
/area/dmm_suite/clear_area)
"Q" = (
/obj/decal/cleanable/blood/drip/high,
/turf/simulated/floor/plating/random,
/area/dmm_suite/clear_area)
"S" = (
/obj/machinery/optable,
/obj/item/toy/plush/small/monkey,
/obj/decal/cleanable/blood/gibs/body,
/obj/fluid_spawner/polluted_filth/blood,
/turf/simulated/floor/plating/random,
/area/dmm_suite/clear_area)
"Y" = (
/obj/machinery/drainage,
/obj/item/parts/human_parts/arm/right,
/turf/simulated/floor/plating/random,
/area/dmm_suite/clear_area)

(1,1,1) = {"
m
Q
Y
a
A
"}
(2,1,1) = {"
O
w
S
i
x
"}
(3,1,1) = {"
l
x
e
s
u
"}
