//MAP CONVERTED BY dmm2tgm.py THIS HEADER COMMENT PREVENTS RECONVERSION, DO NOT REMOVE
"a" = (
/obj/stool/chair{
	dir = 1
	},
/turf/simulated/floor/carpet/grime,
/area/dmm_suite/clear_area)
"h" = (
/obj/machinery/vending/snack,
/turf/simulated/floor/carpet/grime,
/area/dmm_suite/clear_area)
"m" = (
/obj/stool/chair,
/turf/simulated/floor/carpet/grime,
/area/dmm_suite/clear_area)
"y" = (
/obj/item/cigbutt,
/turf/simulated/floor/carpet/grime,
/area/dmm_suite/clear_area)
"A" = (
/turf/simulated/floor/carpet/grime,
/area/dmm_suite/clear_area)
"E" = (
/obj/stool/chair/comfy/blue{
	dir = 4
	},
/turf/simulated/floor/carpet/grime,
/area/dmm_suite/clear_area)
"F" = (
/obj/machinery/vending/cigarette,
/turf/simulated/floor/carpet/grime,
/area/dmm_suite/clear_area)
"I" = (
/obj/table/wood/round/auto,
/obj/item/decoration/ashtray{
	butts = 5;
	name = "grubby old ashtray"
	},
/obj/item/reagent_containers/food/drinks/bottle/hobo_wine{
	pixel_y = 5;
	pixel_x = -8
	},
/obj/item/cigbutt,
/obj/machinery/light/small/sticky{
	dir = 4
	},
/turf/simulated/floor/carpet/grime,
/area/dmm_suite/clear_area)
"L" = (
/obj/item/cigbutt,
/obj/machinery/light/small/sticky{
	dir = 4
	},
/turf/simulated/floor/carpet/grime,
/area/dmm_suite/clear_area)
"X" = (
/obj/stool/chair/comfy/blue,
/turf/simulated/floor/carpet/grime,
/area/dmm_suite/clear_area)

(1,1,1) = {"
F
A
y
E
h
"}
(2,1,1) = {"
A
A
y
A
y
"}
(3,1,1) = {"
X
L
m
I
a
"}
