//MAP CONVERTED BY dmm2tgm.py THIS HEADER COMMENT PREVENTS RECONVERSION, DO NOT REMOVE
"an" = (
/obj/item/storage/wall/medical{
	dir = 8
	},
/turf/simulated/wall/auto/shuttle{
	icon_state = "3"
	},
/area/shuttle/escape/centcom/cogmap)
"bX" = (
/turf/unsimulated/floor/carpet/regalcarpet/border{
	dir = 9
	},
/area/shuttle/escape/centcom/cogmap)
"cg" = (
/obj/indestructible/shuttle_corner{
	dir = 0
	},
/turf/unsimulated/floor/carpet/regalcarpet/border{
	dir = 6
	},
/area/shuttle/escape/centcom/cogmap)
"ch" = (
/obj/machinery/computer/shuttle/embedded/south,
/obj/stool/chair/comfy/throne_gold{
	anchored = 1
	},
/obj/machinery/light/small/floor/warm,
/obj/item/clothing/head/crown,
/turf/unsimulated/floor/carpet/regalcarpet/border,
/area/shuttle/escape/centcom/cogmap)
"cx" = (
/obj/shrub{
	dir = 1
	},
/turf/unsimulated/floor/marble/border_bw{
	dir = 8
	},
/area/shuttle/escape/centcom/cogmap)
"cX" = (
/obj/table/regal/auto,
/obj/item/reagent_containers/food/snacks/breadloaf/honeywheat{
	pixel_x = -5;
	pixel_y = 17;
	rand_pos = 0
	},
/obj/item/reagent_containers/food/snacks/breadloaf/pumpkin{
	pixel_x = 3;
	pixel_y = 11;
	rand_pos = 0
	},
/obj/item/reagent_containers/food/snacks/garlicbread_ch{
	pixel_y = 2;
	rand_pos = 0
	},
/obj/machinery/light/small/floor/warm,
/turf/unsimulated/floor/carpet/regalcarpet,
/area/shuttle/escape/centcom/cogmap)
"dq" = (
/turf/unsimulated/floor/carpet/regalcarpet/border{
	dir = 10
	},
/area/shuttle/escape/centcom/cogmap)
"es" = (
/obj/indestructible/shuttle_corner{
	dir = 8
	},
/turf/unsimulated/outdoors/grass,
/area/shuttle/escape/centcom/cogmap)
"eB" = (
/obj/wingrille_spawn/auto,
/obj/wingrille_spawn/auto/crystal,
/turf/unsimulated/floor/marble/black,
/area/shuttle/escape/centcom/cogmap)
"fi" = (
/obj/stool/chair/wooden/regal{
	anchored = 1;
	dir = 8
	},
/turf/unsimulated/floor/carpet/regalcarpet/border{
	dir = 4
	},
/area/shuttle/escape/centcom/cogmap)
"fr" = (
/obj/stool/chair/wooden/regal{
	anchored = 1;
	dir = 4
	},
/turf/unsimulated/floor/carpet/regalcarpet/border{
	dir = 8
	},
/area/shuttle/escape/centcom/cogmap)
"fv" = (
/obj/stool/chair/wooden/regal{
	anchored = 1
	},
/turf/unsimulated/floor/marble/border_bw{
	dir = 10
	},
/area/shuttle/escape/centcom/cogmap)
"gq" = (
/turf/unsimulated/outdoors/grass,
/area/shuttle/escape/centcom/cogmap)
"hB" = (
/obj/decoration/regallamp{
	anchored = 1;
	lit = 1
	},
/turf/unsimulated/floor/carpet/regalcarpet/border,
/area/shuttle/escape/centcom/cogmap)
"hJ" = (
/turf/simulated/wall/auto/shuttle{
	icon_state = "7"
	},
/area/shuttle/escape/centcom/cogmap)
"hY" = (
/obj/machinery/shuttle/engine/heater{
	dir = 1;
	icon_state = "alt_heater-M"
	},
/obj/window/reinforced/south,
/turf/unsimulated/floor/plating,
/area/shuttle/escape/centcom/cogmap)
"jP" = (
/turf/unsimulated/floor/marble/border_wb{
	dir = 10
	},
/area/shuttle/escape/centcom/cogmap)
"kv" = (
/obj/wingrille_spawn/auto/crystal,
/obj/machinery/light/small/floor/warm,
/turf/unsimulated/floor/marble/black,
/area/shuttle/escape/centcom/cogmap)
"kA" = (
/obj/indestructible/invisible_block,
/turf/unsimulated/outdoors/grass,
/area/shuttle/escape/centcom/cogmap)
"lc" = (
/turf/unsimulated/floor/carpet/regalcarpet/border{
	dir = 1
	},
/area/shuttle/escape/centcom/cogmap)
"lr" = (
/turf/unsimulated/floor/marble/border_wb{
	dir = 6
	},
/area/shuttle/escape/centcom/cogmap)
"nf" = (
/turf/unsimulated/outdoors/grass,
/area/centcom/outside)
"nz" = (
/turf/simulated/shuttle/wall/cockpit{
	dir = 1
	},
/area/shuttle/escape/centcom/cogmap)
"pC" = (
/obj/indestructible/shuttle_corner{
	dir = 4
	},
/turf/unsimulated/outdoors/grass,
/area/shuttle/escape/centcom/cogmap)
"qb" = (
/obj/indestructible/shuttle_corner{
	dir = 0
	},
/turf/unsimulated/floor/marble/border_wb{
	dir = 9
	},
/area/shuttle/escape/centcom/cogmap)
"qj" = (
/obj/machinery/shuttle/engine/propulsion{
	dir = 9;
	icon_state = "alt_propulsion"
	},
/turf/unsimulated/outdoors/grass,
/area/shuttle/escape/centcom/cogmap)
"ri" = (
/obj/shrub{
	dir = 1
	},
/obj/machinery/light/small/floor/warm,
/turf/unsimulated/floor/marble/border_bw{
	dir = 4
	},
/area/shuttle/escape/centcom/cogmap)
"vr" = (
/obj/machinery/shuttle/engine/heater{
	dir = 1;
	icon_state = "alt_heater-R"
	},
/obj/window/reinforced/south,
/turf/unsimulated/floor/plating,
/area/shuttle/escape/centcom/cogmap)
"vs" = (
/obj/machinery/light/small/floor/warm,
/obj/stool/chair/comfy/throne_gold{
	anchored = 1
	},
/turf/unsimulated/floor/carpet/regalcarpet/border{
	dir = 5
	},
/area/shuttle/escape/centcom/cogmap)
"vJ" = (
/obj/stool/chair/wooden/regal{
	anchored = 1
	},
/turf/unsimulated/floor/marble/border_bw,
/area/shuttle/escape/centcom/cogmap)
"vL" = (
/obj/machinery/shuttle/engine/heater{
	dir = 1;
	icon_state = "alt_heater-L"
	},
/obj/window/reinforced/south,
/turf/unsimulated/floor/plating,
/area/shuttle/escape/centcom/cogmap)
"vR" = (
/obj/shrub,
/obj/machinery/light/small/floor/warm,
/turf/unsimulated/floor/marble/border_wb{
	dir = 4
	},
/area/shuttle/escape/centcom/cogmap)
"wG" = (
/turf/unsimulated/floor/carpet/regalcarpet/border{
	dir = 5
	},
/area/shuttle/escape/centcom/cogmap)
"xc" = (
/obj/decoration/regallamp{
	anchored = 1;
	lit = 1
	},
/turf/unsimulated/floor/marble/border_bw{
	dir = 4
	},
/area/shuttle/escape/centcom/cogmap)
"xl" = (
/obj/table/regal/auto,
/obj/decoration/floralarrangement{
	pixel_y = 16
	},
/obj/item/reagent_containers/food/snacks/painauchocolat{
	pixel_x = -6;
	pixel_y = 6;
	rand_pos = 0
	},
/obj/item/reagent_containers/food/snacks/painauchocolat{
	pixel_x = -6;
	rand_pos = 0
	},
/obj/item/reagent_containers/food/snacks/painauchocolat{
	pixel_x = -6;
	pixel_y = -6;
	rand_pos = 0
	},
/obj/item/reagent_containers/food/snacks/painauchocolat{
	pixel_x = -6;
	pixel_y = -12;
	rand_pos = 0
	},
/obj/item/reagent_containers/food/snacks/plant/grape{
	pixel_x = 9;
	pixel_y = 5;
	rand_pos = 0
	},
/obj/item/reagent_containers/food/snacks/plant/grape/green{
	pixel_x = 9;
	pixel_y = -2;
	rand_pos = 0
	},
/obj/item/reagent_containers/food/snacks/plant/pear{
	pixel_x = 10;
	pixel_y = -10;
	rand_pos = 0
	},
/obj/machinery/light/small/floor/warm,
/turf/unsimulated/floor/carpet/regalcarpet,
/area/shuttle/escape/centcom/cogmap)
"xs" = (
/obj/indestructible/shuttle_corner{
	dir = 0
	},
/turf/unsimulated/outdoors/grass,
/area/shuttle/escape/centcom/cogmap)
"xZ" = (
/obj/machinery/light/small/floor/warm,
/obj/stool/chair/comfy/throne_gold{
	anchored = 1
	},
/turf/unsimulated/floor/carpet/regalcarpet/border{
	dir = 9
	},
/area/shuttle/escape/centcom/cogmap)
"zB" = (
/obj/machinery/shuttle/engine/propulsion{
	dir = 5;
	icon_state = "alt_propulsion"
	},
/turf/unsimulated/outdoors/grass,
/area/shuttle/escape/centcom/cogmap)
"zV" = (
/obj/decal/lightshaft,
/obj/shrub{
	dir = 8
	},
/obj/machinery/light/small/floor/warm,
/turf/unsimulated/floor/marble/border_bw{
	dir = 4
	},
/area/shuttle/escape/centcom/cogmap)
"Ag" = (
/obj/item/storage/wall/medical{
	dir = 4
	},
/turf/simulated/wall/auto/shuttle{
	icon_state = "3"
	},
/area/shuttle/escape/centcom/cogmap)
"Bt" = (
/obj/decoration/regallamp{
	anchored = 1;
	lit = 1
	},
/turf/unsimulated/floor/carpet/regalcarpet/border{
	dir = 1
	},
/area/shuttle/escape/centcom/cogmap)
"BY" = (
/obj/table/regal/auto,
/obj/item/reagent_containers/food/drinks/drinkingglass/wine{
	pixel_x = 7;
	pixel_y = 13;
	rand_pos = 0
	},
/obj/item/reagent_containers/food/drinks/drinkingglass/wine{
	pixel_y = 13;
	rand_pos = 0
	},
/obj/item/reagent_containers/food/drinks/drinkingglass/wine{
	pixel_x = -7;
	pixel_y = 13;
	rand_pos = 0
	},
/obj/item/reagent_containers/food/drinks/bottle/champagne{
	pixel_x = 9;
	pixel_y = 7;
	rand_pos = 0
	},
/obj/item/reagent_containers/food/drinks/bottle/wine{
	pixel_x = -7;
	pixel_y = 3;
	rand_pos = 0
	},
/obj/item/reagent_containers/food/drinks/bottle/mead{
	rand_pos = 0
	},
/obj/machinery/light/small/floor/warm,
/turf/unsimulated/floor/carpet/regalcarpet,
/area/shuttle/escape/centcom/cogmap)
"CY" = (
/obj/indestructible/invisible_block,
/turf/simulated/wall/auto/shuttle{
	icon_state = "12"
	},
/area/shuttle/escape/centcom/cogmap)
"Dy" = (
/obj/item/storage/wall/fire{
	dir = 4
	},
/turf/simulated/wall/auto/shuttle{
	icon_state = "3"
	},
/area/shuttle/escape/centcom/cogmap)
"Er" = (
/obj/table/regal/auto,
/obj/item/reagent_containers/food/drinks/drinkingglass/wine{
	pixel_x = -7;
	rand_pos = 0
	},
/obj/item/reagent_containers/food/drinks/drinkingglass/wine{
	rand_pos = 0
	},
/obj/item/reagent_containers/food/drinks/drinkingglass/wine{
	pixel_x = 7;
	rand_pos = 0
	},
/obj/item/reagent_containers/food/drinks/bottle/wine{
	pixel_x = 9;
	pixel_y = 19;
	rand_pos = 0
	},
/obj/item/reagent_containers/food/drinks/bottle/champagne{
	pixel_x = -7;
	pixel_y = 21;
	rand_pos = 0
	},
/obj/item/reagent_containers/food/drinks/bottle/mead{
	pixel_x = -2;
	pixel_y = 18;
	rand_pos = 0
	},
/obj/machinery/light/small/floor/warm,
/turf/unsimulated/floor/carpet/regalcarpet,
/area/shuttle/escape/centcom/cogmap)
"EZ" = (
/turf/simulated/wall/auto/shuttle{
	icon_state = "12"
	},
/area/shuttle/escape/centcom/cogmap)
"IX" = (
/turf/simulated/wall/auto/shuttle{
	icon_state = "11"
	},
/area/shuttle/escape/centcom/cogmap)
"Jd" = (
/obj/stool/chair/wooden/regal{
	anchored = 1
	},
/turf/unsimulated/floor/marble/border_bw{
	dir = 6
	},
/area/shuttle/escape/centcom/cogmap)
"Ke" = (
/turf/simulated/wall/auto/shuttle{
	icon_state = "3"
	},
/area/shuttle/escape/centcom/cogmap)
"KJ" = (
/obj/machinery/door/airlock/pyro/external{
	dir = 4
	},
/turf/unsimulated/floor/marble/black,
/area/shuttle/escape/centcom/cogmap)
"KN" = (
/obj/lattice{
	icon_state = "lattice-dir-b"
	},
/turf/unsimulated/outdoors/grass,
/area/centcom/outside)
"LU" = (
/obj/lattice{
	icon_state = "lattice-dir"
	},
/turf/unsimulated/outdoors/grass,
/area/centcom/outside)
"MN" = (
/turf/unsimulated/floor/marble/border_bw{
	dir = 1
	},
/area/shuttle/escape/centcom/cogmap)
"MZ" = (
/obj/decal/lightshaft,
/obj/shrub{
	dir = 8
	},
/obj/machinery/light/small/floor/warm,
/turf/unsimulated/floor/marble/border_wb{
	dir = 10
	},
/area/shuttle/escape/centcom/cogmap)
"Nw" = (
/obj/table/regal/auto,
/obj/item/reagent_containers/food/snacks/croissant{
	pixel_x = 9;
	pixel_y = 13;
	rand_pos = 0
	},
/obj/item/reagent_containers/food/snacks/croissant{
	pixel_x = 9;
	pixel_y = 5;
	rand_pos = 0
	},
/obj/item/reagent_containers/food/snacks/croissant{
	pixel_x = 9;
	pixel_y = -3;
	rand_pos = 0
	},
/obj/item/reagent_containers/food/snacks/croissant{
	pixel_x = 9;
	pixel_y = -10;
	rand_pos = 0
	},
/obj/item/reagent_containers/food/snacks/danish_apple{
	pixel_x = -7;
	pixel_y = 16;
	rand_pos = 0
	},
/obj/item/reagent_containers/food/snacks/danish_apple{
	pixel_x = -7;
	pixel_y = 10;
	rand_pos = 0
	},
/obj/item/reagent_containers/food/snacks/danish_apple{
	pixel_x = -7;
	pixel_y = 4;
	rand_pos = 0
	},
/obj/item/reagent_containers/food/snacks/danish_apple{
	pixel_x = -7;
	pixel_y = -2;
	rand_pos = 0
	},
/turf/unsimulated/floor/carpet/regalcarpet,
/area/shuttle/escape/centcom/cogmap)
"OJ" = (
/obj/shrub{
	dir = 6
	},
/obj/machinery/light/small/floor/warm,
/turf/unsimulated/floor/marble/border_wb{
	dir = 6
	},
/area/shuttle/escape/centcom/cogmap)
"OZ" = (
/turf/unsimulated/floor/carpet/regalcarpet/border{
	dir = 6
	},
/area/shuttle/escape/centcom/cogmap)
"QC" = (
/obj/table/regal/auto,
/obj/item/reagent_containers/food/snacks/salad{
	pixel_x = -9;
	pixel_y = 14;
	rand_pos = 0
	},
/obj/item/reagent_containers/food/snacks/salad{
	pixel_x = -9;
	pixel_y = 7;
	rand_pos = 0
	},
/obj/item/reagent_containers/food/snacks/fairybread{
	pixel_x = 8;
	pixel_y = 9;
	rand_pos = 0
	},
/obj/item/reagent_containers/food/snacks/fairybread{
	pixel_x = 8;
	pixel_y = 2;
	rand_pos = 0
	},
/obj/item/reagent_containers/food/snacks/fairybread{
	pixel_x = 8;
	pixel_y = -6;
	rand_pos = 0
	},
/obj/item/reagent_containers/food/snacks/danish_blueb{
	pixel_x = -7;
	pixel_y = -1;
	rand_pos = 0
	},
/obj/item/reagent_containers/food/snacks/danish_blueb{
	pixel_x = -7;
	pixel_y = -7;
	rand_pos = 0
	},
/obj/item/reagent_containers/food/snacks/danish_blueb{
	pixel_x = -7;
	pixel_y = -13;
	rand_pos = 0
	},
/obj/item/reagent_containers/food/snacks/danish_weed{
	pixel_x = 7;
	pixel_y = -15;
	rand_pos = 0
	},
/obj/item/reagent_containers/food/snacks/danish_weed{
	pixel_x = 7;
	pixel_y = -8;
	rand_pos = 0
	},
/turf/unsimulated/floor/carpet/regalcarpet,
/area/shuttle/escape/centcom/cogmap)
"Te" = (
/turf/unsimulated/floor/marble/border_wb{
	dir = 9
	},
/area/shuttle/escape/centcom/cogmap)
"TB" = (
/obj/item/storage/wall/emergency{
	dir = 8
	},
/turf/simulated/wall/auto/shuttle{
	icon_state = "3"
	},
/area/shuttle/escape/centcom/cogmap)
"UD" = (
/obj/shrub{
	dir = 10
	},
/turf/unsimulated/floor/marble/border_bw{
	dir = 8
	},
/area/shuttle/escape/centcom/cogmap)
"UI" = (
/obj/stool/chair/comfy/throne_gold{
	anchored = 1
	},
/turf/unsimulated/floor/carpet/regalcarpet/border{
	dir = 1
	},
/area/shuttle/escape/centcom/cogmap)
"UT" = (
/obj/shrub{
	dir = 10
	},
/turf/unsimulated/floor/marble/border_bw{
	dir = 4
	},
/area/shuttle/escape/centcom/cogmap)
"Vh" = (
/obj/table/regal/auto,
/obj/random_item_spawner/med_kit/two{
	pixel_x = -8;
	pixel_y = 16
	},
/obj/item/storage/toolbox/emergency{
	pixel_x = 5;
	pixel_y = 8
	},
/obj/item/reagent_containers/food/snacks/cake/chocolate/gateau{
	pixel_y = 6;
	rand_pos = 0
	},
/turf/unsimulated/floor/marble/border_bw,
/area/shuttle/escape/centcom/cogmap)
"VM" = (
/obj/shrub{
	dir = 1
	},
/obj/machinery/light/small/floor/warm,
/turf/unsimulated/floor/marble/border_bw{
	dir = 5
	},
/area/shuttle/escape/centcom/cogmap)
"VO" = (
/obj/indestructible/shuttle_corner{
	dir = 1
	},
/turf/unsimulated/floor/carpet/regalcarpet/border{
	dir = 10
	},
/area/shuttle/escape/centcom/cogmap)
"VS" = (
/obj/shrub{
	dir = 1
	},
/obj/machinery/light/small/floor/warm,
/turf/unsimulated/floor/marble/border_bw{
	dir = 9
	},
/area/shuttle/escape/centcom/cogmap)
"WX" = (
/obj/shrub,
/obj/item/clothing/head/crown,
/turf/unsimulated/floor/marble/border_bw{
	dir = 4
	},
/area/shuttle/escape/centcom/cogmap)
"XE" = (
/obj/decoration/regallamp{
	anchored = 1;
	lit = 1
	},
/turf/unsimulated/floor/marble/border_bw{
	dir = 8
	},
/area/shuttle/escape/centcom/cogmap)
"XV" = (
/turf/unsimulated/floor/marble/border_wb{
	dir = 5
	},
/area/shuttle/escape/centcom/cogmap)
"Yh" = (
/obj/machinery/shuttle/engine/propulsion{
	dir = 10;
	icon_state = "alt_propulsion"
	},
/turf/unsimulated/outdoors/grass,
/area/shuttle/escape/centcom/cogmap)
"Yp" = (
/obj/indestructible/shuttle_corner{
	dir = 1
	},
/turf/unsimulated/floor/marble/border_wb{
	dir = 5
	},
/area/shuttle/escape/centcom/cogmap)
"Yq" = (
/turf/unsimulated/floor/marble/black,
/area/shuttle/escape/centcom/cogmap)
"Yu" = (
/obj/indestructible/shuttle_corner{
	dir = 1
	},
/turf/unsimulated/outdoors/grass,
/area/shuttle/escape/centcom/cogmap)
"YO" = (
/obj/shrub{
	dir = 8
	},
/obj/machinery/light/small/floor/warm,
/turf/unsimulated/floor/marble/border_bw{
	dir = 8
	},
/area/shuttle/escape/centcom/cogmap)
"Zz" = (
/obj/wingrille_spawn/auto/crystal,
/turf/unsimulated/floor/marble/black,
/area/shuttle/escape/centcom/cogmap)

(1,1,1) = {"
gq
xs
Ke
Ke
Ag
IX
KJ
IX
eB
eB
eB
Dy
pC
KN
LU
LU
LU
"}
(2,1,1) = {"
qj
vr
Zz
OJ
XE
cx
Yq
YO
XE
UD
XE
vR
Yp
eB
pC
nf
nf
"}
(3,1,1) = {"
Yh
hY
Zz
Jd
XV
XV
XV
XV
lr
lr
lr
lr
VM
xZ
VO
pC
KN
"}
(4,1,1) = {"
zB
vL
kv
vJ
bX
fr
fr
fr
fr
fr
fr
dq
MN
UI
hB
CY
kA
"}
(5,1,1) = {"
nf
EZ
Zz
Vh
Bt
Er
Nw
cX
xl
QC
BY
hB
MN
lc
ch
CY
nz
"}
(6,1,1) = {"
qj
vr
kv
vJ
wG
fi
fi
fi
fi
fi
fi
OZ
MN
UI
hB
CY
kA
"}
(7,1,1) = {"
Yh
hY
Zz
fv
Te
Te
Te
Te
jP
jP
jP
jP
VS
vs
cg
es
KN
"}
(8,1,1) = {"
zB
vL
Zz
MZ
xc
UT
Yq
ri
xc
WX
xc
zV
qb
eB
es
nf
nf
"}
(9,1,1) = {"
gq
Yu
Ke
Ke
TB
hJ
KJ
hJ
eB
eB
eB
an
es
KN
LU
LU
LU
"}
