//MAP CONVERTED BY dmm2tgm.py THIS HEADER COMMENT PREVENTS RECONVERSION, DO NOT REMOVE
"cg" = (
/obj/indestructible/shuttle_corner{
	dir = 0
	},
/turf/unsimulated/floor/shuttle{
	icon_state = "floor2"
	},
/area/shuttle/escape/centcom/cogmap)
"ch" = (
/obj/machinery/computer/shuttle/embedded/south,
/obj/stool/chair/comfy/shuttle/pilot,
/turf/unsimulated/floor/shuttle{
	icon_state = "floor2"
	},
/area/shuttle/escape/centcom/cogmap)
"cx" = (
/turf/simulated/wall/auto/shuttle{
	icon_state = "12"
	},
/area/shuttle/escape/centcom/cogmap)
"es" = (
/obj/indestructible/shuttle_corner{
	dir = 8
	},
/turf/unsimulated/outdoors/grass,
/area/shuttle/escape/centcom/cogmap)
"eB" = (
/obj/wingrille_spawn/auto,
/turf/unsimulated/floor/shuttle,
/area/shuttle/escape/centcom/cogmap)
"fv" = (
/turf/unsimulated/floor/shuttle{
	icon_state = "floor3"
	},
/area/shuttle/escape/centcom/cogmap)
"gq" = (
/turf/unsimulated/outdoors/grass,
/area/shuttle/escape/centcom/cogmap)
"hJ" = (
/turf/simulated/wall/auto/shuttle{
	icon_state = "7"
	},
/area/shuttle/escape/centcom/cogmap)
"hY" = (
/obj/machinery/shuttle/engine/heater{
	dir = 1;
	icon_state = "alt_heater-M"
	},
/obj/window/reinforced/south,
/turf/unsimulated/floor/plating,
/area/shuttle/escape/centcom/cogmap)
"iY" = (
/obj/machinery/door/airlock/pyro/medical{
	name = "First-Aid Station"
	},
/turf/unsimulated/floor/shuttle{
	icon_state = "floor3"
	},
/area/shuttle/escape/centcom/cogmap)
"kv" = (
/obj/wingrille_spawn/auto,
/turf/unsimulated/floor/shuttle{
	icon_state = "floor3"
	},
/area/shuttle/escape/centcom/cogmap)
"kA" = (
/obj/indestructible/invisible_block,
/turf/unsimulated/outdoors/grass,
/area/shuttle/escape/centcom/cogmap)
"lc" = (
/obj/machinery/light/small/floor,
/turf/unsimulated/floor/shuttle{
	icon_state = "floor2"
	},
/area/shuttle/escape/centcom/cogmap)
"mM" = (
/obj/table/auto,
/obj/random_item_spawner/med_kit,
/turf/unsimulated/floor/shuttle{
	icon_state = "floor3"
	},
/area/shuttle/escape/centcom/cogmap)
"nf" = (
/turf/unsimulated/outdoors/grass,
/area/centcom/outside)
"nz" = (
/turf/simulated/shuttle/wall/cockpit{
	dir = 1
	},
/area/shuttle/escape/centcom/cogmap)
"pC" = (
/obj/indestructible/shuttle_corner{
	dir = 4
	},
/turf/unsimulated/outdoors/grass,
/area/shuttle/escape/centcom/cogmap)
"qj" = (
/obj/machinery/shuttle/engine/propulsion{
	dir = 9;
	icon_state = "alt_propulsion"
	},
/turf/unsimulated/outdoors/grass,
/area/shuttle/escape/centcom/cogmap)
"ri" = (
/obj/stool/chair/comfy/shuttle,
/obj/machinery/light{
	dir = 4;
	layer = 9.1;
	pixel_x = 10
	},
/turf/unsimulated/floor/shuttle,
/area/shuttle/escape/centcom/cogmap)
"vr" = (
/obj/machinery/shuttle/engine/heater{
	dir = 1;
	icon_state = "alt_heater-R"
	},
/obj/window/reinforced/south,
/turf/unsimulated/floor/plating,
/area/shuttle/escape/centcom/cogmap)
"vJ" = (
/obj/item/storage/wall/emergency{
	dir = 8
	},
/turf/simulated/wall/auto/shuttle{
	icon_state = "3"
	},
/area/shuttle/escape/centcom/cogmap)
"vL" = (
/obj/machinery/shuttle/engine/heater{
	dir = 1;
	icon_state = "alt_heater-L"
	},
/obj/window/reinforced/south,
/turf/unsimulated/floor/plating,
/area/shuttle/escape/centcom/cogmap)
"wG" = (
/obj/stool/chair/comfy/shuttle/green,
/turf/unsimulated/floor/shuttle{
	icon_state = "floor3"
	},
/area/shuttle/escape/centcom/cogmap)
"xe" = (
/obj/table/reinforced/auto,
/obj/item/storage/firstaid/regular,
/turf/unsimulated/floor/shuttle{
	icon_state = "floor2"
	},
/area/shuttle/escape/centcom/cogmap)
"xs" = (
/obj/indestructible/shuttle_corner{
	dir = 0
	},
/turf/unsimulated/outdoors/grass,
/area/shuttle/escape/centcom/cogmap)
"xZ" = (
/obj/table/reinforced/auto,
/obj/item/storage/toolbox/emergency,
/obj/item/device/radio,
/turf/unsimulated/floor/shuttle{
	icon_state = "floor2"
	},
/area/shuttle/escape/centcom/cogmap)
"zB" = (
/obj/machinery/shuttle/engine/propulsion{
	dir = 5;
	icon_state = "alt_propulsion"
	},
/turf/unsimulated/outdoors/grass,
/area/shuttle/escape/centcom/cogmap)
"zJ" = (
/obj/stool/chair/comfy/shuttle/brown,
/turf/unsimulated/floor/shuttle{
	icon_state = "floor2"
	},
/area/shuttle/escape/centcom/cogmap)
"Er" = (
/obj/item/storage/wall/emergency,
/turf/simulated/wall/auto/shuttle{
	icon_state = "13"
	},
/area/shuttle/escape/centcom/cogmap)
"EZ" = (
/turf/simulated/wall/auto/shuttle{
	icon_state = "2"
	},
/area/shuttle/escape/centcom/cogmap)
"FZ" = (
/obj/machinery/light/small/floor,
/turf/unsimulated/floor/shuttle{
	icon_state = "floor4"
	},
/area/shuttle/escape/centcom/cogmap)
"IX" = (
/turf/simulated/wall/auto/shuttle{
	icon_state = "11"
	},
/area/shuttle/escape/centcom/cogmap)
"Jd" = (
/turf/simulated/wall/auto/shuttle{
	icon_state = "15"
	},
/area/shuttle/escape/centcom/cogmap)
"Ke" = (
/turf/simulated/wall/auto/shuttle{
	icon_state = "3"
	},
/area/shuttle/escape/centcom/cogmap)
"KJ" = (
/obj/machinery/door/airlock/pyro/external{
	dir = 4
	},
/turf/unsimulated/floor/shuttle,
/area/shuttle/escape/centcom/cogmap)
"KN" = (
/obj/lattice{
	icon_state = "lattice-dir-b"
	},
/turf/unsimulated/outdoors/grass,
/area/centcom/outside)
"LU" = (
/obj/lattice{
	icon_state = "lattice-dir"
	},
/turf/unsimulated/outdoors/grass,
/area/centcom/outside)
"MN" = (
/obj/machinery/door/airlock/pyro/command,
/turf/unsimulated/floor/shuttle{
	icon_state = "floor2"
	},
/area/shuttle/escape/centcom/cogmap)
"MZ" = (
/obj/machinery/sleeper/compact,
/turf/unsimulated/floor/shuttle{
	icon_state = "floor3"
	},
/area/shuttle/escape/centcom/cogmap)
"OJ" = (
/obj/stool/chair/comfy/shuttle/red,
/turf/unsimulated/floor/shuttle{
	icon_state = "floor4"
	},
/area/shuttle/escape/centcom/cogmap)
"QC" = (
/obj/machinery/light/small/floor,
/turf/unsimulated/floor/shuttle,
/area/shuttle/escape/centcom/cogmap)
"Te" = (
/obj/machinery/light/small/floor,
/turf/unsimulated/floor/shuttle{
	icon_state = "floor3"
	},
/area/shuttle/escape/centcom/cogmap)
"VM" = (
/obj/wingrille_spawn/auto,
/turf/unsimulated/floor/shuttle{
	icon_state = "floor2"
	},
/area/shuttle/escape/centcom/cogmap)
"VO" = (
/obj/indestructible/shuttle_corner{
	dir = 1
	},
/turf/unsimulated/floor/shuttle{
	icon_state = "floor2"
	},
/area/shuttle/escape/centcom/cogmap)
"WZ" = (
/obj/stool/chair/comfy/shuttle,
/turf/unsimulated/floor/shuttle,
/area/shuttle/escape/centcom/cogmap)
"XV" = (
/obj/machinery/door/airlock/pyro/security{
	name = "Secure Transport"
	},
/turf/unsimulated/floor/shuttle{
	icon_state = "floor4"
	},
/area/shuttle/escape/centcom/cogmap)
"Yh" = (
/obj/machinery/shuttle/engine/propulsion{
	dir = 10;
	icon_state = "alt_propulsion"
	},
/turf/unsimulated/outdoors/grass,
/area/shuttle/escape/centcom/cogmap)
"Yp" = (
/turf/simulated/wall/auto/shuttle{
	icon_state = "14"
	},
/area/shuttle/escape/centcom/cogmap)
"Yq" = (
/turf/unsimulated/floor/shuttle,
/area/shuttle/escape/centcom/cogmap)
"Yu" = (
/obj/indestructible/shuttle_corner{
	dir = 1
	},
/turf/unsimulated/outdoors/grass,
/area/shuttle/escape/centcom/cogmap)
"YO" = (
/obj/stool/chair/comfy/shuttle,
/obj/machinery/light{
	dir = 8;
	layer = 9.1;
	pixel_x = -10
	},
/turf/unsimulated/floor/shuttle,
/area/shuttle/escape/centcom/cogmap)
"Zz" = (
/obj/wingrille_spawn/auto,
/turf/unsimulated/floor/shuttle{
	icon_state = "floor4"
	},
/area/shuttle/escape/centcom/cogmap)

(1,1,1) = {"
gq
xs
Ke
Ke
Ke
Jd
KJ
IX
eB
eB
eB
Ke
pC
KN
LU
LU
LU
"}
(2,1,1) = {"
qj
vr
Zz
OJ
OJ
cx
Yq
YO
WZ
WZ
WZ
YO
Yp
VM
pC
nf
nf
"}
(3,1,1) = {"
Yh
hY
Zz
OJ
FZ
XV
Yq
WZ
WZ
WZ
WZ
WZ
VM
xZ
VO
pC
KN
"}
(4,1,1) = {"
zB
vL
Zz
OJ
OJ
cx
Yq
WZ
WZ
WZ
WZ
WZ
cx
zJ
zJ
cx
kA
"}
(5,1,1) = {"
nf
EZ
Ke
vJ
Ke
Er
Yq
Yq
Yq
QC
Yq
Yq
MN
lc
ch
cx
nz
"}
(6,1,1) = {"
qj
vr
kv
mM
wG
cx
Yq
WZ
WZ
WZ
WZ
WZ
cx
zJ
zJ
cx
kA
"}
(7,1,1) = {"
Yh
hY
kv
fv
Te
iY
Yq
WZ
WZ
WZ
WZ
WZ
VM
xe
cg
es
KN
"}
(8,1,1) = {"
zB
vL
kv
MZ
MZ
cx
Yq
ri
WZ
WZ
WZ
ri
Yp
VM
es
nf
nf
"}
(9,1,1) = {"
gq
Yu
Ke
Ke
Ke
Jd
KJ
hJ
eB
eB
eB
Ke
es
KN
LU
LU
LU
"}
