//MAP CONVERTED BY dmm2tgm.py THIS HEADER COMMENT PREVENTS RECONVERSION, DO NOT REMOVE
"a" = (
/turf/simulated/floor/specialroom/arcade,
/area/dmm_suite/clear_area)
"d" = (
/obj/storage/closet,
/obj/fakeobject/skeleton,
/turf/simulated/floor/specialroom/arcade,
/area/dmm_suite/clear_area)
"k" = (
/obj/stool/chair{
	dir = 4
	},
/turf/simulated/floor/specialroom/arcade,
/area/dmm_suite/clear_area)
"y" = (
/obj/submachine/chef_sink{
	desc = "A common utility sink.";
	dir = 8;
	name = "utility sink"
	},
/turf/simulated/floor/specialroom/arcade,
/area/dmm_suite/clear_area)
"D" = (
/obj/machinery/light/small/floor/netural,
/turf/simulated/floor/specialroom/arcade,
/area/dmm_suite/clear_area)
"E" = (
/obj/rack,
/obj/item/reagent_containers/glass/bottle/cleaner,
/obj/item/reagent_containers/glass/bottle/acetone/janitors,
/obj/item/reagent_containers/glass/bottle/ammonia/janitors,
/turf/simulated/floor/specialroom/arcade,
/area/dmm_suite/clear_area)
"G" = (
/obj/item/storage/toolbox/emergency,
/obj/item/storage/box/mousetraps,
/obj/item/sponge,
/obj/item/spraybottle/cleaner,
/obj/item/mop,
/obj/item/reagent_containers/glass/bucket,
/obj/item/chem_grenade/cleaner,
/obj/item/reagent_containers/glass/bottle/cleaner,
/obj/storage/crate,
/obj/item/chem_grenade/cleaner,
/turf/simulated/floor/specialroom/arcade,
/area/dmm_suite/clear_area)

(1,1,1) = {"
d
k
G
"}
(2,1,1) = {"
a
D
a
"}
(3,1,1) = {"
E
a
y
"}
