//MAP CONVERTED BY dmm2tgm.py THIS HEADER COMMENT PREVENTS RECONVERSION, DO NOT REMOVE
"a" = (
/turf/simulated/floor/plating,
/area/dmm_suite/clear_area)
"e" = (
/obj/machinery/bot/duckbot,
/turf/simulated/floor/plating,
/area/dmm_suite/clear_area)

(1,1,1) = {"
a
a
a
"}
(2,1,1) = {"
a
e
a
"}
(3,1,1) = {"
a
a
a
"}
