//MAP CONVERTED BY dmm2tgm.py THIS HEADER COMMENT PREVENTS RECONVERSION, DO NOT REMOVE
"a" = (
/obj/machinery/light/small,
/obj/decal/cleanable/dirt,
/turf/simulated/floor/carpet/grime,
/area/dmm_suite/clear_area)
"f" = (
/obj/stool/bed,
/obj/item/storage/secure/ssafe{
	pixel_x = -28
	},
/obj/decal/cleanable/dirt,
/obj/decal/cleanable/vomit,
/obj/decal/cleanable/blood{
	icon_state = "drip3"
	},
/obj/item/clothing/suit/bedsheet/random,
/turf/simulated/floor/carpet/grime,
/area/dmm_suite/clear_area)
"j" = (
/obj/stool/chair{
	dir = 4;
	tag = "icon-chair (EAST)"
	},
/obj/decal/cleanable/dirt,
/turf/simulated/floor/carpet/grime,
/area/dmm_suite/clear_area)
"D" = (
/obj/decal/cleanable/dirt,
/turf/simulated/floor/carpet/grime,
/area/dmm_suite/clear_area)
"J" = (
/obj/table/wood/auto,
/obj/machinery/light/lamp/black{
	pixel_x = 1;
	pixel_y = 10
	},
/turf/simulated/floor/carpet/grime,
/area/dmm_suite/clear_area)
"P" = (
/obj/decal/cleanable/dirt,
/obj/decal/cleanable/vomit,
/turf/simulated/floor/carpet/grime,
/area/dmm_suite/clear_area)
"S" = (
/obj/storage/closet/dresser/random,
/obj/item/reagent_containers/food/drinks/bottle/beer,
/obj/item/reagent_containers/food/drinks/bottle/beer,
/obj/item/reagent_containers/food/drinks/bottle/beer,
/obj/item/reagent_containers/food/drinks/bottle/beer,
/obj/item/reagent_containers/food/drinks/bottle/beer,
/turf/simulated/floor/carpet/grime,
/area/dmm_suite/clear_area)
"X" = (
/obj/decal/cleanable/dirt,
/obj/decal/cleanable/blood{
	icon_state = "bloodhit3"
	},
/obj/decal/cleanable/blood{
	icon_state = "drip1a"
	},
/turf/simulated/floor/carpet/grime,
/area/dmm_suite/clear_area)

(1,1,1) = {"
f
D
a
"}
(2,1,1) = {"
j
X
P
"}
(3,1,1) = {"
J
D
S
"}
