//MAP CONVERTED BY dmm2tgm.py THIS HEADER COMMENT PREVENTS RECONVERSION, DO NOT REMOVE
"a" = (
/turf/simulated/floor/plating/random,
/area/dmm_suite/clear_area)
"f" = (
/obj/reagent_dispensers/foamtank,
/turf/simulated/floor/plating/random,
/area/dmm_suite/clear_area)
"i" = (
/obj/machinery/portable_atmospherics/canister/air/large,
/turf/simulated/floor/plating/random,
/area/dmm_suite/clear_area)
"z" = (
/obj/rack,
/obj/item/reagent_containers/patch/mini/burn{
	pixel_y = 5
	},
/obj/item/reagent_containers/patch/mini/burn,
/obj/item/extinguisher{
	pixel_x = -4
	},
/obj/item/extinguisher{
	pixel_x = 4
	},
/obj/item/chem_grenade/firefighting{
	pixel_x = 11;
	pixel_y = -5
	},
/obj/item/chem_grenade/firefighting{
	pixel_x = -10;
	pixel_y = -5
	},
/turf/simulated/floor/plating/random,
/area/dmm_suite/clear_area)
"J" = (
/obj/rack,
/obj/item/clothing/suit/hazard/fire,
/obj/item/clothing/suit/hazard/fire,
/obj/item/tank/air,
/obj/item/tank/air,
/obj/item/clothing/head/helmet/firefighter,
/obj/item/clothing/mask/gas,
/obj/item/clothing/mask/gas,
/turf/simulated/floor/plating/random,
/area/dmm_suite/clear_area)

(1,1,1) = {"
J
i
f
"}
(2,1,1) = {"
a
a
a
"}
(3,1,1) = {"
J
a
z
"}
