//MAP CONVERTED BY dmm2tgm.py THIS HEADER COMMENT PREVENTS RECONVERSION, DO NOT REMOVE
"a" = (
/obj/item/a_gift/festive{
	pixel_x = 6;
	pixel_y = -10
	},
/turf/simulated/floor/plating/scorched,
/area/dmm_suite/clear_area)
"g" = (
/obj/item/match{
	pixel_x = -11;
	pixel_y = 18
	},
/obj/decal/fakeobjects/skeleton,
/obj/decal/fakeobjects/lightbulb_broken,
/turf/simulated/floor/plating,
/area/dmm_suite/clear_area)
"l" = (
/obj/critter/domestic_bee/santa{
	alive = 0;
	desc = "Goodness, how depressing.";
	name = "dead greater domestic space-bee"
	},
/turf/simulated/floor/plating/scorched,
/area/dmm_suite/clear_area)
"n" = (
/obj/decal/cleanable/leaves,
/obj/shrub/dead{
	pixel_y = 13
	},
/turf/simulated/floor/plating/damaged1,
/area/dmm_suite/clear_area)
"p" = (
/obj/item/a_gift/festive{
	pixel_x = 9;
	pixel_y = 6
	},
/obj/item/clothing/suit/space/santa{
	pixel_x = -16
	},
/turf/simulated/floor/plating/damaged1,
/area/dmm_suite/clear_area)
"A" = (
/obj/decal/fakeobjects/lightbulb_broken,
/obj/decal/cleanable/dirt/dirt5,
/turf/simulated/floor/plating,
/area/dmm_suite/clear_area)
"H" = (
/obj/item/a_gift/festive{
	pixel_x = 9
	},
/turf/simulated/floor/plating/damaged3,
/area/dmm_suite/clear_area)
"K" = (
/obj/item/matchbook{
	pixel_x = -10;
	pixel_y = -15
	},
/obj/decal/xmas_lights{
	pixel_y = 32
	},
/obj/decal/cleanable/dirt,
/turf/simulated/floor/plating,
/area/dmm_suite/clear_area)
"Y" = (
/obj/stocking{
	pixel_y = 32
	},
/turf/simulated/floor/plating,
/area/dmm_suite/clear_area)

(1,1,1) = {"
Y
H
A
"}
(2,1,1) = {"
a
n
p
"}
(3,1,1) = {"
K
l
g
"}
