//MAP CONVERTED BY dmm2tgm.py THIS HEADER COMMENT PREVENTS RECONVERSION, DO NOT REMOVE
"aa" = (
/obj/stool/bench/blue/auto,
/turf/unsimulated/floor/arrival{
	dir = 4
	},
/area/centcom)
"ab" = (
/obj/decal/tile_edge/line/orange{
	dir = 1;
	icon_state = "line1"
	},
/turf/unsimulated/floor/black,
/area/centcom/outside)
"ac" = (
/obj/decal/tile_edge/line/orange{
	dir = 8;
	icon_state = "line1"
	},
/obj/decal/poster/wallsign/hazard_rad{
	pixel_y = 32
	},
/turf/unsimulated/floor/black,
/area/centcom/outside)
"af" = (
/obj/decal/tile_edge/stripe/extra_big{
	dir = 4
	},
/obj/decal/tile_edge/stripe/corner/extra_big{
	dir = 4
	},
/obj/machinery/light/small/floor,
/turf/unsimulated/floor/black,
/area/centcom/outside)
"al" = (
/obj/decal/tile_edge/line/orange{
	dir = 9;
	icon_state = "line1"
	},
/turf/unsimulated/floor/black,
/area/centcom/outside)
"aB" = (
/obj/machinery/light/small/floor,
/turf/unsimulated/floor/shuttle,
/area/shuttle/escape/centcom)
"aQ" = (
/obj/mapping_helper/wingrille_spawn/auto/reinforced,
/turf/unsimulated/floor/shuttle{
	icon_state = "floor2"
	},
/area/shuttle/escape/centcom)
"aZ" = (
/obj/fakeobject/pipe{
	desc = "It's a pipe manifold.";
	dir = 6;
	icon = 'icons/obj/atmospherics/pipes/manifold_pipe.dmi';
	icon_state = "manifold-map";
	name = "pipe"
	},
/turf/unsimulated/floor{
	icon_state = "floor"
	},
/area/centcom/outside)
"bs" = (
/obj/decal/tile_edge/stripe/extra_big{
	dir = 9;
	icon_state = "xtra_bigstripe-corner2"
	},
/turf/unsimulated/floor/shuttlebay,
/area/centcom/outside)
"bD" = (
/obj/stool/chair/comfy/shuttle/brown{
	dir = 4
	},
/turf/unsimulated/floor/shuttle,
/area/shuttle/escape/centcom)
"cd" = (
/obj/machinery/door/airlock/pyro/glass/med{
	dir = 4;
	hardened = 1
	},
/turf/unsimulated/floor/shuttle{
	icon_state = "floor3"
	},
/area/shuttle/escape/centcom)
"cl" = (
/obj/decal/tile_edge/stripe/extra_big{
	dir = 6
	},
/turf/unsimulated/floor/shuttlebay,
/area/centcom/outside)
"cm" = (
/obj/decal/tile_edge/line/black{
	dir = 5;
	icon_state = "line2"
	},
/turf/unsimulated/floor{
	icon_state = "floor"
	},
/area/centcom/outside)
"cr" = (
/obj/decal/tile_edge/stripe/extra_big{
	dir = 6
	},
/obj/machinery/light/small/floor,
/turf/unsimulated/floor/shuttlebay,
/area/centcom/outside)
"cV" = (
/obj/stool/chair/comfy/shuttle/red,
/obj/machinery/light{
	dir = 1;
	pixel_y = 21
	},
/turf/unsimulated/floor/shuttle{
	icon_state = "floor4"
	},
/area/shuttle/escape/centcom)
"dB" = (
/obj/fakeobject/shuttleengine{
	dir = 8;
	icon_state = "alt_heater"
	},
/turf/simulated/wall/auto/shuttle{
	icon_state = "12"
	},
/area/shuttle/escape/centcom)
"dC" = (
/obj/shrub{
	dir = 1
	},
/obj/machinery/light{
	dir = 8
	},
/turf/unsimulated/floor/arrival{
	dir = 9
	},
/area/centcom)
"dH" = (
/obj/decal/tile_edge/line/orange{
	dir = 8;
	icon_state = "line1"
	},
/obj/decal/poster/wallsign/hazard_rad{
	pixel_y = -32
	},
/turf/unsimulated/floor/black,
/area/centcom/outside)
"dK" = (
/obj/decal/tile_edge/stripe/extra_big{
	dir = 6;
	icon_state = "xtra_bigstripe-corner2"
	},
/turf/unsimulated/floor/shuttlebay,
/area/centcom/outside)
"dW" = (
/turf/simulated/wall/auto/shuttle{
	icon_state = "14"
	},
/area/shuttle/escape/centcom)
"eu" = (
/obj/indestructible/shuttle_corner{
	dir = 1
	},
/turf/unsimulated/floor/shuttlebay,
/area/shuttle/escape/centcom)
"eA" = (
/obj/decal/tile_edge/line/orange{
	dir = 10;
	icon_state = "line2"
	},
/turf/unsimulated/floor/black,
/area/centcom/outside)
"eQ" = (
/obj/decal/tile_edge/stripe/extra_big{
	dir = 1
	},
/turf/unsimulated/floor/shuttlebay,
/area/centcom/outside)
"fa" = (
/turf/simulated/wall/auto/shuttle{
	icon_state = "12"
	},
/area/shuttle/escape/centcom)
"fH" = (
/obj/stool/chair/comfy/shuttle,
/turf/unsimulated/floor/shuttle{
	icon_state = "floor3"
	},
/area/shuttle/escape/centcom)
"gA" = (
/obj/indestructible/shuttle_corner{
	dir = 1
	},
/turf/unsimulated/floor/shuttle{
	icon_state = "floor3"
	},
/area/shuttle/escape/centcom)
"gG" = (
/obj/fakeobject/shuttleengine{
	dir = 8;
	icon_state = "alt_heater-R"
	},
/turf/simulated/wall/auto/shuttle{
	icon_state = "7"
	},
/area/shuttle/escape/centcom)
"gL" = (
/obj/decal/poster/wallsign/danger_highvolt{
	pixel_x = -32
	},
/turf/unsimulated/floor/shuttlebay,
/area/centcom/outside)
"gP" = (
/obj/decal/tile_edge/line/orange{
	dir = 10;
	icon_state = "line1"
	},
/turf/unsimulated/floor/black,
/area/centcom/outside)
"hx" = (
/obj/stool/chair/comfy/shuttle/green{
	dir = 1
	},
/turf/unsimulated/floor/shuttle{
	icon_state = "floor6"
	},
/area/shuttle/escape/centcom)
"ip" = (
/obj/fakeobject/pipe{
	desc = "It's a pipe manifold.";
	dir = 8;
	icon = 'icons/obj/atmospherics/pipes/manifold_pipe.dmi';
	icon_state = "manifold-map";
	name = "pipe"
	},
/turf/unsimulated/floor/shuttlebay,
/area/centcom/outside)
"iC" = (
/obj/fakeobject{
	anchored = 1;
	desc = "Like conventional cables, but more burly.";
	dir = 5;
	icon = 'icons/obj/power_cond.dmi';
	icon_state = "conduit";
	name = "power conduit"
	},
/turf/unsimulated/floor/shuttlebay,
/area/centcom/outside)
"iD" = (
/obj/stool/chair/blue{
	dir = 4
	},
/turf/unsimulated/floor{
	icon_state = "floor"
	},
/area/centcom)
"jx" = (
/obj/stool/chair/comfy/shuttle/brown{
	dir = 4
	},
/obj/machinery/light{
	dir = 4;
	layer = 9.1;
	pixel_x = 10
	},
/turf/unsimulated/floor/shuttle,
/area/shuttle/escape/centcom)
"jS" = (
/obj/stool/bench/blue/auto,
/obj/machinery/light{
	dir = 8
	},
/turf/unsimulated/floor/arrival{
	dir = 8
	},
/area/centcom)
"jY" = (
/obj/fakeobject/pipe{
	desc = "A pipe.";
	name = "pipe";
	color = "b4b4b4"
	},
/turf/unsimulated/floor/shuttlebay,
/area/centcom/outside)
"kt" = (
/obj/fakeobject/pipe{
	dir = 4;
	name = "pipe";
	color = "b4b4b4"
	},
/turf/unsimulated/floor/shuttlebay,
/area/centcom/outside)
"ky" = (
/obj/fakeobject{
	anchored = 1;
	desc = "Like conventional cables, but more burly.";
	dir = 1;
	icon = 'icons/obj/power_cond.dmi';
	icon_state = "conduit";
	layer = 2.5;
	name = "power conduit";
	tag = "icon-conduit (NORTH)"
	},
/turf/unsimulated/floor{
	icon_state = "floor"
	},
/area/centcom/outside)
"kz" = (
/obj/decal/tile_edge/line/black{
	dir = 4;
	icon_state = "line1"
	},
/obj/machinery/atmospherics/unary/portables_connector{
	dir = 8
	},
/obj/fakeobject{
	density = 1;
	icon = 'icons/obj/atmospherics/atmos.dmi';
	icon_state = "orange";
	name = "Canister \[Plasma\]"
	},
/turf/unsimulated/floor{
	icon_state = "floor"
	},
/area/centcom/outside)
"kB" = (
/obj/table/auto,
/obj/item/kitchen/food_box/donut_box{
	pixel_y = 6
	},
/turf/unsimulated/floor/shuttle{
	icon_state = "floor6"
	},
/area/shuttle/escape/centcom)
"lK" = (
/obj/machinery/computer/shuttle{
	dir = 8
	},
/turf/unsimulated/floor/shuttle{
	icon_state = "floor2"
	},
/area/shuttle/escape/centcom)
"mY" = (
/obj/machinery/atmospherics/unary/portables_connector{
	dir = 8
	},
/obj/fakeobject{
	density = 1;
	icon = 'icons/obj/atmospherics/atmos.dmi';
	icon_state = "orange";
	name = "Canister \[Plasma\]"
	},
/turf/unsimulated/floor{
	icon_state = "floor"
	},
/area/centcom/outside)
"oC" = (
/turf/unsimulated/floor/shuttle{
	icon_state = "floor3"
	},
/area/shuttle/escape/centcom)
"oO" = (
/obj/indestructible/shuttle_corner{
	dir = 4
	},
/turf/unsimulated/floor/shuttle,
/area/shuttle/escape/centcom)
"pj" = (
/obj/fakeobject/shuttleengine{
	dir = 8;
	icon_state = "alt_heater-L"
	},
/turf/simulated/wall/auto/shuttle{
	icon_state = "7"
	},
/area/shuttle/escape/centcom)
"pm" = (
/obj/decal/poster/wallsign/hazard_caution,
/turf/unsimulated/wall/auto/lead/blue,
/area/centcom)
"pp" = (
/obj/machinery/light{
	dir = 8
	},
/turf/unsimulated/floor/shuttle{
	icon_state = "floor4"
	},
/area/shuttle/escape/centcom)
"px" = (
/obj/stool/chair/comfy/shuttle/pilot{
	dir = 4
	},
/turf/unsimulated/floor/shuttle{
	icon_state = "floor2"
	},
/area/shuttle/escape/centcom)
"qb" = (
/obj/fakeobject/shuttleengine{
	dir = 8;
	icon_state = "alt_heater-R"
	},
/turf/simulated/wall/auto/shuttle{
	icon_state = "3"
	},
/area/shuttle/escape/centcom)
"qx" = (
/obj/decal/tile_edge/line/black{
	icon_state = "line1"
	},
/obj/fakeobject{
	anchored = 1;
	desc = "Like conventional cables, but more burly.";
	dir = 10;
	icon = 'icons/obj/power_cond.dmi';
	icon_state = "conduit";
	layer = 2.5;
	name = "power conduit"
	},
/obj/fakeobject{
	anchored = 1;
	desc = "Like conventional cables, but more burly.";
	dir = 4;
	icon = 'icons/obj/power_cond.dmi';
	icon_state = "conduit";
	layer = 2.5;
	name = "power conduit";
	tag = "icon-conduit (EAST)"
	},
/turf/unsimulated/floor{
	icon_state = "floor"
	},
/area/centcom/outside)
"qH" = (
/obj/indestructible/shuttle_corner{
	dir = 4
	},
/turf/unsimulated/floor/shuttlebay,
/area/shuttle/escape/centcom)
"qZ" = (
/turf/unsimulated/floor/stairs/dark/wide{
	dir = 6
	},
/area/centcom/outside)
"rl" = (
/obj/machinery/sleeper/compact,
/turf/unsimulated/floor/shuttle{
	icon_state = "floor3"
	},
/area/shuttle/escape/centcom)
"ro" = (
/turf/unsimulated/floor/shuttle{
	icon_state = "floor4"
	},
/area/shuttle/escape/centcom)
"rK" = (
/obj/decal/tile_edge/stripe/extra_big{
	dir = 9;
	icon_state = "xtra_bigstripe-corner2"
	},
/obj/machinery/light/small/floor,
/turf/unsimulated/floor/shuttlebay,
/area/centcom/outside)
"rP" = (
/turf/unsimulated/floor/arrival{
	dir = 4
	},
/area/centcom)
"rQ" = (
/obj/decal/tile_edge/stripe/extra_big{
	dir = 10;
	icon_state = "xtra_bigstripe-corner2"
	},
/turf/unsimulated/floor/shuttlebay,
/area/centcom/outside)
"rR" = (
/turf/unsimulated/floor/shuttlebay,
/area/centcom/outside)
"rZ" = (
/obj/indestructible/shuttle_corner{
	dir = 0
	},
/turf/unsimulated/floor/shuttle,
/area/shuttle/escape/centcom)
"sd" = (
/obj/decal/tile_edge/line/black{
	dir = 4;
	icon_state = "line1"
	},
/turf/unsimulated/floor{
	icon_state = "floor"
	},
/area/centcom/outside)
"ss" = (
/turf/unsimulated/floor{
	icon_state = "floor"
	},
/area/centcom)
"sB" = (
/obj/decal/tile_edge/stripe/extra_big{
	dir = 6;
	icon_state = "xtra_bigstripe-corner2"
	},
/obj/machinery/light/small/floor,
/turf/unsimulated/floor/shuttlebay,
/area/centcom/outside)
"sE" = (
/obj/shrub{
	dir = 1
	},
/obj/machinery/light{
	dir = 4
	},
/turf/unsimulated/floor/arrival{
	dir = 6
	},
/area/centcom)
"sR" = (
/obj/decal/tile_edge/stripe/extra_big,
/obj/machinery/light/small/floor,
/turf/unsimulated/floor/shuttlebay,
/area/centcom/outside)
"ta" = (
/turf/unsimulated/floor/stairs/dark{
	dir = 4
	},
/area/centcom/outside)
"tC" = (
/obj/stool/chair/comfy/shuttle/brown{
	dir = 4
	},
/obj/machinery/light,
/turf/unsimulated/floor/shuttle,
/area/shuttle/escape/centcom)
"tD" = (
/obj/fakeobject{
	anchored = 1;
	desc = "Like conventional cables, but more burly.";
	dir = 1;
	icon = 'icons/obj/power_cond.dmi';
	icon_state = "conduit";
	layer = 2.5;
	name = "power conduit";
	tag = "icon-conduit (NORTH)"
	},
/obj/decal/tile_edge/stripe/extra_big,
/turf/unsimulated/floor/shuttlebay,
/area/centcom/outside)
"uY" = (
/obj/decal/tile_edge/stripe/extra_big{
	icon_state = "delivery2"
	},
/turf/unsimulated/floor/arrival{
	dir = 1
	},
/area/centcom)
"vd" = (
/obj/decal/tile_edge/stripe/extra_big{
	dir = 8;
	tag = "icon-xtra_bigstripe-edge (WEST)"
	},
/turf/unsimulated/floor/shuttlebay,
/area/centcom/outside)
"vp" = (
/obj/indestructible/shuttle_corner{
	dir = 8
	},
/turf/unsimulated/floor/shuttle{
	icon_state = "floor4"
	},
/area/shuttle/escape/centcom)
"vx" = (
/obj/stool/chair/comfy/shuttle/brown{
	dir = 4
	},
/obj/machinery/light{
	dir = 1;
	pixel_y = 21
	},
/turf/unsimulated/floor/shuttle,
/area/shuttle/escape/centcom)
"vW" = (
/obj/machinery/light{
	dir = 1;
	pixel_y = 21
	},
/turf/unsimulated/floor/shuttle{
	icon_state = "floor6"
	},
/area/shuttle/escape/centcom)
"wm" = (
/obj/stool/chair/comfy/shuttle,
/turf/unsimulated/floor/shuttle{
	icon_state = "floor2"
	},
/area/shuttle/escape/centcom)
"wR" = (
/turf/unsimulated/floor/stairs/dark/wide{
	dir = 1
	},
/area/centcom/outside)
"wT" = (
/obj/mapping_helper/wingrille_spawn/auto/reinforced,
/turf/unsimulated/floor/shuttle,
/area/shuttle/escape/centcom)
"xw" = (
/turf/unsimulated/floor/shuttle{
	icon_state = "floor2"
	},
/area/shuttle/escape/centcom)
"yZ" = (
/obj/decal/tile_edge/line/black{
	dir = 1;
	icon_state = "line1"
	},
/obj/fakeobject/pipe{
	dir = 10;
	name = "pipe";
	color = "b4b4b4"
	},
/turf/unsimulated/floor{
	icon_state = "floor"
	},
/area/centcom/outside)
"zb" = (
/turf/unsimulated/floor{
	icon_state = "floor"
	},
/area/centcom/outside)
"zi" = (
/obj/decal/tile_edge/stripe/extra_big{
	dir = 5
	},
/obj/machinery/light/small/floor,
/turf/unsimulated/floor/shuttlebay,
/area/centcom/outside)
"zj" = (
/turf/unsimulated/wall/generic{
	dir = 4;
	icon = 'icons/misc/worlds.dmi';
	icon_state = "leadwindow_1";
	name = "window";
	opacity = 0
	},
/area/centcom)
"zo" = (
/turf/unsimulated/floor/arrival{
	dir = 1
	},
/area/centcom)
"zr" = (
/obj/decal/tile_edge/stripe/extra_big{
	dir = 1
	},
/obj/machinery/light/small/floor,
/turf/unsimulated/floor/shuttlebay,
/area/centcom/outside)
"zy" = (
/obj/decal/tile_edge/stripe/extra_big{
	dir = 5
	},
/turf/unsimulated/floor/shuttlebay,
/area/centcom/outside)
"zA" = (
/obj/decal/tile_edge/stripe/extra_big{
	dir = 10;
	icon_state = "xtra_bigstripe-corner2"
	},
/obj/machinery/light/small/floor,
/turf/unsimulated/floor/shuttlebay,
/area/centcom/outside)
"Ae" = (
/obj/decal/tile_edge/line/black{
	icon_state = "line1"
	},
/obj/fakeobject{
	anchored = 1;
	desc = "Like conventional cables, but more burly.";
	dir = 10;
	icon = 'icons/obj/power_cond.dmi';
	icon_state = "conduit";
	layer = 2.5;
	name = "power conduit"
	},
/turf/unsimulated/floor{
	icon_state = "floor"
	},
/area/centcom/outside)
"AI" = (
/turf/simulated/wall/auto/shuttle{
	icon_state = "13"
	},
/area/shuttle/escape/centcom)
"BC" = (
/obj/machinery/door/airlock/pyro/external,
/obj/decal/tile_edge/stripe/extra_big{
	icon_state = "delivery2"
	},
/turf/unsimulated/outdoors/grass,
/area/centcom)
"BD" = (
/turf/unsimulated/floor/arrival,
/area/centcom)
"CC" = (
/obj/decal/tile_edge/stripe/extra_big,
/turf/unsimulated/floor/shuttlebay,
/area/centcom/outside)
"CK" = (
/obj/machinery/door/airlock/pyro/glass/command{
	dir = 4;
	hardened = 1
	},
/obj/mapping_helper/access/heads,
/turf/unsimulated/floor/shuttle{
	icon_state = "floor2"
	},
/area/shuttle/escape/centcom)
"Da" = (
/turf/unsimulated/floor/stairs/dark/wide,
/area/centcom/outside)
"DC" = (
/obj/machinery/door/airlock/pyro/security{
	dir = 4;
	name = "Secure Transport";
	hardened = 1
	},
/obj/mapping_helper/access/security,
/turf/unsimulated/floor/shuttle{
	icon_state = "floor4"
	},
/area/shuttle/escape/centcom)
"DI" = (
/obj/machinery/light{
	dir = 8
	},
/turf/unsimulated/floor/shuttle{
	icon_state = "floor3"
	},
/area/shuttle/escape/centcom)
"DN" = (
/obj/fakeobject/pipe{
	dir = 2;
	icon = 'icons/obj/atmospherics/valve.dmi';
	icon_state = "valve0-map";
	name = "valve"
	},
/turf/unsimulated/floor{
	icon_state = "floor"
	},
/area/centcom/outside)
"DY" = (
/turf/unsimulated/floor/shuttle{
	icon_state = "floor6"
	},
/area/shuttle/escape/centcom)
"Em" = (
/obj/decal/tile_edge/stripe/extra_big{
	dir = 5;
	icon_state = "xtra_bigstripe-corner2"
	},
/obj/machinery/light/small/floor,
/turf/unsimulated/floor/shuttlebay,
/area/centcom/outside)
"Er" = (
/obj/indestructible/shuttle_corner{
	dir = 8
	},
/turf/unsimulated/floor/shuttlebay,
/area/shuttle/escape/centcom)
"EF" = (
/turf/simulated/wall/auto/shuttle{
	icon_state = "3"
	},
/area/shuttle/escape/centcom)
"EH" = (
/obj/fakeobject/pipe{
	dir = 4;
	name = "pipe";
	color = "b4b4b4"
	},
/obj/decal/tile_edge/stripe/extra_big{
	dir = 4
	},
/turf/unsimulated/floor/shuttlebay,
/area/centcom/outside)
"EQ" = (
/obj/table/reinforced/auto,
/obj/item/storage/toolbox/emergency,
/turf/unsimulated/floor/shuttle{
	icon_state = "floor2"
	},
/area/shuttle/escape/centcom)
"ET" = (
/obj/decal/tile_edge/line/black{
	dir = 6;
	icon_state = "line2"
	},
/obj/fakeobject{
	anchored = 1;
	desc = "Like conventional cables, but more burly.";
	dir = 4;
	icon = 'icons/obj/power_cond.dmi';
	icon_state = "conduit";
	layer = 2.5;
	name = "power conduit";
	tag = "icon-conduit (EAST)"
	},
/turf/unsimulated/floor{
	icon_state = "floor"
	},
/area/centcom/outside)
"FC" = (
/obj/rack,
/obj/random_item_spawner/tools/maybe_few,
/obj/random_item_spawner/tools/one_or_zero,
/turf/unsimulated/floor/black,
/area/centcom/outside)
"Gb" = (
/obj/fakeobject/shuttleengine{
	dir = 8;
	icon_state = "alt_heater-M"
	},
/turf/simulated/wall/auto/shuttle{
	icon_state = "3"
	},
/area/shuttle/escape/centcom)
"Gc" = (
/obj/machinery/light/small/floor,
/turf/unsimulated/floor/black,
/area/centcom/outside)
"GN" = (
/obj/table/reinforced/auto,
/obj/item/storage/firstaid/regular{
	pixel_x = 7
	},
/obj/item/device/radio{
	pixel_x = -6;
	pixel_y = 5
	},
/turf/unsimulated/floor/shuttle{
	icon_state = "floor2"
	},
/area/shuttle/escape/centcom)
"GU" = (
/obj/decal/tile_edge/stripe/extra_big{
	icon_state = "delivery2"
	},
/turf/unsimulated/floor/arrival,
/area/centcom)
"GV" = (
/turf/simulated/wall/auto/shuttle{
	icon_state = "11"
	},
/area/shuttle/escape/centcom)
"If" = (
/obj/stool/chair/comfy/shuttle{
	dir = 1
	},
/turf/unsimulated/floor/shuttle{
	icon_state = "floor2"
	},
/area/shuttle/escape/centcom)
"Il" = (
/turf/unsimulated/floor/shuttle,
/area/shuttle/escape/centcom)
"It" = (
/obj/decal/tile_edge/line/black{
	dir = 1;
	icon_state = "line1"
	},
/obj/fakeobject/pipe{
	dir = 5;
	name = "pipe";
	color = "b4b4b4"
	},
/turf/unsimulated/floor{
	icon_state = "floor"
	},
/area/centcom/outside)
"Iy" = (
/obj/decal/tile_edge/line/orange{
	dir = 8;
	icon_state = "line1"
	},
/turf/unsimulated/floor/black,
/area/centcom/outside)
"Iz" = (
/obj/stool/chair/comfy/shuttle/red{
	dir = 1
	},
/turf/unsimulated/floor/shuttle{
	icon_state = "floor4"
	},
/area/shuttle/escape/centcom)
"IK" = (
/obj/stool/bench/blue/auto,
/turf/unsimulated/floor/arrival{
	dir = 8
	},
/area/centcom)
"IV" = (
/turf/unsimulated/wall/auto/lead/blue,
/area/centcom)
"Jd" = (
/obj/machinery/door/airlock/pyro/glass{
	dir = 4;
	hardened = 1
	},
/turf/unsimulated/floor/shuttle{
	icon_state = "floor6"
	},
/area/shuttle/escape/centcom)
"JY" = (
/obj/shrub,
/obj/machinery/light{
	dir = 8
	},
/turf/unsimulated/floor/arrival{
	dir = 10
	},
/area/centcom)
"Kg" = (
/obj/decal/tile_edge/line/black{
	dir = 4;
	icon_state = "line1"
	},
/obj/machinery/light/small/floor,
/turf/unsimulated/floor{
	icon_state = "floor"
	},
/area/centcom/outside)
"Lk" = (
/turf/unsimulated/floor/black,
/area/centcom/outside)
"Ls" = (
/obj/fakeobject/shuttleengine{
	dir = 8;
	icon_state = "alt_heater-L"
	},
/turf/simulated/wall/auto/shuttle{
	icon_state = "3"
	},
/area/shuttle/escape/centcom)
"LN" = (
/obj/fakeobject{
	anchored = 1;
	desc = "Like conventional cables, but more burly.";
	dir = 1;
	icon = 'icons/obj/power_cond.dmi';
	icon_state = "conduit";
	layer = 2.5;
	name = "power conduit";
	tag = "icon-conduit (NORTH)"
	},
/turf/unsimulated/floor/shuttlebay,
/area/centcom/outside)
"LT" = (
/obj/indestructible/shuttle_corner{
	dir = 0
	},
/turf/unsimulated/floor/shuttle{
	icon_state = "floor2"
	},
/area/shuttle/escape/centcom)
"LV" = (
/obj/decal/tile_edge/stripe/extra_big{
	dir = 5;
	icon_state = "xtra_bigstripe-corner2"
	},
/turf/unsimulated/floor/shuttlebay,
/area/centcom/outside)
"LZ" = (
/obj/decal/tile_edge/line/black{
	icon_state = "line1"
	},
/obj/fakeobject{
	anchored = 1;
	desc = "Like conventional cables, but more burly.";
	dir = 4;
	icon = 'icons/obj/power_cond.dmi';
	icon_state = "conduit";
	layer = 2.5;
	name = "power conduit";
	tag = "icon-conduit (EAST)"
	},
/turf/unsimulated/floor{
	icon_state = "floor"
	},
/area/centcom/outside)
"ME" = (
/obj/machinery/sleeper/compact,
/obj/machinery/light,
/turf/unsimulated/floor/shuttle{
	icon_state = "floor3"
	},
/area/shuttle/escape/centcom)
"NK" = (
/obj/machinery/door/airlock/pyro/external,
/turf/unsimulated/floor/shuttle,
/area/shuttle/escape/centcom)
"NR" = (
/obj/machinery/atmospherics/unary/portables_connector{
	dir = 4
	},
/obj/fakeobject{
	density = 1;
	icon = 'icons/obj/atmospherics/atmos.dmi';
	icon_state = "orange";
	name = "Canister \[Plasma\]"
	},
/turf/unsimulated/floor{
	icon_state = "floor"
	},
/area/centcom/outside)
"Oo" = (
/obj/shrub,
/obj/machinery/light{
	dir = 4
	},
/turf/unsimulated/floor/arrival{
	dir = 5
	},
/area/centcom)
"Ou" = (
/obj/table/auto,
/obj/item/storage/firstaid/fire{
	pixel_x = -6
	},
/obj/item/storage/firstaid/brute{
	pixel_x = 7
	},
/obj/item/storage/firstaid/oxygen{
	pixel_x = 1;
	pixel_y = 10
	},
/turf/unsimulated/floor/shuttle{
	icon_state = "floor3"
	},
/area/shuttle/escape/centcom)
"Ox" = (
/obj/decal/tile_edge/stripe/extra_big{
	dir = 8;
	tag = "icon-xtra_bigstripe-edge (WEST)"
	},
/obj/decal/tile_edge/stripe/corner/extra_big{
	dir = 8
	},
/obj/machinery/light/small/floor,
/turf/unsimulated/floor/black,
/area/centcom/outside)
"PL" = (
/obj/fakeobject/tallsmes,
/turf/unsimulated/floor{
	icon_state = "floor"
	},
/area/centcom/outside)
"PU" = (
/obj/indestructible/shuttle_corner{
	dir = 4
	},
/turf/unsimulated/floor/shuttle{
	icon_state = "floor2"
	},
/area/shuttle/escape/centcom)
"Qp" = (
/turf/unsimulated/floor/stairs/dark/wide{
	dir = 10
	},
/area/centcom/outside)
"Rb" = (
/obj/stool/chair/comfy/shuttle/red,
/turf/unsimulated/floor/shuttle{
	icon_state = "floor4"
	},
/area/shuttle/escape/centcom)
"Rh" = (
/obj/machinery/door/airlock/pyro/external{
	dir = 4
	},
/turf/unsimulated/floor{
	icon_state = "floor"
	},
/area/centcom)
"RC" = (
/obj/decal/tile_edge/stripe/extra_big{
	dir = 10
	},
/turf/unsimulated/floor/shuttlebay,
/area/centcom/outside)
"Sp" = (
/obj/indestructible/shuttle_corner{
	dir = 0
	},
/turf/unsimulated/floor/shuttlebay,
/area/shuttle/escape/centcom)
"Te" = (
/obj/decal/tile_edge/line/orange{
	dir = 8;
	icon_state = "line1"
	},
/obj/machinery/light/small/floor,
/turf/unsimulated/floor/black,
/area/centcom/outside)
"Ti" = (
/obj/fakeobject/shuttlethruster{
	dir = 8;
	icon_state = "alt_propulsion"
	},
/turf/unsimulated/floor/shuttlebay,
/area/shuttle/escape/centcom)
"TZ" = (
/obj/decal/tile_edge/stripe/extra_big{
	dir = 9
	},
/turf/unsimulated/floor/shuttlebay,
/area/centcom/outside)
"Un" = (
/obj/decal/tile_edge/line/black{
	dir = 1;
	icon_state = "line1"
	},
/obj/fakeobject/pipe{
	dir = 1;
	icon = 'icons/obj/atmospherics/pipes/manifold_pipe.dmi';
	icon_state = "manifold-map";
	name = "pipe"
	},
/turf/unsimulated/floor{
	icon_state = "floor"
	},
/area/centcom/outside)
"UQ" = (
/obj/machinery/light/small/floor,
/turf/unsimulated/floor{
	icon_state = "floor"
	},
/area/centcom/outside)
"UT" = (
/obj/table/auto,
/obj/machinery/coffeemaker{
	pixel_x = -1;
	pixel_y = 2
	},
/obj/drink_rack/mug{
	pixel_x = -26;
	pixel_y = 4
	},
/turf/unsimulated/floor/shuttle{
	icon_state = "floor6"
	},
/area/shuttle/escape/centcom)
"Vi" = (
/obj/stool/chair/comfy/shuttle{
	dir = 8
	},
/obj/machinery/light{
	dir = 4;
	pixel_x = 10
	},
/turf/unsimulated/floor/shuttle{
	icon_state = "floor2"
	},
/area/shuttle/escape/centcom)
"Vz" = (
/obj/stool/bench/blue/auto,
/obj/machinery/light{
	dir = 4
	},
/turf/unsimulated/floor/arrival{
	dir = 4
	},
/area/centcom)
"VP" = (
/obj/decal/poster/wallsign/danger_highvolt{
	pixel_y = 32
	},
/turf/unsimulated/floor/shuttlebay,
/area/centcom/outside)
"XE" = (
/obj/stool/chair/blue{
	dir = 8
	},
/turf/unsimulated/floor{
	icon_state = "floor"
	},
/area/centcom)
"XO" = (
/turf/unsimulated/wall/generic{
	icon = 'icons/misc/worlds.dmi';
	icon_state = "leadwindow_1";
	name = "window";
	opacity = 0
	},
/area/centcom)
"XZ" = (
/obj/decal/tile_edge/line/black{
	dir = 1;
	icon_state = "line1"
	},
/obj/fakeobject/pipe{
	dir = 4;
	name = "pipe";
	color = "b4b4b4"
	},
/turf/unsimulated/floor{
	icon_state = "floor"
	},
/area/centcom/outside)
"Ya" = (
/obj/decal/tile_edge/line/orange{
	icon_state = "line1"
	},
/turf/unsimulated/floor/black,
/area/centcom/outside)
"Yd" = (
/obj/decal/tile_edge/line/orange{
	dir = 9;
	icon_state = "line2"
	},
/turf/unsimulated/floor/black,
/area/centcom/outside)
"YN" = (
/obj/machinery/computer/announcement{
	dir = 8
	},
/turf/unsimulated/floor/shuttle{
	icon_state = "floor2"
	},
/area/shuttle/escape/centcom)
"ZJ" = (
/turf/unsimulated/floor/arrival{
	dir = 8
	},
/area/centcom)
"ZY" = (
/obj/fakeobject/pipe{
	dir = 6;
	name = "pipe";
	color = "b4b4b4"
	},
/turf/unsimulated/floor/shuttlebay,
/area/centcom/outside)

(1,1,1) = {"
IV
IV
IV
IV
XO
IV
IV
XO
IV
IV
XO
IV
IV
XO
IV
IV
XO
IV
IV
XO
IV
IV
XO
IV
IV
IV
"}
(2,1,1) = {"
IV
PL
ky
Ae
rR
gL
ZY
jY
ip
ip
ip
jY
jY
jY
jY
ip
ip
ip
jY
ip
jY
jY
It
UQ
NR
IV
"}
(3,1,1) = {"
IV
zb
UQ
LZ
rR
rR
kt
sB
EH
EH
EH
LV
rR
rR
dK
EH
EH
EH
Em
kt
rR
rR
Un
DN
aZ
IV
"}
(4,1,1) = {"
zj
PL
ky
qx
rR
sB
EH
cl
Ti
Ti
Ti
zi
LV
dK
cr
Ti
Ti
Ti
zy
EH
Em
rR
XZ
zb
mY
zj
"}
(5,1,1) = {"
IV
zb
zb
LZ
rR
CC
Ti
Sp
pj
Gb
qb
qH
zy
cl
Sp
Ls
Gb
gG
qH
Ti
eQ
rR
XZ
zb
NR
IV
"}
(6,1,1) = {"
IV
PL
ky
qx
rR
CC
dB
dW
vp
pp
Iz
dW
EF
EF
AI
fH
DI
gA
AI
dB
eQ
rR
yZ
DN
aZ
IV
"}
(7,1,1) = {"
zj
sd
Kg
ET
rR
sR
dW
vp
Rb
ro
Iz
fa
kB
UT
fa
fH
oC
rl
gA
AI
zr
rR
cm
Kg
kz
zj
"}
(8,1,1) = {"
IV
VP
rR
iC
LN
tD
fa
cV
ro
ro
Iz
fa
DY
hx
fa
fH
oC
oC
ME
fa
eQ
rR
rR
rR
rR
IV
"}
(9,1,1) = {"
IV
ac
Iy
ta
eA
CC
fa
Rb
ro
ro
Iz
fa
vW
hx
fa
Ou
oC
oC
rl
fa
eQ
Yd
ta
Iy
dH
IV
"}
(10,1,1) = {"
zj
Lk
Lk
af
Ya
CC
dW
EF
EF
DC
EF
GV
Jd
Jd
GV
EF
cd
EF
EF
AI
eQ
ab
af
Lk
Lk
zj
"}
(11,1,1) = {"
IV
IV
pm
Rh
pm
IV
fa
bD
bD
Il
bD
bD
Il
Il
bD
bD
Il
bD
bD
fa
IV
pm
Rh
pm
IV
IV
"}
(12,1,1) = {"
IK
jS
IK
ZJ
JY
IV
wT
vx
bD
aB
bD
bD
Il
Il
bD
bD
aB
bD
tC
wT
IV
dC
ZJ
IK
jS
IK
"}
(13,1,1) = {"
ss
ss
ss
ss
GU
BC
NK
Il
Il
Il
Il
aB
Il
Il
aB
Il
Il
Il
Il
NK
BC
uY
ss
ss
ss
ss
"}
(14,1,1) = {"
XE
XE
XE
XE
BD
IV
wT
bD
bD
Il
bD
bD
Il
Il
bD
bD
Il
bD
bD
wT
IV
zo
XE
XE
XE
XE
"}
(15,1,1) = {"
iD
iD
iD
iD
BD
IV
wT
bD
bD
aB
bD
bD
Il
Il
bD
bD
aB
bD
bD
wT
IV
zo
iD
iD
iD
iD
"}
(16,1,1) = {"
ss
ss
ss
ss
GU
BC
NK
Il
Il
Il
Il
Il
Il
Il
Il
Il
Il
Il
Il
NK
BC
uY
ss
ss
ss
ss
"}
(17,1,1) = {"
aa
Vz
aa
rP
sE
IV
wT
vx
bD
bD
bD
aB
bD
bD
aB
bD
bD
bD
tC
wT
IV
Oo
rP
aa
Vz
aa
"}
(18,1,1) = {"
IV
IV
pm
Rh
pm
IV
eu
oO
jx
bD
bD
Il
bD
bD
Il
bD
bD
jx
rZ
Er
IV
pm
Rh
pm
IV
IV
"}
(19,1,1) = {"
zj
FC
Lk
Ox
Ya
rR
RC
eu
EF
EF
EF
CK
EF
EF
CK
EF
EF
EF
Er
TZ
rR
ab
Ox
Lk
FC
zj
"}
(20,1,1) = {"
IV
Lk
Lk
Lk
Qp
rR
zA
vd
RC
aQ
EQ
xw
xw
xw
xw
GN
aQ
TZ
vd
rK
rR
Da
Lk
Lk
Lk
IV
"}
(21,1,1) = {"
IV
FC
Lk
Lk
wR
rR
rR
rR
CC
aQ
wm
xw
px
px
xw
If
aQ
eQ
rR
rR
rR
qZ
Lk
Lk
FC
IV
"}
(22,1,1) = {"
zj
Lk
Lk
Gc
Lk
eA
rR
rR
CC
eu
PU
Vi
YN
lK
Vi
LT
Er
eQ
rR
rR
Yd
Lk
Gc
Lk
Lk
zj
"}
(23,1,1) = {"
IV
Lk
Lk
Lk
Lk
gP
eA
rR
zA
RC
eu
aQ
aQ
aQ
aQ
Er
TZ
rK
rR
Yd
al
Lk
Lk
Lk
Lk
IV
"}
(24,1,1) = {"
IV
Lk
Lk
Lk
Lk
Gc
Ya
rR
rR
rQ
vd
vd
vd
vd
vd
vd
bs
rR
rR
ab
Gc
Lk
Lk
Lk
Lk
IV
"}
(25,1,1) = {"
IV
Lk
Lk
Lk
Lk
Lk
gP
Iy
Te
Iy
Iy
Te
Iy
Iy
Te
Iy
Iy
Te
Iy
al
Lk
Lk
Lk
Lk
Lk
IV
"}
(26,1,1) = {"
IV
IV
IV
IV
XO
IV
IV
XO
IV
IV
XO
IV
IV
XO
IV
IV
XO
IV
IV
XO
IV
IV
XO
IV
IV
IV
"}
