//MAP CONVERTED BY dmm2tgm.py THIS HEADER COMMENT PREVENTS RECONVERSION, DO NOT REMOVE
"aI" = (
/turf/unsimulated/floor/marble/border_bw,
/area/shuttle/escape/centcom)
"bj" = (
/obj/shrub{
	dir = 10
	},
/turf/unsimulated/floor/carpet/regalcarpet/border{
	dir = 10
	},
/area/shuttle/escape/centcom)
"bz" = (
/obj/stool/chair/comfy/throne_gold{
	anchored = 1;
	dir = 4
	},
/obj/item/clothing/head/crown,
/turf/unsimulated/floor/carpet/regalcarpet,
/area/shuttle/escape/centcom)
"bW" = (
/obj/machinery/shuttle/engine/heater{
	dir = 4;
	icon_state = "alt_heater-L"
	},
/turf/unsimulated/floor/plating,
/area/shuttle/escape/centcom)
"cr" = (
/obj/item/storage/wall/medical{
	pixel_z = -1
	},
/turf/simulated/wall/auto/shuttle{
	icon_state = "13"
	},
/area/shuttle/escape/centcom)
"cL" = (
/obj/table/clothred/auto,
/obj/random_item_spawner/med_kit/two{
	pixel_x = 6;
	pixel_y = -6
	},
/obj/item/storage/toolbox/emergency{
	pixel_x = -2;
	pixel_y = 10
	},
/obj/item/reagent_containers/food/drinks/bottle/wine{
	pixel_x = -6;
	pixel_y = 5;
	rand_pos = 0
	},
/obj/machinery/light/small/floor/netural,
/turf/unsimulated/floor/marble/border_bw{
	dir = 8
	},
/area/shuttle/escape/centcom)
"dg" = (
/obj/machinery/light,
/obj/shrub{
	dir = 4
	},
/obj/item/reagent_containers/food/snacks/donut/custom/frosted{
	rand_pos = 0
	},
/turf/unsimulated/floor/marble/border_bw{
	dir = 1
	},
/area/shuttle/escape/centcom)
"dh" = (
/obj/item/storage/wall/emergency,
/turf/simulated/wall/auto/shuttle{
	icon_state = "13"
	},
/area/shuttle/escape/centcom)
"ed" = (
/turf/simulated/shuttle/wall/cockpit{
	dir = 4;
	layer = 50
	},
/area/shuttle/escape/centcom)
"fM" = (
/obj/machinery/light{
	dir = 1;
	pixel_y = 21
	},
/obj/shrub{
	dir = 8
	},
/turf/unsimulated/floor/marble/border_bw,
/area/shuttle/escape/centcom)
"gm" = (
/obj/table/regal/auto,
/obj/machinery/light/small/floor/netural,
/obj/random_item_spawner/med_kit/two,
/obj/item/storage/toolbox/emergency,
/turf/unsimulated/floor/carpet/regalcarpet/border{
	dir = 10
	},
/area/shuttle/escape/centcom)
"gI" = (
/turf/unsimulated/wall{
	dir = 1;
	icon = 'icons/misc/worlds.dmi';
	icon_state = "leadcap"
	},
/area/centcom)
"in" = (
/obj/stool/chair/wooden/regal{
	anchored = 1;
	dir = 4
	},
/turf/unsimulated/floor/carpet/regalcarpet/border{
	dir = 8
	},
/area/shuttle/escape/centcom)
"iJ" = (
/turf/unsimulated/floor/carpet/regalcarpet/border{
	dir = 5
	},
/area/shuttle/escape/centcom)
"jA" = (
/obj/machinery/shuttle/engine/heater{
	dir = 4;
	icon_state = "alt_heater-M"
	},
/turf/unsimulated/floor/plating,
/area/shuttle/escape/centcom)
"kK" = (
/obj/machinery/light,
/obj/shrub{
	dir = 8
	},
/turf/unsimulated/floor/marble/border_bw{
	dir = 1
	},
/area/shuttle/escape/centcom)
"kU" = (
/turf/unsimulated/floor/carpet/regalcarpet/border{
	dir = 9
	},
/area/shuttle/escape/centcom)
"lk" = (
/obj/shrub{
	dir = 8
	},
/turf/unsimulated/floor/marble/border_bw{
	dir = 8
	},
/area/shuttle/escape/centcom)
"nC" = (
/obj/stool/chair/comfy/throne_gold{
	anchored = 1;
	dir = 4
	},
/turf/unsimulated/floor/carpet/regalcarpet/border,
/area/shuttle/escape/centcom)
"ou" = (
/obj/machinery/light{
	dir = 1;
	pixel_y = 21
	},
/obj/table/regal/auto,
/obj/item/reagent_containers/food/snacks/donut/custom/frosted{
	pixel_x = 3;
	pixel_y = 12;
	rand_pos = 0
	},
/obj/decoration/floralarrangement,
/turf/unsimulated/floor/marble,
/area/shuttle/escape/centcom)
"oL" = (
/obj/indestructible/shuttle_corner{
	dir = 8
	},
/turf/unsimulated/outdoors/grass,
/area/shuttle/escape/centcom)
"oU" = (
/obj/wingrille_spawn/auto,
/obj/machinery/shuttle/engine/heater{
	dir = 4;
	icon_state = "alt_heater-L"
	},
/turf/unsimulated/floor/plating,
/area/shuttle/escape/centcom)
"ph" = (
/obj/decoration/regallamp{
	anchored = 1;
	lit = 1
	},
/turf/unsimulated/floor/marble/border_bw{
	dir = 1
	},
/area/shuttle/escape/centcom)
"pP" = (
/turf/unsimulated/floor/marble,
/area/shuttle/escape/centcom)
"qS" = (
/obj/indestructible/invisible_block,
/turf/unsimulated/floor/marble,
/area/shuttle/escape/centcom)
"ri" = (
/obj/wingrille_spawn/auto,
/obj/machinery/shuttle/engine/heater{
	dir = 4;
	icon_state = "alt_heater-M"
	},
/turf/unsimulated/floor/plating,
/area/shuttle/escape/centcom)
"rA" = (
/obj/stool/chair/comfy/throne_gold{
	anchored = 1;
	dir = 4
	},
/turf/unsimulated/floor/carpet/regalcarpet,
/area/shuttle/escape/centcom)
"rL" = (
/obj/decoration/regallamp{
	anchored = 1;
	lit = 1
	},
/turf/unsimulated/floor/carpet/regalcarpet/innercorner{
	dir = 8
	},
/area/shuttle/escape/centcom)
"rU" = (
/obj/machinery/light,
/obj/table/regal/auto,
/obj/decoration/floralarrangement,
/turf/unsimulated/floor/marble,
/area/shuttle/escape/centcom)
"sy" = (
/obj/table/clothred/auto,
/obj/item/kitchen/food_box/donut_box{
	pixel_x = -4;
	pixel_y = 14
	},
/obj/item/kitchen/food_box/donut_box{
	pixel_x = 2;
	pixel_y = 6
	},
/obj/machinery/light/small/floor/netural,
/turf/unsimulated/floor/marble/border_bw{
	dir = 8
	},
/area/shuttle/escape/centcom)
"ty" = (
/obj/decoration/regallamp{
	anchored = 1;
	lit = 1
	},
/turf/unsimulated/floor/marble/border_wb{
	dir = 9
	},
/area/shuttle/escape/centcom)
"tG" = (
/turf/unsimulated/floor/marble/border_bw{
	dir = 1
	},
/area/shuttle/escape/centcom)
"vY" = (
/turf/simulated/wall/auto/shuttle{
	icon_state = "12"
	},
/area/shuttle/escape/centcom)
"wL" = (
/obj/shrub{
	dir = 1
	},
/turf/unsimulated/floor/marble/border_bw{
	dir = 1
	},
/area/shuttle/escape/centcom)
"wY" = (
/turf/unsimulated/floor/carpet/regalcarpet/border{
	dir = 4
	},
/area/shuttle/escape/centcom)
"xK" = (
/turf/unsimulated/floor/carpet/regalcarpet/innercorner{
	dir = 5
	},
/area/shuttle/escape/centcom)
"xR" = (
/obj/wingrille_spawn/auto,
/obj/machinery/shuttle/engine/heater{
	dir = 4;
	icon_state = "alt_heater-R"
	},
/turf/unsimulated/floor/plating,
/area/shuttle/escape/centcom)
"xS" = (
/obj/machinery/door/airlock/pyro/external{
	dir = 1
	},
/turf/unsimulated/floor/shuttle{
	dir = 8
	},
/area/shuttle/escape/centcom)
"xV" = (
/obj/stool/chair/wooden/regal{
	anchored = 1;
	dir = 1
	},
/turf/unsimulated/floor/carpet/regalcarpet/border,
/area/shuttle/escape/centcom)
"yI" = (
/turf/unsimulated/floor/carpet/regalcarpet/innercorner,
/area/shuttle/escape/centcom)
"yN" = (
/obj/wingrille_spawn/auto/crystal,
/turf/unsimulated/floor/marble/black,
/area/shuttle/escape/centcom)
"zl" = (
/obj/table/clothred/auto,
/obj/decoration/floralarrangement{
	pixel_y = 4
	},
/obj/item/reagent_containers/food/drinks/bottle/champagne{
	pixel_x = -5;
	pixel_y = 3;
	rand_pos = 0
	},
/obj/item/reagent_containers/food/drinks/bottle/wine{
	pixel_x = 7;
	pixel_y = 5;
	rand_pos = 0
	},
/obj/item/reagent_containers/food/drinks/drinkingglass/wine{
	pixel_x = 4;
	pixel_y = -3;
	rand_pos = 0
	},
/turf/unsimulated/floor/marble/border_bw{
	dir = 4
	},
/area/shuttle/escape/centcom)
"zo" = (
/obj/shrub,
/obj/machinery/light/small/floor/netural,
/turf/unsimulated/floor/marble/border_wb{
	dir = 9
	},
/area/shuttle/escape/centcom)
"zP" = (
/obj/shrub{
	dir = 6
	},
/turf/unsimulated/floor/marble/border_bw{
	dir = 1
	},
/area/shuttle/escape/centcom)
"Bm" = (
/obj/shrub{
	dir = 6
	},
/turf/unsimulated/floor/marble/border_bw,
/area/shuttle/escape/centcom)
"Ck" = (
/obj/decoration/regallamp{
	anchored = 1;
	lit = 1
	},
/turf/unsimulated/floor/marble/border_bw,
/area/shuttle/escape/centcom)
"CD" = (
/obj/indestructible/shuttle_corner{
	dir = 8
	},
/turf/unsimulated/floor/marble/black,
/area/shuttle/escape/centcom)
"Dw" = (
/turf/unsimulated/floor/marble/border_bw{
	dir = 8
	},
/area/shuttle/escape/centcom)
"DA" = (
/turf/unsimulated/floor/marble/border_bw{
	dir = 4
	},
/area/shuttle/escape/centcom)
"DO" = (
/obj/table/regal/auto,
/obj/machinery/light/small/floor/netural,
/obj/item/kitchen/food_box/donut_box{
	pixel_x = -4;
	pixel_y = 15
	},
/obj/item/kitchen/food_box/donut_box{
	pixel_x = 2;
	pixel_y = 5
	},
/turf/unsimulated/floor/carpet/regalcarpet/border{
	dir = 9
	},
/area/shuttle/escape/centcom)
"Em" = (
/obj/shrub{
	dir = 4
	},
/obj/item/clothing/head/crown,
/turf/unsimulated/floor/marble/border_bw,
/area/shuttle/escape/centcom)
"FS" = (
/obj/stool/chair/wooden/regal{
	anchored = 1;
	dir = 8
	},
/turf/unsimulated/floor/carpet/regalcarpet/border{
	dir = 4
	},
/area/shuttle/escape/centcom)
"Gb" = (
/turf/simulated/wall/auto/shuttle{
	icon_state = "8"
	},
/area/shuttle/escape/centcom)
"Gd" = (
/obj/indestructible/invisible_block,
/turf/unsimulated/outdoors/grass,
/area/shuttle/escape/centcom)
"GD" = (
/turf/unsimulated/floor/carpet/regalcarpet/border{
	dir = 6
	},
/area/shuttle/escape/centcom)
"HA" = (
/obj/decoration/regallamp{
	anchored = 1;
	lit = 1
	},
/turf/unsimulated/floor/marble/border_wb{
	dir = 10
	},
/area/shuttle/escape/centcom)
"HO" = (
/turf/unsimulated/floor/carpet/regalcarpet/border{
	dir = 10
	},
/area/shuttle/escape/centcom)
"HV" = (
/obj/machinery/shuttle/engine/propulsion{
	dir = 4;
	icon_state = "alt_propulsion"
	},
/turf/unsimulated/outdoors/grass,
/area/shuttle/escape/centcom)
"HZ" = (
/obj/indestructible/shuttle_corner{
	dir = 1
	},
/turf/unsimulated/floor/marble/black,
/area/shuttle/escape/centcom)
"If" = (
/turf/unsimulated/outdoors/grass,
/area/shuttle/escape/centcom)
"Io" = (
/turf/unsimulated/wall{
	icon = 'icons/misc/worlds.dmi';
	icon_state = "leadcap"
	},
/area/centcom)
"JD" = (
/obj/decoration/regallamp{
	anchored = 1;
	lit = 1
	},
/turf/unsimulated/floor/carpet/regalcarpet/innercorner{
	dir = 1
	},
/area/shuttle/escape/centcom)
"JS" = (
/obj/machinery/computer/shuttle/embedded/west,
/turf/unsimulated/floor/carpet/regalcarpet/border{
	dir = 8
	},
/area/shuttle/escape/centcom)
"La" = (
/turf/unsimulated/floor/carpet/regalcarpet,
/area/shuttle/escape/centcom)
"LG" = (
/turf/simulated/wall/auto/shuttle{
	icon_state = "3"
	},
/area/shuttle/escape/centcom)
"LM" = (
/obj/indestructible/shuttle_corner{
	dir = 4
	},
/turf/unsimulated/outdoors/grass,
/area/shuttle/escape/centcom)
"MG" = (
/turf/unsimulated/floor/marble/border_wb{
	dir = 5
	},
/area/shuttle/escape/centcom)
"Ns" = (
/obj/shrub,
/obj/machinery/light/small/floor/netural,
/turf/unsimulated/floor/marble/border_wb{
	dir = 10
	},
/area/shuttle/escape/centcom)
"NH" = (
/obj/shrub{
	dir = 1
	},
/obj/item/clothing/head/crown,
/turf/unsimulated/floor/marble/border_bw{
	dir = 8
	},
/area/shuttle/escape/centcom)
"NM" = (
/obj/indestructible/shuttle_corner,
/turf/unsimulated/outdoors/grass,
/area/shuttle/escape/centcom)
"Od" = (
/turf/unsimulated/outdoors/grass,
/area/centcom/outside)
"OL" = (
/obj/machinery/light{
	dir = 1;
	pixel_y = 21
	},
/obj/shrub{
	dir = 1
	},
/turf/unsimulated/floor/marble/border_bw,
/area/shuttle/escape/centcom)
"Pz" = (
/turf/simulated/wall/auto/shuttle{
	icon_state = "14"
	},
/area/shuttle/escape/centcom)
"PK" = (
/turf/unsimulated/floor/marble/border_bw{
	dir = 5
	},
/area/shuttle/escape/centcom)
"QK" = (
/obj/stool/chair/wooden/regal{
	anchored = 1
	},
/turf/unsimulated/floor/carpet/regalcarpet/border{
	dir = 1
	},
/area/shuttle/escape/centcom)
"RH" = (
/obj/table/regal/auto,
/obj/item/reagent_containers/food/snacks/croissant{
	pixel_x = -15;
	pixel_y = 11;
	rand_pos = 0
	},
/obj/item/reagent_containers/food/snacks/croissant{
	pixel_x = -8;
	pixel_y = 11;
	rand_pos = 0
	},
/obj/item/reagent_containers/food/snacks/croissant{
	pixel_y = 11;
	rand_pos = 0
	},
/obj/item/reagent_containers/food/snacks/croissant{
	pixel_x = 7;
	pixel_y = 11;
	rand_pos = 0
	},
/obj/decoration/floralarrangement{
	pixel_x = 17
	},
/obj/item/reagent_containers/food/snacks/danish_apple{
	rand_pos = 0
	},
/obj/item/reagent_containers/food/snacks/danish_blueb{
	rand_pos = 0
	},
/obj/item/reagent_containers/food/snacks/danish_cherry{
	pixel_x = -9;
	rand_pos = 0
	},
/obj/item/reagent_containers/food/snacks/danish_weed{
	pixel_x = -16;
	rand_pos = 0
	},
/obj/item/reagent_containers/food/snacks/danish_apple{
	pixel_x = -17;
	pixel_y = 6;
	rand_pos = 0
	},
/obj/item/reagent_containers/food/snacks/danish_blueb{
	pixel_x = -19;
	rand_pos = 0
	},
/turf/unsimulated/floor/carpet/regalcarpet,
/area/shuttle/escape/centcom)
"Sw" = (
/obj/table/regal/auto,
/obj/item/reagent_containers/food/snacks/croissant{
	pixel_x = -6;
	pixel_y = -3;
	rand_pos = 0
	},
/obj/item/reagent_containers/food/snacks/croissant{
	pixel_x = 1;
	pixel_y = -3;
	rand_pos = 0
	},
/obj/item/reagent_containers/food/snacks/croissant{
	pixel_x = 8;
	pixel_y = -3;
	rand_pos = 0
	},
/obj/item/reagent_containers/food/snacks/croissant{
	pixel_x = 15;
	pixel_y = -3;
	rand_pos = 0
	},
/obj/item/reagent_containers/food/snacks/plant/apple{
	pixel_x = -7;
	pixel_y = 14;
	rand_pos = 0
	},
/obj/item/reagent_containers/food/snacks/plant/grape{
	pixel_y = 14;
	rand_pos = 0
	},
/obj/item/reagent_containers/food/snacks/plant/grape/green{
	pixel_x = 9;
	pixel_y = 13;
	rand_pos = 0
	},
/obj/item/reagent_containers/food/snacks/plant/strawberry{
	pixel_x = 16;
	pixel_y = 12;
	rand_pos = 0
	},
/obj/item/reagent_containers/food/snacks/plant/banana{
	pixel_x = 16;
	pixel_y = 11;
	rand_pos = 0
	},
/turf/unsimulated/floor/carpet/regalcarpet,
/area/shuttle/escape/centcom)
"SP" = (
/turf/unsimulated/floor/marble/border_bw{
	dir = 10
	},
/area/shuttle/escape/centcom)
"TD" = (
/obj/decoration/regallamp{
	anchored = 1;
	lit = 1
	},
/turf/unsimulated/floor/marble/black,
/area/shuttle/escape/centcom)
"Ul" = (
/obj/table/regal/auto,
/obj/machinery/light/small/floor/netural,
/obj/item/reagent_containers/food/drinks/bottle/champagne{
	pixel_x = -7;
	pixel_y = 21;
	rand_pos = 0
	},
/obj/item/reagent_containers/food/drinks/drinkingglass/flute{
	pixel_x = -2;
	pixel_y = 10;
	rand_pos = 0
	},
/obj/item/reagent_containers/food/drinks/drinkingglass/flute{
	pixel_x = 3;
	pixel_y = 18;
	rand_pos = 0
	},
/obj/item/reagent_containers/food/drinks/drinkingglass/flute{
	pixel_x = 4;
	pixel_y = 8;
	rand_pos = 0
	},
/obj/item/reagent_containers/food/drinks/bottle/champagne{
	pixel_x = -4;
	pixel_y = 9;
	rand_pos = 0
	},
/obj/item/reagent_containers/food/snacks/donut/custom/frosted{
	pixel_x = 5;
	rand_pos = 0
	},
/turf/unsimulated/floor/carpet/regalcarpet,
/area/shuttle/escape/centcom)
"Vz" = (
/obj/stool/chair/comfy/throne_gold{
	anchored = 1;
	dir = 4
	},
/turf/unsimulated/floor/carpet/regalcarpet/border{
	dir = 1
	},
/area/shuttle/escape/centcom)
"VV" = (
/turf/unsimulated/floor/marble/border_wb{
	dir = 6
	},
/area/shuttle/escape/centcom)
"Wb" = (
/turf/unsimulated/floor/marble/border_bw{
	dir = 6
	},
/area/shuttle/escape/centcom)
"Wf" = (
/obj/indestructible/shuttle_corner{
	dir = 1
	},
/turf/unsimulated/outdoors/grass,
/area/shuttle/escape/centcom)
"WE" = (
/obj/shrub{
	dir = 10
	},
/turf/unsimulated/floor/carpet/regalcarpet/border{
	dir = 9
	},
/area/shuttle/escape/centcom)
"Xa" = (
/turf/unsimulated/floor/marble/border_bw{
	dir = 9
	},
/area/shuttle/escape/centcom)
"Xk" = (
/turf/simulated/wall/auto/shuttle{
	icon_state = "13"
	},
/area/shuttle/escape/centcom)
"XU" = (
/obj/machinery/shuttle/engine/heater{
	dir = 4;
	icon_state = "alt_heater-R"
	},
/turf/unsimulated/floor/plating,
/area/shuttle/escape/centcom)
"Yz" = (
/turf/unsimulated/floor/stairs{
	dir = 1
	},
/area/centcom)
"YA" = (
/turf/unsimulated/floor/stairs,
/area/centcom)
"YJ" = (
/obj/table/regal/auto,
/obj/machinery/light/small/floor/netural,
/obj/item/reagent_containers/food/drinks/bottle/wine{
	pixel_x = -7;
	pixel_y = 19;
	rand_pos = 0
	},
/obj/item/reagent_containers/food/drinks/bottle/wine{
	pixel_x = -3;
	pixel_y = 7;
	rand_pos = 0
	},
/obj/item/reagent_containers/food/drinks/drinkingglass/wine{
	pixel_x = 4;
	pixel_y = 18;
	rand_pos = 0
	},
/obj/item/reagent_containers/food/drinks/drinkingglass/wine{
	pixel_x = 9;
	pixel_y = 14;
	rand_pos = 0
	},
/obj/item/reagent_containers/food/drinks/drinkingglass/wine{
	pixel_x = 5;
	pixel_y = 11;
	rand_pos = 0
	},
/obj/item/reagent_containers/food/snacks/donut/custom/frosted{
	pixel_x = 6;
	rand_pos = 0
	},
/turf/unsimulated/floor/carpet/regalcarpet,
/area/shuttle/escape/centcom)

(1,1,1) = {"
Od
Od
Od
Od
Gd
ed
Gd
Od
Od
Od
Od
"}
(2,1,1) = {"
Od
Od
Od
NM
qS
qS
qS
LM
Od
Od
Od
"}
(3,1,1) = {"
Od
Od
NM
CD
WE
JS
bj
HZ
LM
Od
Od
"}
(4,1,1) = {"
Od
Od
vY
DO
JD
bz
rL
gm
vY
Od
Od
"}
(5,1,1) = {"
Od
NM
Xk
Vz
rA
La
rA
nC
Pz
LM
Od
"}
(6,1,1) = {"
Od
Pz
CD
iJ
xK
La
yI
GD
HZ
Xk
Od
"}
(7,1,1) = {"
Io
cr
TD
Ns
iJ
wY
GD
zo
TD
Pz
gI
"}
(8,1,1) = {"
YA
xS
VV
DA
DA
Dw
DA
DA
MG
xS
Yz
"}
(9,1,1) = {"
Io
Xk
fM
Xa
Dw
DA
Dw
SP
dg
Pz
gI
"}
(10,1,1) = {"
Od
yN
Ck
tG
kU
in
HO
aI
ph
yN
Od
"}
(11,1,1) = {"
Od
yN
Bm
tG
QK
Ul
xV
aI
wL
yN
Od
"}
(12,1,1) = {"
Io
Xk
ou
Xa
QK
RH
xV
SP
rU
Pz
gI
"}
(13,1,1) = {"
YA
xS
pP
PK
QK
Sw
xV
Wb
pP
xS
Yz
"}
(14,1,1) = {"
Io
Xk
Ck
tG
QK
YJ
xV
aI
ph
Pz
gI
"}
(15,1,1) = {"
NM
dh
Em
tG
iJ
FS
GD
aI
zP
Pz
LM
"}
(16,1,1) = {"
Gb
vY
OL
PK
DA
Dw
DA
Wb
kK
vY
Gb
"}
(17,1,1) = {"
HV
vY
HA
lk
cL
zl
sy
NH
ty
vY
HV
"}
(18,1,1) = {"
Od
Wf
xR
ri
oU
LG
XU
jA
bW
oL
Od
"}
(19,1,1) = {"
Od
If
HV
HV
HV
If
HV
HV
HV
If
Od
"}
