//MAP CONVERTED BY dmm2tgm.py THIS HEADER COMMENT PREVENTS RECONVERSION, DO NOT REMOVE
"a" = (
/turf/space/shuttle_transit,
/area/area_that_kills_you_if_you_enter_it)
"j" = (
/turf/space/shuttle_transit,
/area/shuttle_particle_spawn/west)
"C" = (
/obj/landmark/escape_pod_succ/east,
/turf/space/shuttle_transit,
/area/shuttle_transit_space/west)
"W" = (
/turf/space/shuttle_transit,
/area/shuttle_transit_space/west)
"Y" = (
/turf/space/shuttle_transit,
/area/shuttle/escape/transit)

(1,1,1) = {"
a
a
a
a
a
a
a
a
a
a
a
a
a
a
a
a
a
a
a
a
a
a
a
a
a
a
a
a
a
a
"}
(2,1,1) = {"
a
W
W
W
W
W
W
W
W
W
W
W
W
W
W
W
W
W
W
W
W
W
W
W
W
W
W
W
W
a
"}
(3,1,1) = {"
a
W
W
W
W
W
W
W
W
W
W
W
W
W
W
W
W
W
W
W
W
W
W
W
W
W
W
W
W
a
"}
(4,1,1) = {"
a
W
W
W
W
W
W
W
W
W
W
W
W
W
W
W
W
W
W
W
W
W
W
W
W
W
W
W
W
a
"}
(5,1,1) = {"
a
W
W
W
W
W
W
W
W
W
W
W
W
W
W
W
W
W
W
W
W
W
W
W
W
W
W
W
W
a
"}
(6,1,1) = {"
a
W
W
W
W
W
C
W
W
W
W
W
W
W
W
W
W
W
W
W
W
W
W
W
C
W
W
W
W
a
"}
(7,1,1) = {"
a
W
W
W
W
W
W
W
W
W
W
Y
Y
Y
W
W
W
Y
Y
Y
W
W
W
W
W
W
W
W
W
a
"}
(8,1,1) = {"
a
W
W
W
W
W
W
W
Y
Y
Y
Y
Y
Y
Y
Y
Y
Y
Y
Y
Y
Y
Y
W
W
W
W
W
W
a
"}
(9,1,1) = {"
a
W
W
W
W
W
W
W
Y
Y
Y
Y
Y
Y
Y
Y
Y
Y
Y
Y
Y
Y
Y
W
W
W
W
W
W
a
"}
(10,1,1) = {"
a
W
W
W
W
W
W
W
Y
Y
Y
Y
Y
Y
Y
Y
Y
Y
Y
Y
Y
Y
Y
W
W
W
W
W
W
a
"}
(11,1,1) = {"
a
W
W
W
W
W
W
W
Y
Y
Y
Y
Y
Y
Y
Y
Y
Y
Y
Y
Y
Y
Y
W
W
W
W
W
W
a
"}
(12,1,1) = {"
a
W
W
W
W
W
W
W
Y
Y
Y
Y
Y
Y
Y
Y
Y
Y
Y
Y
Y
Y
Y
W
W
W
W
W
W
a
"}
(13,1,1) = {"
a
W
W
W
W
W
W
W
Y
Y
Y
Y
Y
Y
Y
Y
Y
Y
Y
Y
Y
Y
Y
W
W
W
W
W
W
a
"}
(14,1,1) = {"
a
W
W
W
W
W
W
W
Y
Y
Y
Y
Y
Y
Y
Y
Y
Y
Y
Y
Y
Y
Y
W
W
W
W
W
W
a
"}
(15,1,1) = {"
a
W
W
W
W
W
W
W
Y
Y
Y
Y
Y
Y
Y
Y
Y
Y
Y
Y
Y
Y
Y
W
W
W
W
W
W
a
"}
(16,1,1) = {"
a
W
W
W
W
W
W
W
Y
Y
Y
Y
Y
Y
Y
Y
Y
Y
Y
Y
Y
Y
Y
W
W
W
W
W
W
a
"}
(17,1,1) = {"
a
W
W
W
W
W
W
W
Y
Y
Y
Y
Y
Y
Y
Y
Y
Y
Y
Y
Y
Y
Y
W
W
W
W
W
W
a
"}
(18,1,1) = {"
a
W
W
W
W
W
W
W
Y
Y
Y
Y
Y
Y
Y
Y
Y
Y
Y
Y
Y
Y
Y
W
W
W
W
W
W
a
"}
(19,1,1) = {"
a
W
W
W
W
W
W
W
Y
Y
Y
Y
Y
Y
Y
Y
Y
Y
Y
Y
Y
Y
Y
W
W
W
W
W
W
a
"}
(20,1,1) = {"
a
W
W
W
W
W
W
W
Y
Y
Y
Y
Y
Y
Y
Y
Y
Y
Y
Y
Y
Y
Y
W
W
W
W
W
W
a
"}
(21,1,1) = {"
a
W
W
W
W
W
W
W
Y
Y
Y
Y
Y
Y
Y
Y
Y
Y
Y
Y
Y
Y
Y
W
W
W
W
W
W
a
"}
(22,1,1) = {"
a
W
W
W
W
W
W
W
W
Y
Y
Y
Y
Y
Y
Y
Y
Y
Y
Y
Y
Y
W
W
W
W
W
W
W
a
"}
(23,1,1) = {"
a
W
W
W
W
W
W
W
W
Y
Y
Y
Y
Y
Y
Y
Y
Y
Y
Y
Y
Y
W
W
W
W
W
W
W
a
"}
(24,1,1) = {"
a
W
W
W
W
W
W
W
W
W
W
W
W
W
W
j
W
W
W
W
W
W
W
W
W
W
W
W
W
a
"}
(25,1,1) = {"
a
W
W
W
W
W
W
W
W
W
W
W
W
W
W
j
W
W
W
W
W
W
W
W
W
W
W
W
W
a
"}
(26,1,1) = {"
a
W
W
W
W
W
W
W
W
W
W
W
W
W
W
W
W
W
W
W
W
W
W
W
W
W
W
W
W
a
"}
(27,1,1) = {"
a
W
W
W
W
W
W
W
W
W
W
W
W
W
W
W
W
W
W
W
W
W
W
W
W
W
W
W
W
a
"}
(28,1,1) = {"
a
W
W
W
W
W
W
W
W
W
W
W
W
W
W
W
W
W
W
W
W
W
W
W
W
W
W
W
W
a
"}
(29,1,1) = {"
a
W
W
W
W
W
W
W
W
W
W
W
W
W
W
W
W
W
W
W
W
W
W
W
W
W
W
W
W
a
"}
(30,1,1) = {"
a
a
a
a
a
a
a
a
a
a
a
a
a
a
a
a
a
a
a
a
a
a
a
a
a
a
a
a
a
a
"}
