"a" = (/turf/variableTurf/floor,/area)
"b" = (/obj/item/raw_material/scrap_metal,/turf/variableTurf/floor,/area)
"c" = (/turf/space/fluid/warp_z5/polarishole/edge,/area/crashsite)
"d" = (/obj/decal/cleanable/machine_debris{icon_state = "gib7"},/turf/variableTurf/floor,/area)
"e" = (/obj/item/scrap,/turf/variableTurf/floor,/area)
"f" = (/obj/decal/cleanable/machine_debris,/turf/variableTurf/floor,/area)
"g" = (/obj/item/raw_material/shard/glass,/turf/variableTurf/floor,/area)
"h" = (/obj/map/light/cyan,/turf/space/fluid/warp_z5/polarishole/edge,/area/crashsite)
"i" = (/turf/space/fluid/warp_z5/polarishole,/area/crashsite)
"j" = (/obj/map/light/cyan,/turf/space/fluid/warp_z5/polarishole,/area/crashsite)
"k" = (/obj/ladder{id = "polaris"; layer = 2; pixel_y = 18},/turf/variableTurf/floor,/area/crashsite)

(1,1,1) = {"
aabadaaeaf
abaaaaagba
aaachcaaaa
agciiicaeg
eajijiihaa
aaiiiijiaa
aaijiiiaga
adaijkagaa
aaaaafaafe
aaagaaaaaa
"}
