//MAP CONVERTED BY dmm2tgm.py THIS HEADER COMMENT PREVENTS RECONVERSION, DO NOT REMOVE
"aa" = (
/turf/unsimulated/wall/void,
/area)
"ab" = (
/turf/background_canvas,
/area)
"bl" = (
/obj/stool/chair,
/turf/simulated/floor/blue/checker,
/area)
"bt" = (
/obj/table/auto,
/obj/item/storage/box/cutlery,
/obj/item/storage/box/plates,
/turf/simulated/floor/blue/checker,
/area)
"cG" = (
/obj/table/wood/auto,
/turf/simulated/floor/carpet{
	dir = 6;
	icon_state = "fblue3"
	},
/area/ship/arjuna)
"cM" = (
/obj/machinery/vending/cola/blue,
/turf/simulated/floor/carpet{
	dir = 6;
	icon_state = "green2"
	},
/area/ship/arjuna)
"cV" = (
/turf/simulated/floor/carpet{
	dir = 8;
	icon_state = "green2"
	},
/area/ship/arjuna)
"dq" = (
/obj/machinery/door/airlock/gannets/engineering/alt,
/turf/simulated/floor/black,
/area/ship/arjuna)
"dv" = (
/obj/stool/chair/office/blue{
	dir = 1;
	icon_state = "office_chair_blue"
	},
/turf/simulated/floor/carpet{
	dir = 1;
	icon_state = "fblue2"
	},
/area/ship/arjuna)
"dz" = (
/obj/stool/chair/office{
	dir = 1;
	icon_state = "office_chair"
	},
/turf/simulated/floor/specialroom/medbay,
/area/ship/arjuna)
"dV" = (
/turf/unsimulated/wall/setpieces/leadwindow/gray{
	dir = 8;
	icon_state = "leadwindow_gray_1"
	},
/area/ship/arjuna)
"em" = (
/obj/machinery/bathtub{
	anchored = 1;
	dir = 4
	},
/turf/simulated/floor/purple,
/area/ship/arjuna)
"er" = (
/turf/simulated/floor/carpet{
	dir = 5;
	icon_state = "red2"
	},
/area/ship/arjuna)
"eu" = (
/turf/simulated/floor/carpet{
	dir = 9;
	icon_state = "fblue2"
	},
/area/ship/arjuna)
"eM" = (
/turf/simulated/floor/carpet{
	dir = 1;
	icon_state = "green2"
	},
/area/ship/arjuna)
"eZ" = (
/turf/simulated/floor/carpet{
	dir = 4;
	icon_state = "red2"
	},
/area/ship/arjuna)
"fQ" = (
/obj/submachine/laundry_machine,
/turf/simulated/floor/purple,
/area/ship/arjuna)
"gh" = (
/obj/stool/chair/couch/red{
	dir = 8;
	icon_state = "chair_couch-red"
	},
/turf/simulated/floor/carpet{
	dir = 9;
	icon_state = "red2"
	},
/area/ship/arjuna)
"gl" = (
/turf/simulated/floor/carpet{
	dir = 2;
	icon_state = "fblue2"
	},
/area/ship/arjuna)
"gY" = (
/obj/machinery/clone_scanner,
/obj/machinery/power/data_terminal,
/turf/simulated/floor/bluegreen,
/area/ship/arjuna)
"hl" = (
/obj/machinery/vending/coffee,
/turf/simulated/floor/carpet{
	dir = 10;
	icon_state = "green2"
	},
/area/ship/arjuna)
"hC" = (
/obj/submachine/chef_sink/chem_sink{
	dir = 4;
	pixel_x = -8
	},
/turf/simulated/floor/blue/checker,
/area/ship/arjuna)
"iq" = (
/obj/machinery/computer/announcement,
/obj/machinery/power/data_terminal,
/turf/simulated/floor/carpet{
	dir = 4;
	icon_state = "fblue4"
	},
/area/ship/arjuna)
"ja" = (
/turf/simulated/floor/carpet{
	dir = 5;
	icon_state = "fblue2"
	},
/area/ship/arjuna)
"ji" = (
/obj/machinery/networked/mainframe,
/obj/machinery/power/data_terminal,
/turf/simulated/floor/circuit/off,
/area/ship/arjuna)
"jA" = (
/obj/machinery/sim/vr_bed/flight_chair{
	stars_id = "arjuna"
	},
/turf/simulated/floor/carpet{
	dir = 10;
	icon_state = "fblue1"
	},
/area/ship/arjuna)
"jD" = (
/obj/table/auto,
/obj/item/storage/box/iv_box,
/obj/item/storage/box/patchbox,
/obj/item/kitchen/food_box/lollipop,
/turf/simulated/floor/specialroom/medbay,
/area/ship/arjuna)
"kK" = (
/obj/machinery/vending/snack,
/turf/simulated/floor/blue/checker,
/area/ship/arjuna)
"kX" = (
/obj/machinery/vending/cola/red,
/turf/simulated/floor/carpet{
	dir = 10;
	icon_state = "red2"
	},
/area/ship/arjuna)
"lh" = (
/obj/machinery/clonepod,
/obj/machinery/power/data_terminal,
/turf/simulated/floor/bluegreen,
/area/ship/arjuna)
"ll" = (
/obj/machinery/door/airlock/gannets/chemistry,
/turf/simulated/floor/black,
/area/ship/arjuna)
"lv" = (
/obj/machinery/power/smes,
/turf/simulated/floor/engine,
/area/ship/arjuna)
"mp" = (
/obj/machinery/computer/cloning{
	dir = 8;
	icon_state = "dna"
	},
/obj/machinery/power/data_terminal,
/turf/simulated/floor/bluegreen,
/area/ship/arjuna)
"mq" = (
/obj/stool/chair/couch/green{
	dir = 8;
	icon_state = "chair_couch-green"
	},
/turf/simulated/floor/carpet{
	dir = 9;
	icon_state = "green2"
	},
/area/ship/arjuna)
"op" = (
/turf/simulated/floor/carpet{
	dir = 10;
	icon_state = "fblue2"
	},
/area/ship/arjuna)
"pa" = (
/obj/storage/closet/fire,
/turf/simulated/floor/engine,
/area/ship/arjuna)
"qt" = (
/turf/simulated/floor/carpet{
	dir = 9;
	icon_state = "green3"
	},
/area/ship/arjuna)
"qD" = (
/obj/table/auto,
/obj/submachine/mixer,
/turf/simulated/floor/blue/checker,
/area/ship/arjuna)
"rc" = (
/obj/machinery/door/airlock/gannets/glass/medical,
/turf/simulated/floor/bluegreen,
/area/ship/arjuna)
"rx" = (
/obj/storage/secure/closet/research/chemical,
/turf/simulated/floor/specialroom/medbay,
/area/ship/arjuna)
"si" = (
/turf/simulated/floor/circuit/off,
/area/ship/arjuna)
"sv" = (
/obj/table/auto,
/obj/item/storage/box/beakerbox,
/turf/simulated/floor/specialroom/medbay,
/area/ship/arjuna)
"sI" = (
/obj/machinery/door/airlock/gannets/glass/security,
/turf/simulated/floor/black,
/area/ship/arjuna)
"sX" = (
/turf/simulated/floor/carpet{
	dir = 6;
	icon_state = "fblue2"
	},
/area/ship/arjuna)
"tb" = (
/turf/simulated/floor/carpet{
	dir = 1;
	icon_state = "red2"
	},
/area/ship/arjuna)
"tU" = (
/obj/stool/bed,
/obj/item/clothing/suit/bedsheet{
	bcolor = "red";
	icon_state = "bedsheet-red"
	},
/turf/simulated/floor/carpet{
	dir = 2;
	icon_state = "red2"
	},
/area/ship/arjuna)
"uo" = (
/obj/storage/secure/closet/fridge,
/turf/simulated/floor/blue/checker,
/area/ship/arjuna)
"uB" = (
/obj/stool/chair/office{
	dir = 4;
	icon_state = "office_chair"
	},
/turf/simulated/floor/bluegreen,
/area/ship/arjuna)
"vc" = (
/obj/machinery/vending/kitchen,
/turf/simulated/floor/blue/checker,
/area/ship/arjuna)
"vq" = (
/turf/simulated/floor/black,
/area/ship/arjuna)
"vF" = (
/turf/simulated/floor/carpet{
	dir = 6;
	icon_state = "green3"
	},
/area/ship/arjuna)
"wi" = (
/obj/table/wood/auto,
/turf/simulated/floor/carpet{
	dir = 5;
	icon_state = "fblue3"
	},
/area/ship/arjuna)
"wD" = (
/obj/machinery/vending/cigarette,
/turf/simulated/floor/carpet{
	dir = 6;
	icon_state = "red2"
	},
/area/ship/arjuna)
"wH" = (
/turf/simulated/floor/specialroom/medbay,
/area/ship/arjuna)
"wM" = (
/obj/machinery/door/airlock/gannets/glass,
/turf/simulated/floor/blue/checker,
/area/ship/arjuna)
"xi" = (
/obj/machinery/optable,
/obj/item/surgical_spoon,
/obj/item/suture,
/obj/item/scalpel,
/obj/item/circular_saw,
/turf/simulated/floor/specialroom/medbay,
/area/ship/arjuna)
"xG" = (
/obj/stool/bed,
/obj/item/clothing/suit/bedsheet{
	bcolor = "red";
	icon_state = "bedsheet-red"
	},
/turf/simulated/floor/carpet{
	dir = 10;
	icon_state = "red2"
	},
/area/ship/arjuna)
"yF" = (
/obj/stool/chair/comfy/blue{
	dir = 4
	},
/turf/simulated/floor/carpet{
	dir = 8;
	icon_state = "fblue2"
	},
/area/ship/arjuna)
"zl" = (
/obj/machinery/door/airlock/gannets/command/alt,
/turf/simulated/floor/black,
/area/ship/arjuna)
"zv" = (
/obj/table/auto,
/obj/machinery/chem_dispenser/chemical,
/turf/simulated/floor/specialroom/medbay,
/area/ship/arjuna)
"Ak" = (
/obj/storage/closet/biohazard,
/obj/item/clothing/head/rad_hood,
/obj/item/clothing/suit/rad,
/turf/simulated/floor/engine,
/area/ship/arjuna)
"AA" = (
/obj/submachine/chef_oven{
	dir = 4;
	icon_state = "oven_off"
	},
/turf/simulated/floor/blue/checker,
/area/ship/arjuna)
"Bm" = (
/obj/machinery/vending/port_a_nanomed,
/turf/simulated/floor/specialroom/medbay,
/area/ship/arjuna)
"BH" = (
/obj/table/auto,
/obj/machinery/chem_heater,
/turf/simulated/floor/specialroom/medbay,
/area/ship/arjuna)
"Cl" = (
/obj/table/auto,
/obj/item/storage/box/syringes,
/obj/item/remote/porter/port_a_nanomed,
/turf/simulated/floor/specialroom/medbay,
/area/ship/arjuna)
"CZ" = (
/obj/landmark/ship_marker{
	ship_id = "arjuna"
	},
/turf/simulated/floor/black,
/area/ship/arjuna)
"Do" = (
/obj/table/wood/auto,
/turf/simulated/floor/carpet{
	dir = 10;
	icon_state = "fblue3"
	},
/area/ship/arjuna)
"DG" = (
/obj/table/auto,
/obj/machinery/chem_master,
/turf/simulated/floor/specialroom/medbay,
/area/ship/arjuna)
"Eb" = (
/turf/simulated/floor/purple,
/area/ship/arjuna)
"Ej" = (
/turf/simulated/floor/carpet{
	dir = 8;
	icon_state = "red2"
	},
/area/ship/arjuna)
"EI" = (
/obj/machinery/door/airlock/gannets/glass/medical,
/turf/simulated/floor/black,
/area/ship/arjuna)
"Ff" = (
/obj/storage/secure/closet/medical,
/turf/simulated/floor/specialroom/medbay,
/area/ship/arjuna)
"Fj" = (
/obj/stool/bed,
/obj/item/clothing/suit/bedsheet{
	bcolor = "green";
	icon_state = "bedsheet-green"
	},
/turf/simulated/floor/carpet{
	dir = 2;
	icon_state = "green2"
	},
/area/ship/arjuna)
"Hp" = (
/obj/machinery/door/airlock/gannets/glass/toxins,
/turf/simulated/floor/engine,
/area/ship/arjuna)
"IS" = (
/obj/stool/chair/couch/green{
	dir = 4;
	icon_state = "chair_couch-green"
	},
/turf/simulated/floor/carpet{
	dir = 5;
	icon_state = "green2"
	},
/area/ship/arjuna)
"Jt" = (
/obj/machinery/door/airlock/gannets/glass/command/alt,
/turf/simulated/floor/carpet{
	dir = 8;
	icon_state = "fblue4"
	},
/area/ship/arjuna)
"Jy" = (
/turf/simulated/floor/blue/checker,
/area/ship/arjuna)
"JP" = (
/turf/simulated/floor/carpet{
	dir = 4;
	icon_state = "green2"
	},
/area/ship/arjuna)
"Ko" = (
/obj/decal/fakeobjects/shuttlethruster,
/turf/space,
/area/ship/arjuna)
"Kp" = (
/obj/decal/fakeobjects/shuttlethruster,
/obj/decal/fakeobjects/shuttlethruster,
/turf/space,
/area/ship/arjuna)
"KX" = (
/turf/simulated/floor/bluegreen,
/area/ship/arjuna)
"Ml" = (
/obj/storage/secure/closet/engineering,
/turf/simulated/floor/engine,
/area/ship/arjuna)
"MW" = (
/turf/simulated/floor/engine,
/area/ship/arjuna)
"MZ" = (
/turf/unsimulated/wall/setpieces/leadwindow/gray,
/area/ship/arjuna)
"NW" = (
/obj/stool/bed,
/obj/item/clothing/suit/bedsheet{
	bcolor = "green";
	icon_state = "bedsheet-green"
	},
/turf/simulated/floor/carpet{
	dir = 6;
	icon_state = "green2"
	},
/area/ship/arjuna)
"Oe" = (
/obj/stool/chair{
	dir = 1;
	icon_state = "chair"
	},
/turf/simulated/floor/blue/checker,
/area/ship/arjuna)
"Oz" = (
/obj/stool/chair/comfy/blue{
	dir = 8
	},
/turf/simulated/floor/carpet{
	dir = 4;
	icon_state = "fblue2"
	},
/area/ship/arjuna)
"OA" = (
/obj/machinery/communications_dish,
/obj/machinery/power/data_terminal,
/turf/simulated/floor/circuit/off,
/area/ship/arjuna)
"OD" = (
/obj/machinery/door/airlock/gannets/glass,
/turf/simulated/floor/black,
/area/ship/arjuna)
"OU" = (
/obj/stool/chair/couch/red{
	dir = 4;
	icon_state = "chair_couch-red"
	},
/turf/simulated/floor/carpet{
	dir = 5;
	icon_state = "red2"
	},
/area/ship/arjuna)
"OW" = (
/obj/table/wood/auto,
/turf/simulated/floor/carpet{
	dir = 9;
	icon_state = "fblue3"
	},
/area/ship/arjuna)
"Pn" = (
/obj/machinery/door/airlock/gannets/glass/command/alt,
/turf/simulated/floor/carpet{
	dir = 4;
	icon_state = "fblue4"
	},
/area/ship/arjuna)
"PG" = (
/turf/simulated/floor/carpet{
	dir = 10;
	icon_state = "red3"
	},
/area/ship/arjuna)
"Qo" = (
/turf/simulated/floor/carpet{
	dir = 5;
	icon_state = "red3"
	},
/area/ship/arjuna)
"QU" = (
/turf/unsimulated/wall/auto/lead/gray{
	desc = "Seems pretty sturdy.";
	name = "shielded wall"
	},
/area/ship/arjuna)
"RF" = (
/obj/machinery/lrteleporter/planetary_teleporter{
	ship_id = "arjuna"
	},
/turf/simulated/floor/engine,
/area/ship/arjuna)
"RV" = (
/obj/machinery/door/airlock/gannets/chemistry,
/turf/simulated/floor/purple,
/area/ship/arjuna)
"SB" = (
/obj/machinery/power/rtg,
/turf/simulated/floor/engine,
/area/ship/arjuna)
"UA" = (
/turf/simulated/floor/stairs{
	dir = 1
	},
/area/ship/arjuna)
"Vg" = (
/obj/item/storage/toilet{
	dir = 4;
	icon_state = "toilet"
	},
/turf/simulated/floor/purple,
/area/ship/arjuna)
"VL" = (
/obj/machinery/clonegrinder,
/obj/machinery/power/data_terminal,
/turf/simulated/floor/bluegreen,
/area/ship/arjuna)
"WL" = (
/turf/simulated/floor/carpet{
	dir = 9;
	icon_state = "green2"
	},
/area/ship/arjuna)
"YT" = (
/obj/machinery/computer/communications,
/obj/machinery/power/data_terminal,
/turf/simulated/floor/carpet{
	dir = 8;
	icon_state = "fblue4"
	},
/area/ship/arjuna)

(1,1,1) = {"
aa
aa
aa
aa
aa
aa
aa
aa
aa
aa
aa
aa
aa
aa
aa
aa
aa
aa
aa
aa
aa
aa
aa
aa
aa
aa
aa
aa
aa
aa
aa
aa
aa
aa
aa
aa
aa
aa
aa
aa
aa
aa
aa
aa
aa
"}
(2,1,1) = {"
aa
ab
ab
ab
ab
ab
ab
ab
ab
ab
ab
ab
ab
ab
ab
ab
ab
ab
ab
ab
ab
ab
ab
ab
ab
ab
ab
ab
ab
ab
ab
ab
ab
ab
ab
ab
ab
ab
ab
ab
ab
ab
ab
ab
aa
"}
(3,1,1) = {"
aa
ab
ab
ab
ab
ab
ab
ab
ab
ab
ab
ab
ab
ab
ab
ab
ab
ab
ab
ab
ab
ab
ab
ab
ab
ab
ab
ab
ab
ab
ab
ab
ab
ab
ab
ab
ab
ab
ab
ab
ab
ab
ab
ab
aa
"}
(4,1,1) = {"
aa
ab
ab
ab
ab
ab
ab
ab
ab
ab
ab
ab
ab
ab
ab
ab
ab
ab
ab
ab
ab
ab
ab
ab
ab
ab
ab
ab
ab
ab
ab
ab
ab
ab
ab
ab
ab
ab
ab
ab
ab
ab
ab
ab
aa
"}
(5,1,1) = {"
aa
ab
ab
ab
ab
ab
ab
ab
ab
ab
ab
ab
ab
ab
ab
ab
ab
ab
ab
ab
ab
ab
ab
ab
ab
ab
ab
ab
ab
ab
ab
ab
ab
ab
ab
ab
ab
ab
ab
ab
ab
ab
ab
ab
aa
"}
(6,1,1) = {"
aa
ab
ab
ab
ab
ab
ab
ab
ab
ab
ab
ab
ab
ab
ab
ab
ab
ab
ab
ab
ab
ab
ab
ab
ab
ab
ab
ab
ab
ab
ab
ab
ab
ab
ab
ab
ab
ab
ab
ab
ab
ab
ab
ab
aa
"}
(7,1,1) = {"
aa
ab
ab
ab
ab
ab
ab
ab
ab
ab
ab
ab
ab
ab
ab
ab
ab
ab
ab
ab
ab
ab
ab
ab
ab
ab
ab
ab
ab
ab
ab
ab
ab
ab
ab
ab
ab
ab
ab
ab
ab
ab
ab
ab
aa
"}
(8,1,1) = {"
aa
ab
ab
ab
ab
ab
ab
ab
ab
ab
ab
ab
ab
ab
ab
ab
ab
ab
ab
ab
ab
ab
ab
ab
ab
ab
ab
ab
ab
ab
ab
ab
ab
ab
ab
ab
ab
ab
ab
ab
ab
ab
ab
ab
aa
"}
(9,1,1) = {"
aa
ab
ab
ab
ab
ab
ab
ab
ab
ab
ab
ab
ab
ab
ab
ab
ab
ab
ab
ab
ab
ab
ab
ab
ab
ab
ab
ab
ab
ab
ab
ab
ab
ab
ab
ab
ab
ab
ab
ab
ab
ab
ab
ab
aa
"}
(10,1,1) = {"
aa
ab
ab
ab
ab
ab
ab
ab
ab
ab
ab
ab
ab
ab
ab
ab
ab
ab
ab
ab
ab
ab
ab
ab
ab
ab
ab
ab
ab
ab
ab
ab
ab
ab
ab
ab
ab
ab
ab
ab
ab
ab
ab
ab
aa
"}
(11,1,1) = {"
aa
ab
ab
ab
ab
ab
ab
ab
ab
ab
ab
ab
ab
ab
ab
ab
ab
ab
ab
ab
ab
ab
ab
ab
ab
ab
ab
ab
ab
ab
ab
ab
ab
ab
ab
ab
ab
ab
ab
ab
ab
ab
ab
ab
aa
"}
(12,1,1) = {"
aa
ab
ab
ab
ab
ab
ab
ab
ab
ab
ab
ab
ab
ab
ab
ab
ab
ab
ab
ab
ab
ab
ab
ab
ab
ab
ab
ab
ab
ab
ab
ab
ab
ab
ab
ab
ab
ab
ab
ab
ab
ab
ab
ab
aa
"}
(13,1,1) = {"
aa
ab
ab
ab
ab
ab
ab
ab
ab
ab
ab
ab
ab
ab
ab
ab
ab
ab
ab
ab
ab
ab
ab
ab
ab
ab
QU
MZ
MZ
QU
ab
ab
ab
ab
ab
ab
ab
ab
ab
ab
ab
ab
ab
ab
aa
"}
(14,1,1) = {"
aa
ab
ab
ab
ab
ab
ab
ab
ab
ab
ab
ab
ab
ab
ab
ab
ab
ab
ab
ab
ab
ab
ab
QU
MZ
QU
QU
em
Vg
QU
Ko
ab
ab
ab
ab
ab
ab
ab
ab
ab
ab
ab
ab
ab
aa
"}
(15,1,1) = {"
aa
ab
ab
ab
ab
ab
ab
ab
ab
ab
ab
ab
ab
ab
ab
ab
ab
ab
ab
ab
ab
QU
MZ
QU
vq
vq
ll
Eb
Eb
QU
Ko
ab
ab
ab
ab
ab
ab
ab
ab
ab
ab
ab
ab
ab
aa
"}
(16,1,1) = {"
aa
ab
ab
ab
ab
ab
ab
ab
ab
ab
ab
ab
ab
ab
ab
ab
ab
ab
ab
QU
MZ
QU
vq
vq
vq
QU
QU
fQ
Eb
QU
Ko
ab
ab
ab
ab
ab
ab
ab
ab
ab
ab
ab
ab
ab
aa
"}
(17,1,1) = {"
aa
ab
ab
ab
ab
ab
ab
ab
ab
ab
ab
ab
ab
ab
ab
ab
ab
ab
QU
QU
vq
vq
vq
QU
QU
QU
QU
QU
RV
QU
QU
ab
ab
ab
ab
ab
ab
ab
ab
ab
ab
ab
ab
ab
aa
"}
(18,1,1) = {"
aa
ab
ab
ab
ab
ab
ab
ab
ab
ab
ab
ab
ab
ab
ab
ab
ab
QU
QU
vq
vq
QU
QU
QU
rx
Ff
QU
gh
Ej
xG
dV
ab
ab
ab
ab
ab
ab
ab
ab
ab
ab
ab
ab
ab
aa
"}
(19,1,1) = {"
aa
ab
ab
ab
ab
ab
ab
ab
ab
ab
ab
ab
ab
ab
ab
ab
QU
QU
vq
vq
QU
QU
QU
Bm
wH
xi
QU
OU
Qo
tU
dV
ab
ab
ab
ab
ab
ab
ab
ab
ab
ab
ab
ab
ab
aa
"}
(20,1,1) = {"
aa
ab
ab
ab
ab
ab
ab
ab
ab
ab
ab
ab
ab
ab
ab
QU
QU
vq
vq
QU
QU
KX
rc
wH
wH
wH
QU
QU
tb
tU
QU
QU
ab
ab
ab
ab
ab
ab
ab
ab
ab
ab
ab
ab
aa
"}
(21,1,1) = {"
aa
ab
ab
ab
ab
ab
ab
ab
ab
ab
ab
ab
QU
MZ
QU
QU
vq
vq
QU
QU
KX
KX
QU
DG
wH
wH
jD
QU
tb
PG
kX
dV
ab
ab
ab
ab
ab
ab
ab
ab
ab
ab
ab
ab
aa
"}
(22,1,1) = {"
aa
ab
ab
ab
ab
ab
ab
ab
ab
ab
ab
QU
QU
RF
MW
Hp
vq
QU
QU
KX
uB
KX
QU
zv
dz
wH
Cl
QU
er
eZ
wD
QU
MZ
QU
QU
ab
ab
ab
ab
ab
ab
ab
ab
ab
aa
"}
(23,1,1) = {"
aa
ab
ab
ab
ab
ab
ab
ab
ab
ab
QU
QU
QU
MZ
QU
QU
vq
QU
VL
lh
mp
gY
QU
BH
wH
wH
sv
QU
sI
QU
QU
QU
pa
Ml
QU
Ko
ab
ab
ab
ab
ab
ab
ab
ab
aa
"}
(24,1,1) = {"
aa
ab
ab
ab
ab
ab
ab
ab
ab
QU
QU
eu
yF
yF
op
QU
vq
QU
QU
QU
MZ
QU
QU
QU
MZ
EI
QU
QU
vq
vq
QU
SB
MW
MW
QU
Ko
ab
ab
ab
ab
ab
ab
ab
ab
aa
"}
(25,1,1) = {"
aa
ab
ab
ab
ab
ab
ab
ab
ab
dV
YT
dv
cG
wi
gl
Jt
vq
vq
vq
vq
vq
vq
vq
vq
vq
vq
vq
vq
vq
vq
dq
UA
MW
lv
QU
Ko
ab
ab
ab
ab
ab
ab
ab
ab
aa
"}
(26,1,1) = {"
aa
ab
ab
ab
ab
ab
ab
ab
ab
dV
jA
dv
Do
OW
gl
Pn
vq
vq
vq
vq
vq
vq
CZ
vq
vq
vq
vq
vq
vq
vq
dq
UA
MW
lv
QU
Ko
ab
ab
ab
ab
ab
ab
ab
ab
aa
"}
(27,1,1) = {"
aa
ab
ab
ab
ab
ab
ab
ab
ab
dV
iq
dv
Do
OW
gl
Pn
vq
vq
vq
vq
vq
vq
vq
vq
vq
vq
vq
vq
vq
vq
dq
UA
MW
lv
QU
Ko
ab
ab
ab
ab
ab
ab
ab
ab
aa
"}
(28,1,1) = {"
aa
ab
ab
ab
ab
ab
ab
ab
ab
QU
QU
ja
Oz
Oz
sX
QU
vq
vq
vq
vq
vq
vq
vq
QU
MZ
zl
QU
QU
vq
vq
QU
SB
MW
MW
QU
Kp
ab
ab
ab
ab
ab
ab
ab
ab
aa
"}
(29,1,1) = {"
aa
ab
ab
ab
ab
ab
ab
ab
ab
ab
QU
QU
QU
eu
op
QU
vq
vq
vq
vq
vq
vq
vq
QU
si
si
si
QU
OD
QU
QU
QU
Ak
Ml
QU
Ko
ab
ab
ab
ab
ab
ab
ab
ab
aa
"}
(30,1,1) = {"
aa
ab
ab
ab
ab
ab
ab
ab
ab
ab
ab
QU
QU
ja
sX
QU
vq
vq
vq
vq
vq
vq
vq
QU
OA
si
ji
QU
WL
cV
hl
QU
MZ
QU
QU
ab
ab
ab
ab
ab
ab
ab
ab
ab
aa
"}
(31,1,1) = {"
aa
ab
ab
ab
ab
ab
ab
ab
ab
ab
ab
ab
QU
MZ
QU
QU
vq
vq
vq
vq
vq
vq
vq
QU
QU
QU
QU
QU
eM
vF
cM
dV
ab
ab
ab
ab
ab
ab
ab
ab
ab
ab
ab
ab
aa
"}
(32,1,1) = {"
aa
ab
ab
ab
ab
ab
ab
ab
ab
ab
ab
ab
ab
ab
ab
QU
QU
vq
vq
vq
vq
vq
vq
vq
vq
vq
QU
QU
eM
Fj
QU
QU
ab
ab
ab
ab
ab
ab
ab
ab
ab
ab
ab
ab
aa
"}
(33,1,1) = {"
aa
ab
ab
ab
ab
ab
ab
ab
ab
ab
ab
ab
ab
ab
ab
ab
QU
QU
vq
vq
vq
vq
vq
vq
vq
vq
QU
mq
qt
Fj
dV
ab
ab
ab
ab
ab
ab
ab
ab
ab
ab
ab
ab
ab
aa
"}
(34,1,1) = {"
aa
ab
ab
ab
ab
ab
ab
ab
ab
ab
ab
ab
ab
ab
ab
ab
ab
QU
QU
vq
vq
QU
QU
QU
QU
QU
QU
IS
JP
NW
dV
ab
ab
ab
ab
ab
ab
ab
ab
ab
ab
ab
ab
ab
aa
"}
(35,1,1) = {"
aa
ab
ab
ab
ab
ab
ab
ab
ab
ab
ab
ab
ab
ab
ab
ab
ab
ab
QU
QU
vq
OD
Jy
hC
AA
vc
QU
QU
wM
QU
QU
ab
ab
ab
ab
ab
ab
ab
ab
ab
ab
ab
ab
ab
aa
"}
(36,1,1) = {"
aa
ab
ab
ab
ab
ab
ab
ab
ab
ab
ab
ab
ab
ab
ab
ab
ab
ab
ab
QU
MZ
QU
uo
Jy
Jy
Jy
Jy
Jy
Jy
QU
Ko
ab
ab
ab
ab
ab
ab
ab
ab
ab
ab
ab
ab
ab
aa
"}
(37,1,1) = {"
aa
ab
ab
ab
ab
ab
ab
ab
ab
ab
ab
ab
ab
ab
ab
ab
ab
ab
ab
ab
ab
QU
MZ
QU
bl
bt
Oe
Jy
Jy
QU
Ko
ab
ab
ab
ab
ab
ab
ab
ab
ab
ab
ab
ab
ab
aa
"}
(38,1,1) = {"
aa
ab
ab
ab
ab
ab
ab
ab
ab
ab
ab
ab
ab
ab
ab
ab
ab
ab
ab
ab
ab
ab
ab
QU
MZ
QU
QU
kK
qD
QU
Ko
ab
ab
ab
ab
ab
ab
ab
ab
ab
ab
ab
ab
ab
aa
"}
(39,1,1) = {"
aa
ab
ab
ab
ab
ab
ab
ab
ab
ab
ab
ab
ab
ab
ab
ab
ab
ab
ab
ab
ab
ab
ab
ab
ab
ab
QU
MZ
MZ
QU
ab
ab
ab
ab
ab
ab
ab
ab
ab
ab
ab
ab
ab
ab
aa
"}
(40,1,1) = {"
aa
ab
ab
ab
ab
ab
ab
ab
ab
ab
ab
ab
ab
ab
ab
ab
ab
ab
ab
ab
ab
ab
ab
ab
ab
ab
ab
ab
ab
ab
ab
ab
ab
ab
ab
ab
ab
ab
ab
ab
ab
ab
ab
ab
aa
"}
(41,1,1) = {"
aa
ab
ab
ab
ab
ab
ab
ab
ab
ab
ab
ab
ab
ab
ab
ab
ab
ab
ab
ab
ab
ab
ab
ab
ab
ab
ab
ab
ab
ab
ab
ab
ab
ab
ab
ab
ab
ab
ab
ab
ab
ab
ab
ab
aa
"}
(42,1,1) = {"
aa
ab
ab
ab
ab
ab
ab
ab
ab
ab
ab
ab
ab
ab
ab
ab
ab
ab
ab
ab
ab
ab
ab
ab
ab
ab
ab
ab
ab
ab
ab
ab
ab
ab
ab
ab
ab
ab
ab
ab
ab
ab
ab
ab
aa
"}
(43,1,1) = {"
aa
ab
ab
ab
ab
ab
ab
ab
ab
ab
ab
ab
ab
ab
ab
ab
ab
ab
ab
ab
ab
ab
ab
ab
ab
ab
ab
ab
ab
ab
ab
ab
ab
ab
ab
ab
ab
ab
ab
ab
ab
ab
ab
ab
aa
"}
(44,1,1) = {"
aa
ab
ab
ab
ab
ab
ab
ab
ab
ab
ab
ab
ab
ab
ab
ab
ab
ab
ab
ab
ab
ab
ab
ab
ab
ab
ab
ab
ab
ab
ab
ab
ab
ab
ab
ab
ab
ab
ab
ab
ab
ab
ab
ab
aa
"}
(45,1,1) = {"
aa
ab
ab
ab
ab
ab
ab
ab
ab
ab
ab
ab
ab
ab
ab
ab
ab
ab
ab
ab
ab
ab
ab
ab
ab
ab
ab
ab
ab
ab
ab
ab
ab
ab
ab
ab
ab
ab
ab
ab
ab
ab
ab
ab
aa
"}
(46,1,1) = {"
aa
ab
ab
ab
ab
ab
ab
ab
ab
ab
ab
ab
ab
ab
ab
ab
ab
ab
ab
ab
ab
ab
ab
ab
ab
ab
ab
ab
ab
ab
ab
ab
ab
ab
ab
ab
ab
ab
ab
ab
ab
ab
ab
ab
aa
"}
(47,1,1) = {"
aa
ab
ab
ab
ab
ab
ab
ab
ab
ab
ab
ab
ab
ab
ab
ab
ab
ab
ab
ab
ab
ab
ab
ab
ab
ab
ab
ab
ab
ab
ab
ab
ab
ab
ab
ab
ab
ab
ab
ab
ab
ab
ab
ab
aa
"}
(48,1,1) = {"
aa
ab
ab
ab
ab
ab
ab
ab
ab
ab
ab
ab
ab
ab
ab
ab
ab
ab
ab
ab
ab
ab
ab
ab
ab
ab
ab
ab
ab
ab
ab
ab
ab
ab
ab
ab
ab
ab
ab
ab
ab
ab
ab
ab
aa
"}
(49,1,1) = {"
aa
ab
ab
ab
ab
ab
ab
ab
ab
ab
ab
ab
ab
ab
ab
ab
ab
ab
ab
ab
ab
ab
ab
ab
ab
ab
ab
ab
ab
ab
ab
ab
ab
ab
ab
ab
ab
ab
ab
ab
ab
ab
ab
ab
aa
"}
(50,1,1) = {"
aa
ab
ab
ab
ab
ab
ab
ab
ab
ab
ab
ab
ab
ab
ab
ab
ab
ab
ab
ab
ab
ab
ab
ab
ab
ab
ab
ab
ab
ab
ab
ab
ab
ab
ab
ab
ab
ab
ab
ab
ab
ab
ab
ab
aa
"}
(51,1,1) = {"
aa
aa
aa
aa
aa
aa
aa
aa
aa
aa
aa
aa
aa
aa
aa
aa
aa
aa
aa
aa
aa
aa
aa
aa
aa
aa
aa
aa
aa
aa
aa
aa
aa
aa
aa
aa
aa
aa
aa
aa
aa
aa
aa
aa
aa
"}
