//MAP CONVERTED BY dmm2tgm.py THIS HEADER COMMENT PREVENTS RECONVERSION, DO NOT REMOVE
"aa" = (
/turf/unsimulated/wall/void,
/area)
"ab" = (
/turf/background_canvas,
/area)
"ad" = (
/turf/unsimulated/wall/setpieces/leadwindow/gray{
	dir = 8;
	icon_state = "leadwindow_gray_1"
	},
/area/ship/arjuna)
"ag" = (
/obj/machinery/computer/communications,
/obj/machinery/power/data_terminal,
/turf/simulated/floor/carpet{
	dir = 8;
	icon_state = "fblue4"
	},
/area/ship/arjuna)
"ah" = (
/obj/machinery/sim/vr_bed/flight_chair{
	stars_id = "arjuna"
	},
/turf/simulated/floor/carpet{
	dir = 10;
	icon_state = "fblue1"
	},
/area/ship/arjuna)
"ai" = (
/obj/machinery/computer/announcement,
/obj/machinery/power/data_terminal,
/turf/simulated/floor/carpet{
	dir = 4;
	icon_state = "fblue4"
	},
/area/ship/arjuna)
"aj" = (
/turf/unsimulated/wall/auto/lead/gray{
	desc = "Seems pretty sturdy.";
	name = "shielded wall"
	},
/area/ship/arjuna)
"al" = (
/turf/simulated/floor/carpet{
	dir = 9;
	icon_state = "fblue2"
	},
/area/ship/arjuna)
"am" = (
/obj/stool/chair/office/blue{
	dir = 1;
	icon_state = "office_chair_blue"
	},
/turf/simulated/floor/carpet{
	dir = 1;
	icon_state = "fblue2"
	},
/area/ship/arjuna)
"an" = (
/turf/simulated/floor/carpet{
	dir = 5;
	icon_state = "fblue2"
	},
/area/ship/arjuna)
"ao" = (
/obj/stool/chair/comfy/blue{
	dir = 4
	},
/turf/simulated/floor/carpet{
	dir = 8;
	icon_state = "fblue2"
	},
/area/ship/arjuna)
"ap" = (
/obj/table/wood/auto,
/turf/simulated/floor/carpet{
	dir = 6;
	icon_state = "fblue3"
	},
/area/ship/arjuna)
"aq" = (
/obj/table/wood/auto,
/turf/simulated/floor/carpet{
	dir = 10;
	icon_state = "fblue3"
	},
/area/ship/arjuna)
"ar" = (
/obj/stool/chair/comfy/blue{
	dir = 8
	},
/turf/simulated/floor/carpet{
	dir = 4;
	icon_state = "fblue2"
	},
/area/ship/arjuna)
"as" = (
/turf/unsimulated/wall/setpieces/leadwindow/gray,
/area/ship/arjuna)
"at" = (
/obj/lrteleporter/planetary_teleporter{
	ship_id = "arjuna"
	},
/turf/simulated/floor/engine,
/area/ship/arjuna)
"au" = (
/obj/table/wood/auto,
/turf/simulated/floor/carpet{
	dir = 5;
	icon_state = "fblue3"
	},
/area/ship/arjuna)
"av" = (
/obj/table/wood/auto,
/turf/simulated/floor/carpet{
	dir = 9;
	icon_state = "fblue3"
	},
/area/ship/arjuna)
"aw" = (
/turf/simulated/floor/engine,
/area/ship/arjuna)
"ax" = (
/turf/simulated/floor/carpet{
	dir = 10;
	icon_state = "fblue2"
	},
/area/ship/arjuna)
"ay" = (
/turf/simulated/floor/carpet{
	dir = 2;
	icon_state = "fblue2"
	},
/area/ship/arjuna)
"az" = (
/turf/simulated/floor/carpet{
	dir = 6;
	icon_state = "fblue2"
	},
/area/ship/arjuna)
"aA" = (
/obj/machinery/door/airlock/gannets/glass/toxins,
/turf/simulated/floor/engine,
/area/ship/arjuna)
"aC" = (
/obj/machinery/door/airlock/gannets/glass/command/alt,
/turf/simulated/floor/carpet{
	dir = 8;
	icon_state = "fblue4"
	},
/area/ship/arjuna)
"aD" = (
/obj/machinery/door/airlock/gannets/glass/command/alt,
/turf/simulated/floor/carpet{
	dir = 4;
	icon_state = "fblue4"
	},
/area/ship/arjuna)
"aE" = (
/turf/simulated/floor/black,
/area/ship/arjuna)
"aF" = (
/obj/machinery/clonegrinder,
/obj/machinery/power/data_terminal,
/turf/simulated/floor/bluegreen,
/area/ship/arjuna)
"aG" = (
/obj/landmark/ship_marker{
	ship_id = "arjuna"
	},
/turf/simulated/floor/black,
/area/ship/arjuna)
"aH" = (
/turf/simulated/floor/bluegreen,
/area/ship/arjuna)
"aI" = (
/obj/machinery/clonepod,
/obj/machinery/power/data_terminal,
/turf/simulated/floor/bluegreen,
/area/ship/arjuna)
"aL" = (
/obj/stool/chair/office{
	dir = 4;
	icon_state = "office_chair"
	},
/turf/simulated/floor/bluegreen,
/area/ship/arjuna)
"aM" = (
/obj/machinery/computer/cloning{
	dir = 8;
	icon_state = "dna"
	},
/obj/machinery/power/data_terminal,
/turf/simulated/floor/bluegreen,
/area/ship/arjuna)
"aP" = (
/obj/machinery/clone_scanner,
/obj/machinery/power/data_terminal,
/turf/simulated/floor/bluegreen,
/area/ship/arjuna)
"aS" = (
/obj/machinery/door/airlock/gannets/glass,
/turf/simulated/floor/black,
/area/ship/arjuna)
"aT" = (
/obj/machinery/door/airlock/gannets/glass/medical,
/turf/simulated/floor/bluegreen,
/area/ship/arjuna)
"aV" = (
/turf/simulated/floor/blue/checker,
/area/ship/arjuna)
"aW" = (
/obj/storage/secure/closet/fridge,
/turf/simulated/floor/blue/checker,
/area/ship/arjuna)
"aX" = (
/obj/machinery/vending/port_a_nanomed,
/turf/simulated/floor/specialroom/medbay,
/area/ship/arjuna)
"aY" = (
/turf/simulated/floor/specialroom/medbay,
/area/ship/arjuna)
"aZ" = (
/obj/table/auto,
/obj/machinery/chem_master,
/turf/simulated/floor/specialroom/medbay,
/area/ship/arjuna)
"ba" = (
/obj/table/auto,
/obj/machinery/chem_dispenser,
/turf/simulated/floor/specialroom/medbay,
/area/ship/arjuna)
"bb" = (
/obj/table/auto,
/obj/machinery/chem_heater,
/turf/simulated/floor/specialroom/medbay,
/area/ship/arjuna)
"be" = (
/obj/submachine/chef_sink/chem_sink{
	dir = 4;
	pixel_x = -8
	},
/turf/simulated/floor/blue/checker,
/area/ship/arjuna)
"bf" = (
/obj/storage/secure/closet/research/chemical,
/turf/simulated/floor/specialroom/medbay,
/area/ship/arjuna)
"bg" = (
/obj/stool/chair/office{
	dir = 1;
	icon_state = "office_chair"
	},
/turf/simulated/floor/specialroom/medbay,
/area/ship/arjuna)
"bh" = (
/turf/simulated/floor/circuit/off,
/area/ship/arjuna)
"bi" = (
/obj/machinery/communications_dish,
/obj/machinery/power/data_terminal,
/turf/simulated/floor/circuit/off,
/area/ship/arjuna)
"bk" = (
/obj/submachine/chef_oven{
	dir = 4;
	icon_state = "oven_off"
	},
/turf/simulated/floor/blue/checker,
/area/ship/arjuna)
"bl" = (
/obj/stool/chair,
/turf/simulated/floor/blue/checker,
/area)
"bm" = (
/obj/storage/secure/closet/medical,
/turf/simulated/floor/specialroom/medbay,
/area/ship/arjuna)
"bn" = (
/obj/machinery/optable,
/obj/item/surgical_spoon,
/obj/item/suture,
/obj/item/scalpel,
/obj/item/circular_saw,
/turf/simulated/floor/specialroom/medbay,
/area/ship/arjuna)
"bo" = (
/obj/machinery/door/airlock/gannets/glass/medical,
/turf/simulated/floor/black,
/area/ship/arjuna)
"bp" = (
/obj/machinery/door/airlock/gannets/command/alt,
/turf/simulated/floor/black,
/area/ship/arjuna)
"bs" = (
/obj/machinery/vending/kitchen,
/turf/simulated/floor/blue/checker,
/area/ship/arjuna)
"bt" = (
/obj/table/auto,
/obj/item/storage/box/cutlery,
/obj/item/storage/box/plates,
/turf/simulated/floor/blue/checker,
/area)
"bu" = (
/obj/machinery/door/airlock/gannets/chemistry,
/turf/simulated/floor/black,
/area/ship/arjuna)
"bv" = (
/obj/table/auto,
/obj/item/storage/box/iv_box,
/obj/item/storage/box/patchbox,
/obj/item/kitchen/food_box/lollipop,
/turf/simulated/floor/specialroom/medbay,
/area/ship/arjuna)
"bw" = (
/obj/table/auto,
/obj/item/storage/box/syringes,
/obj/item/remote/porter/port_a_nanomed,
/turf/simulated/floor/specialroom/medbay,
/area/ship/arjuna)
"bx" = (
/obj/table/auto,
/obj/item/storage/box/beakerbox,
/turf/simulated/floor/specialroom/medbay,
/area/ship/arjuna)
"by" = (
/obj/machinery/networked/mainframe,
/obj/machinery/power/data_terminal,
/turf/simulated/floor/circuit/off,
/area/ship/arjuna)
"bz" = (
/obj/stool/chair{
	dir = 1;
	icon_state = "chair"
	},
/turf/simulated/floor/blue/checker,
/area/ship/arjuna)
"bA" = (
/obj/machinery/bathtub{
	anchored = 1;
	dir = 4
	},
/turf/simulated/floor/purple,
/area/ship/arjuna)
"bB" = (
/turf/simulated/floor/purple,
/area/ship/arjuna)
"bC" = (
/obj/submachine/laundry_machine,
/turf/simulated/floor/purple,
/area/ship/arjuna)
"bD" = (
/obj/stool/chair/couch/red{
	dir = 8;
	icon_state = "chair_couch-red"
	},
/turf/simulated/floor/carpet{
	dir = 9;
	icon_state = "red2"
	},
/area/ship/arjuna)
"bE" = (
/obj/stool/chair/couch/red{
	dir = 4;
	icon_state = "chair_couch-red"
	},
/turf/simulated/floor/carpet{
	dir = 5;
	icon_state = "red2"
	},
/area/ship/arjuna)
"bF" = (
/obj/stool/chair/couch/green{
	dir = 8;
	icon_state = "chair_couch-green"
	},
/turf/simulated/floor/carpet{
	dir = 9;
	icon_state = "green2"
	},
/area/ship/arjuna)
"bG" = (
/obj/stool/chair/couch/green{
	dir = 4;
	icon_state = "chair_couch-green"
	},
/turf/simulated/floor/carpet{
	dir = 5;
	icon_state = "green2"
	},
/area/ship/arjuna)
"bH" = (
/obj/machinery/vending/snack,
/turf/simulated/floor/blue/checker,
/area/ship/arjuna)
"bI" = (
/obj/item/storage/toilet{
	dir = 4;
	icon_state = "toilet"
	},
/turf/simulated/floor/purple,
/area/ship/arjuna)
"bJ" = (
/obj/machinery/door/airlock/gannets/chemistry,
/turf/simulated/floor/purple,
/area/ship/arjuna)
"bK" = (
/turf/simulated/floor/carpet{
	dir = 8;
	icon_state = "red2"
	},
/area/ship/arjuna)
"bL" = (
/turf/simulated/floor/carpet{
	dir = 5;
	icon_state = "red3"
	},
/area/ship/arjuna)
"bM" = (
/turf/simulated/floor/carpet{
	dir = 1;
	icon_state = "red2"
	},
/area/ship/arjuna)
"bN" = (
/turf/simulated/floor/carpet{
	dir = 5;
	icon_state = "red2"
	},
/area/ship/arjuna)
"bO" = (
/obj/machinery/door/airlock/gannets/glass/security,
/turf/simulated/floor/black,
/area/ship/arjuna)
"bP" = (
/turf/simulated/floor/carpet{
	dir = 9;
	icon_state = "green2"
	},
/area/ship/arjuna)
"bQ" = (
/turf/simulated/floor/carpet{
	dir = 1;
	icon_state = "green2"
	},
/area/ship/arjuna)
"bR" = (
/turf/simulated/floor/carpet{
	dir = 9;
	icon_state = "green3"
	},
/area/ship/arjuna)
"bS" = (
/turf/simulated/floor/carpet{
	dir = 4;
	icon_state = "green2"
	},
/area/ship/arjuna)
"bT" = (
/obj/machinery/door/airlock/gannets/glass,
/turf/simulated/floor/blue/checker,
/area/ship/arjuna)
"bU" = (
/obj/table/auto,
/obj/submachine/mixer,
/turf/simulated/floor/blue/checker,
/area/ship/arjuna)
"bV" = (
/obj/stool/bed,
/obj/item/clothing/suit/bedsheet{
	bcolor = "red";
	icon_state = "bedsheet-red"
	},
/turf/simulated/floor/carpet{
	dir = 10;
	icon_state = "red2"
	},
/area/ship/arjuna)
"bW" = (
/obj/stool/bed,
/obj/item/clothing/suit/bedsheet{
	bcolor = "red";
	icon_state = "bedsheet-red"
	},
/turf/simulated/floor/carpet{
	dir = 2;
	icon_state = "red2"
	},
/area/ship/arjuna)
"bX" = (
/turf/simulated/floor/carpet{
	dir = 10;
	icon_state = "red3"
	},
/area/ship/arjuna)
"bY" = (
/turf/simulated/floor/carpet{
	dir = 4;
	icon_state = "red2"
	},
/area/ship/arjuna)
"bZ" = (
/turf/simulated/floor/carpet{
	dir = 8;
	icon_state = "green2"
	},
/area/ship/arjuna)
"ca" = (
/turf/simulated/floor/carpet{
	dir = 6;
	icon_state = "green3"
	},
/area/ship/arjuna)
"cb" = (
/obj/stool/bed,
/obj/item/clothing/suit/bedsheet{
	bcolor = "green";
	icon_state = "bedsheet-green"
	},
/turf/simulated/floor/carpet{
	dir = 2;
	icon_state = "green2"
	},
/area/ship/arjuna)
"cc" = (
/obj/stool/bed,
/obj/item/clothing/suit/bedsheet{
	bcolor = "green";
	icon_state = "bedsheet-green"
	},
/turf/simulated/floor/carpet{
	dir = 6;
	icon_state = "green2"
	},
/area/ship/arjuna)
"cd" = (
/obj/decal/fakeobjects/shuttlethruster,
/turf/space,
/area/ship/arjuna)
"cf" = (
/obj/machinery/vending/cola/red,
/turf/simulated/floor/carpet{
	dir = 10;
	icon_state = "red2"
	},
/area/ship/arjuna)
"cg" = (
/obj/machinery/vending/cigarette,
/turf/simulated/floor/carpet{
	dir = 6;
	icon_state = "red2"
	},
/area/ship/arjuna)
"ch" = (
/obj/machinery/door/airlock/gannets/engineering/alt,
/turf/simulated/floor/black,
/area/ship/arjuna)
"ci" = (
/obj/machinery/vending/coffee,
/turf/simulated/floor/carpet{
	dir = 10;
	icon_state = "green2"
	},
/area/ship/arjuna)
"cj" = (
/obj/machinery/vending/cola/blue,
/turf/simulated/floor/carpet{
	dir = 6;
	icon_state = "green2"
	},
/area/ship/arjuna)
"ck" = (
/obj/machinery/power/rtg,
/turf/simulated/floor/engine,
/area/ship/arjuna)
"cl" = (
/turf/simulated/floor/stairs{
	dir = 1
	},
/area/ship/arjuna)
"cm" = (
/obj/storage/closet/fire,
/turf/simulated/floor/engine,
/area/ship/arjuna)
"cn" = (
/obj/storage/closet/biohazard,
/obj/item/clothing/head/rad_hood,
/obj/item/clothing/suit/rad,
/turf/simulated/floor/engine,
/area/ship/arjuna)
"co" = (
/obj/storage/secure/closet/engineering,
/turf/simulated/floor/engine,
/area/ship/arjuna)
"cp" = (
/obj/machinery/power/smes,
/turf/simulated/floor/engine,
/area/ship/arjuna)
"cq" = (
/obj/decal/fakeobjects/shuttlethruster,
/obj/decal/fakeobjects/shuttlethruster,
/turf/space,
/area/ship/arjuna)

(1,1,1) = {"
aa
aa
aa
aa
aa
aa
aa
aa
aa
aa
aa
aa
aa
aa
aa
aa
aa
aa
aa
aa
aa
aa
aa
aa
aa
aa
aa
aa
aa
aa
aa
aa
aa
aa
aa
aa
aa
aa
aa
aa
aa
aa
aa
aa
aa
"}
(2,1,1) = {"
aa
ab
ab
ab
ab
ab
ab
ab
ab
ab
ab
ab
ab
ab
ab
ab
ab
ab
ab
ab
ab
ab
ab
ab
ab
ab
ab
ab
ab
ab
ab
ab
ab
ab
ab
ab
ab
ab
ab
ab
ab
ab
ab
ab
aa
"}
(3,1,1) = {"
aa
ab
ab
ab
ab
ab
ab
ab
ab
ab
ab
ab
ab
ab
ab
ab
ab
ab
ab
ab
ab
ab
ab
ab
ab
ab
ab
ab
ab
ab
ab
ab
ab
ab
ab
ab
ab
ab
ab
ab
ab
ab
ab
ab
aa
"}
(4,1,1) = {"
aa
ab
ab
ab
ab
ab
ab
ab
ab
ab
ab
ab
ab
ab
ab
ab
ab
ab
ab
ab
ab
ab
ab
ab
ab
ab
ab
ab
ab
ab
ab
ab
ab
ab
ab
ab
ab
ab
ab
ab
ab
ab
ab
ab
aa
"}
(5,1,1) = {"
aa
ab
ab
ab
ab
ab
ab
ab
ab
ab
ab
ab
ab
ab
ab
ab
ab
ab
ab
ab
ab
ab
ab
ab
ab
ab
ab
ab
ab
ab
ab
ab
ab
ab
ab
ab
ab
ab
ab
ab
ab
ab
ab
ab
aa
"}
(6,1,1) = {"
aa
ab
ab
ab
ab
ab
ab
ab
ab
ab
ab
ab
ab
ab
ab
ab
ab
ab
ab
ab
ab
ab
ab
ab
ab
ab
ab
ab
ab
ab
ab
ab
ab
ab
ab
ab
ab
ab
ab
ab
ab
ab
ab
ab
aa
"}
(7,1,1) = {"
aa
ab
ab
ab
ab
ab
ab
ab
ab
ab
ab
ab
ab
ab
ab
ab
ab
ab
ab
ab
ab
ab
ab
ab
ab
ab
ab
ab
ab
ab
ab
ab
ab
ab
ab
ab
ab
ab
ab
ab
ab
ab
ab
ab
aa
"}
(8,1,1) = {"
aa
ab
ab
ab
ab
ab
ab
ab
ab
ab
ab
ab
ab
ab
ab
ab
ab
ab
ab
ab
ab
ab
ab
ab
ab
ab
ab
ab
ab
ab
ab
ab
ab
ab
ab
ab
ab
ab
ab
ab
ab
ab
ab
ab
aa
"}
(9,1,1) = {"
aa
ab
ab
ab
ab
ab
ab
ab
ab
ab
ab
ab
ab
ab
ab
ab
ab
ab
ab
ab
ab
ab
ab
ab
ab
ab
ab
ab
ab
ab
ab
ab
ab
ab
ab
ab
ab
ab
ab
ab
ab
ab
ab
ab
aa
"}
(10,1,1) = {"
aa
ab
ab
ab
ab
ab
ab
ab
ab
ab
ab
ab
ab
ab
ab
ab
ab
ab
ab
ab
ab
ab
ab
ab
ab
ab
ab
ab
ab
ab
ab
ab
ab
ab
ab
ab
ab
ab
ab
ab
ab
ab
ab
ab
aa
"}
(11,1,1) = {"
aa
ab
ab
ab
ab
ab
ab
ab
ab
ab
ab
ab
ab
ab
ab
ab
ab
ab
ab
ab
ab
ab
ab
ab
ab
ab
ab
ab
ab
ab
ab
ab
ab
ab
ab
ab
ab
ab
ab
ab
ab
ab
ab
ab
aa
"}
(12,1,1) = {"
aa
ab
ab
ab
ab
ab
ab
ab
ab
ab
ab
ab
ab
ab
ab
ab
ab
ab
ab
ab
ab
ab
ab
ab
ab
ab
ab
ab
ab
ab
ab
ab
ab
ab
ab
ab
ab
ab
ab
ab
ab
ab
ab
ab
aa
"}
(13,1,1) = {"
aa
ab
ab
ab
ab
ab
ab
ab
ab
ab
ab
ab
ab
ab
ab
ab
ab
ab
ab
ab
ab
ab
ab
ab
ab
ab
aj
as
as
aj
ab
ab
ab
ab
ab
ab
ab
ab
ab
ab
ab
ab
ab
ab
aa
"}
(14,1,1) = {"
aa
ab
ab
ab
ab
ab
ab
ab
ab
ab
ab
ab
ab
ab
ab
ab
ab
ab
ab
ab
ab
ab
ab
aj
as
aj
aj
bA
bI
aj
cd
ab
ab
ab
ab
ab
ab
ab
ab
ab
ab
ab
ab
ab
aa
"}
(15,1,1) = {"
aa
ab
ab
ab
ab
ab
ab
ab
ab
ab
ab
ab
ab
ab
ab
ab
ab
ab
ab
ab
ab
aj
as
aj
aE
aE
bu
bB
bB
aj
cd
ab
ab
ab
ab
ab
ab
ab
ab
ab
ab
ab
ab
ab
aa
"}
(16,1,1) = {"
aa
ab
ab
ab
ab
ab
ab
ab
ab
ab
ab
ab
ab
ab
ab
ab
ab
ab
ab
aj
as
aj
aE
aE
aE
aj
aj
bC
bB
aj
cd
ab
ab
ab
ab
ab
ab
ab
ab
ab
ab
ab
ab
ab
aa
"}
(17,1,1) = {"
aa
ab
ab
ab
ab
ab
ab
ab
ab
ab
ab
ab
ab
ab
ab
ab
ab
ab
aj
aj
aE
aE
aE
aj
aj
aj
aj
aj
bJ
aj
aj
ab
ab
ab
ab
ab
ab
ab
ab
ab
ab
ab
ab
ab
aa
"}
(18,1,1) = {"
aa
ab
ab
ab
ab
ab
ab
ab
ab
ab
ab
ab
ab
ab
ab
ab
ab
aj
aj
aE
aE
aj
aj
aj
bf
bm
aj
bD
bK
bV
ad
ab
ab
ab
ab
ab
ab
ab
ab
ab
ab
ab
ab
ab
aa
"}
(19,1,1) = {"
aa
ab
ab
ab
ab
ab
ab
ab
ab
ab
ab
ab
ab
ab
ab
ab
aj
aj
aE
aE
aj
aj
aj
aX
aY
bn
aj
bE
bL
bW
ad
ab
ab
ab
ab
ab
ab
ab
ab
ab
ab
ab
ab
ab
aa
"}
(20,1,1) = {"
aa
ab
ab
ab
ab
ab
ab
ab
ab
ab
ab
ab
ab
ab
ab
aj
aj
aE
aE
aj
aj
aH
aT
aY
aY
aY
aj
aj
bM
bW
aj
aj
ab
ab
ab
ab
ab
ab
ab
ab
ab
ab
ab
ab
aa
"}
(21,1,1) = {"
aa
ab
ab
ab
ab
ab
ab
ab
ab
ab
ab
ab
aj
as
aj
aj
aE
aE
aj
aj
aH
aH
aj
aZ
aY
aY
bv
aj
bM
bX
cf
ad
ab
ab
ab
ab
ab
ab
ab
ab
ab
ab
ab
ab
aa
"}
(22,1,1) = {"
aa
ab
ab
ab
ab
ab
ab
ab
ab
ab
ab
aj
aj
at
aw
aA
aE
aj
aj
aH
aL
aH
aj
ba
bg
aY
bw
aj
bN
bY
cg
aj
as
aj
aj
ab
ab
ab
ab
ab
ab
ab
ab
ab
aa
"}
(23,1,1) = {"
aa
ab
ab
ab
ab
ab
ab
ab
ab
ab
aj
aj
aj
as
aj
aj
aE
aj
aF
aI
aM
aP
aj
bb
aY
aY
bx
aj
bO
aj
aj
aj
cm
co
aj
cd
ab
ab
ab
ab
ab
ab
ab
ab
aa
"}
(24,1,1) = {"
aa
ab
ab
ab
ab
ab
ab
ab
ab
aj
aj
al
ao
ao
ax
aj
aE
aj
aj
aj
as
aj
aj
aj
as
bo
aj
aj
aE
aE
aj
ck
aw
aw
aj
cd
ab
ab
ab
ab
ab
ab
ab
ab
aa
"}
(25,1,1) = {"
aa
ab
ab
ab
ab
ab
ab
ab
ab
ad
ag
am
ap
au
ay
aC
aE
aE
aE
aE
aE
aE
aE
aE
aE
aE
aE
aE
aE
aE
ch
cl
aw
cp
aj
cd
ab
ab
ab
ab
ab
ab
ab
ab
aa
"}
(26,1,1) = {"
aa
ab
ab
ab
ab
ab
ab
ab
ab
ad
ah
am
aq
av
ay
aD
aE
aE
aE
aE
aE
aE
aG
aE
aE
aE
aE
aE
aE
aE
ch
cl
aw
cp
aj
cd
ab
ab
ab
ab
ab
ab
ab
ab
aa
"}
(27,1,1) = {"
aa
ab
ab
ab
ab
ab
ab
ab
ab
ad
ai
am
aq
av
ay
aD
aE
aE
aE
aE
aE
aE
aE
aE
aE
aE
aE
aE
aE
aE
ch
cl
aw
cp
aj
cd
ab
ab
ab
ab
ab
ab
ab
ab
aa
"}
(28,1,1) = {"
aa
ab
ab
ab
ab
ab
ab
ab
ab
aj
aj
an
ar
ar
az
aj
aE
aE
aE
aE
aE
aE
aE
aj
as
bp
aj
aj
aE
aE
aj
ck
aw
aw
aj
cq
ab
ab
ab
ab
ab
ab
ab
ab
aa
"}
(29,1,1) = {"
aa
ab
ab
ab
ab
ab
ab
ab
ab
ab
aj
aj
aj
al
ax
aj
aE
aE
aE
aE
aE
aE
aE
aj
bh
bh
bh
aj
aS
aj
aj
aj
cn
co
aj
cd
ab
ab
ab
ab
ab
ab
ab
ab
aa
"}
(30,1,1) = {"
aa
ab
ab
ab
ab
ab
ab
ab
ab
ab
ab
aj
aj
an
az
aj
aE
aE
aE
aE
aE
aE
aE
aj
bi
bh
by
aj
bP
bZ
ci
aj
as
aj
aj
ab
ab
ab
ab
ab
ab
ab
ab
ab
aa
"}
(31,1,1) = {"
aa
ab
ab
ab
ab
ab
ab
ab
ab
ab
ab
ab
aj
as
aj
aj
aE
aE
aE
aE
aE
aE
aE
aj
aj
aj
aj
aj
bQ
ca
cj
ad
ab
ab
ab
ab
ab
ab
ab
ab
ab
ab
ab
ab
aa
"}
(32,1,1) = {"
aa
ab
ab
ab
ab
ab
ab
ab
ab
ab
ab
ab
ab
ab
ab
aj
aj
aE
aE
aE
aE
aE
aE
aE
aE
aE
aj
aj
bQ
cb
aj
aj
ab
ab
ab
ab
ab
ab
ab
ab
ab
ab
ab
ab
aa
"}
(33,1,1) = {"
aa
ab
ab
ab
ab
ab
ab
ab
ab
ab
ab
ab
ab
ab
ab
ab
aj
aj
aE
aE
aE
aE
aE
aE
aE
aE
aj
bF
bR
cb
ad
ab
ab
ab
ab
ab
ab
ab
ab
ab
ab
ab
ab
ab
aa
"}
(34,1,1) = {"
aa
ab
ab
ab
ab
ab
ab
ab
ab
ab
ab
ab
ab
ab
ab
ab
ab
aj
aj
aE
aE
aj
aj
aj
aj
aj
aj
bG
bS
cc
ad
ab
ab
ab
ab
ab
ab
ab
ab
ab
ab
ab
ab
ab
aa
"}
(35,1,1) = {"
aa
ab
ab
ab
ab
ab
ab
ab
ab
ab
ab
ab
ab
ab
ab
ab
ab
ab
aj
aj
aE
aS
aV
be
bk
bs
aj
aj
bT
aj
aj
ab
ab
ab
ab
ab
ab
ab
ab
ab
ab
ab
ab
ab
aa
"}
(36,1,1) = {"
aa
ab
ab
ab
ab
ab
ab
ab
ab
ab
ab
ab
ab
ab
ab
ab
ab
ab
ab
aj
as
aj
aW
aV
aV
aV
aV
aV
aV
aj
cd
ab
ab
ab
ab
ab
ab
ab
ab
ab
ab
ab
ab
ab
aa
"}
(37,1,1) = {"
aa
ab
ab
ab
ab
ab
ab
ab
ab
ab
ab
ab
ab
ab
ab
ab
ab
ab
ab
ab
ab
aj
as
aj
bl
bt
bz
aV
aV
aj
cd
ab
ab
ab
ab
ab
ab
ab
ab
ab
ab
ab
ab
ab
aa
"}
(38,1,1) = {"
aa
ab
ab
ab
ab
ab
ab
ab
ab
ab
ab
ab
ab
ab
ab
ab
ab
ab
ab
ab
ab
ab
ab
aj
as
aj
aj
bH
bU
aj
cd
ab
ab
ab
ab
ab
ab
ab
ab
ab
ab
ab
ab
ab
aa
"}
(39,1,1) = {"
aa
ab
ab
ab
ab
ab
ab
ab
ab
ab
ab
ab
ab
ab
ab
ab
ab
ab
ab
ab
ab
ab
ab
ab
ab
ab
aj
as
as
aj
ab
ab
ab
ab
ab
ab
ab
ab
ab
ab
ab
ab
ab
ab
aa
"}
(40,1,1) = {"
aa
ab
ab
ab
ab
ab
ab
ab
ab
ab
ab
ab
ab
ab
ab
ab
ab
ab
ab
ab
ab
ab
ab
ab
ab
ab
ab
ab
ab
ab
ab
ab
ab
ab
ab
ab
ab
ab
ab
ab
ab
ab
ab
ab
aa
"}
(41,1,1) = {"
aa
ab
ab
ab
ab
ab
ab
ab
ab
ab
ab
ab
ab
ab
ab
ab
ab
ab
ab
ab
ab
ab
ab
ab
ab
ab
ab
ab
ab
ab
ab
ab
ab
ab
ab
ab
ab
ab
ab
ab
ab
ab
ab
ab
aa
"}
(42,1,1) = {"
aa
ab
ab
ab
ab
ab
ab
ab
ab
ab
ab
ab
ab
ab
ab
ab
ab
ab
ab
ab
ab
ab
ab
ab
ab
ab
ab
ab
ab
ab
ab
ab
ab
ab
ab
ab
ab
ab
ab
ab
ab
ab
ab
ab
aa
"}
(43,1,1) = {"
aa
ab
ab
ab
ab
ab
ab
ab
ab
ab
ab
ab
ab
ab
ab
ab
ab
ab
ab
ab
ab
ab
ab
ab
ab
ab
ab
ab
ab
ab
ab
ab
ab
ab
ab
ab
ab
ab
ab
ab
ab
ab
ab
ab
aa
"}
(44,1,1) = {"
aa
ab
ab
ab
ab
ab
ab
ab
ab
ab
ab
ab
ab
ab
ab
ab
ab
ab
ab
ab
ab
ab
ab
ab
ab
ab
ab
ab
ab
ab
ab
ab
ab
ab
ab
ab
ab
ab
ab
ab
ab
ab
ab
ab
aa
"}
(45,1,1) = {"
aa
ab
ab
ab
ab
ab
ab
ab
ab
ab
ab
ab
ab
ab
ab
ab
ab
ab
ab
ab
ab
ab
ab
ab
ab
ab
ab
ab
ab
ab
ab
ab
ab
ab
ab
ab
ab
ab
ab
ab
ab
ab
ab
ab
aa
"}
(46,1,1) = {"
aa
ab
ab
ab
ab
ab
ab
ab
ab
ab
ab
ab
ab
ab
ab
ab
ab
ab
ab
ab
ab
ab
ab
ab
ab
ab
ab
ab
ab
ab
ab
ab
ab
ab
ab
ab
ab
ab
ab
ab
ab
ab
ab
ab
aa
"}
(47,1,1) = {"
aa
ab
ab
ab
ab
ab
ab
ab
ab
ab
ab
ab
ab
ab
ab
ab
ab
ab
ab
ab
ab
ab
ab
ab
ab
ab
ab
ab
ab
ab
ab
ab
ab
ab
ab
ab
ab
ab
ab
ab
ab
ab
ab
ab
aa
"}
(48,1,1) = {"
aa
ab
ab
ab
ab
ab
ab
ab
ab
ab
ab
ab
ab
ab
ab
ab
ab
ab
ab
ab
ab
ab
ab
ab
ab
ab
ab
ab
ab
ab
ab
ab
ab
ab
ab
ab
ab
ab
ab
ab
ab
ab
ab
ab
aa
"}
(49,1,1) = {"
aa
ab
ab
ab
ab
ab
ab
ab
ab
ab
ab
ab
ab
ab
ab
ab
ab
ab
ab
ab
ab
ab
ab
ab
ab
ab
ab
ab
ab
ab
ab
ab
ab
ab
ab
ab
ab
ab
ab
ab
ab
ab
ab
ab
aa
"}
(50,1,1) = {"
aa
ab
ab
ab
ab
ab
ab
ab
ab
ab
ab
ab
ab
ab
ab
ab
ab
ab
ab
ab
ab
ab
ab
ab
ab
ab
ab
ab
ab
ab
ab
ab
ab
ab
ab
ab
ab
ab
ab
ab
ab
ab
ab
ab
aa
"}
(51,1,1) = {"
aa
aa
aa
aa
aa
aa
aa
aa
aa
aa
aa
aa
aa
aa
aa
aa
aa
aa
aa
aa
aa
aa
aa
aa
aa
aa
aa
aa
aa
aa
aa
aa
aa
aa
aa
aa
aa
aa
aa
aa
aa
aa
aa
aa
aa
"}
