//MAP CONVERTED BY dmm2tgm.py THIS HEADER COMMENT PREVENTS RECONVERSION, DO NOT REMOVE
"aa" = (
/turf/background_canvas,
/area)
"ab" = (
/turf/unsimulated/wall/void,
/area)
"ac" = (
/turf/unsimulated/wall/setpieces/leadwall/junction{
	dir = 4
	},
/area)
"ad" = (
/turf/unsimulated/wall/setpieces/leadwall/junction,
/area)
"ae" = (
/turf/unsimulated/wall/setpieces/leadwall{
	dir = 6;
	icon_state = "leadwall"
	},
/area)
"af" = (
/turf/unsimulated/wall/setpieces/leadwall{
	dir = 10;
	icon_state = "leadwall"
	},
/area)
"ag" = (
/turf/unsimulated/wall/setpieces/leadwall,
/area)
"ah" = (
/turf/unsimulated/wall/setpieces/leadwall{
	dir = 8;
	icon_state = "leadwall"
	},
/area)
"aj" = (
/turf/unsimulated/wall/setpieces/leadwall{
	dir = 4;
	icon_state = "leadwall"
	},
/area)
"ak" = (
/turf/unsimulated/wall/setpieces/leadwindow{
	dir = 4;
	icon_state = "leadwindow_1"
	},
/area)
"al" = (
/obj/machinery/computer/communications,
/obj/machinery/power/data_terminal,
/turf/simulated/floor/carpet{
	dir = 8;
	icon_state = "fblue4"
	},
/area)
"am" = (
/obj/machinery/computer/announcement,
/obj/machinery/power/data_terminal,
/turf/simulated/floor/carpet{
	dir = 4;
	icon_state = "fblue4"
	},
/area)
"an" = (
/turf/simulated/floor/carpet{
	dir = 9;
	icon_state = "fblue2"
	},
/area)
"ao" = (
/obj/stool/chair/office/blue{
	dir = 1;
	icon_state = "office_chair_blue"
	},
/turf/simulated/floor/carpet{
	dir = 1;
	icon_state = "fblue2"
	},
/area)
"ap" = (
/turf/simulated/floor/carpet{
	dir = 5;
	icon_state = "fblue2"
	},
/area)
"aq" = (
/obj/stool/chair/comfy/blue{
	dir = 4
	},
/turf/simulated/floor/carpet{
	dir = 8;
	icon_state = "fblue2"
	},
/area)
"ar" = (
/obj/table/wood/auto,
/turf/simulated/floor/carpet{
	dir = 6;
	icon_state = "fblue3"
	},
/area)
"as" = (
/obj/table/wood/auto,
/turf/simulated/floor/carpet{
	dir = 10;
	icon_state = "fblue3"
	},
/area)
"at" = (
/obj/stool/chair/comfy/blue{
	dir = 8
	},
/turf/simulated/floor/carpet{
	dir = 4;
	icon_state = "fblue2"
	},
/area)
"au" = (
/turf/simulated/floor/engine,
/area)
"av" = (
/obj/lrteleporter/planetary_teleporter,
/obj/landmark/lrt{
	name = "Artemis-"
	},
/turf/simulated/floor/engine,
/area)
"aw" = (
/obj/table/wood/auto,
/turf/simulated/floor/carpet{
	dir = 5;
	icon_state = "fblue3"
	},
/area)
"ax" = (
/turf/simulated/floor/carpet{
	dir = 10;
	icon_state = "fblue2"
	},
/area)
"ay" = (
/turf/simulated/floor/carpet{
	dir = 2;
	icon_state = "fblue2"
	},
/area)
"az" = (
/turf/simulated/floor/carpet{
	dir = 6;
	icon_state = "fblue2"
	},
/area)
"aA" = (
/turf/simulated/floor/black,
/area)
"aB" = (
/turf/simulated/floor/bluegreen,
/area)
"aC" = (
/obj/decal/fakeobjects/shuttlethruster{
	dir = 1;
	icon_state = "propulsion"
	},
/turf/background_canvas,
/area)
"aD" = (
/turf/simulated/floor/blue/checker,
/area)
"aE" = (
/turf/simulated/floor/specialroom/medbay,
/area)
"aF" = (
/obj/rack,
/obj/item/clothing/suit/rad,
/obj/item/clothing/head/rad_hood,
/turf/simulated/floor/black,
/area)
"aG" = (
/turf/simulated/floor/circuit/off,
/area)
"aH" = (
/turf/simulated/floor/purple,
/area)
"aI" = (
/obj/table/wood/auto,
/turf/simulated/floor/carpet{
	dir = 9;
	icon_state = "fblue3"
	},
/area)
"aJ" = (
/turf/simulated/floor/carpet{
	dir = 5;
	icon_state = "red2"
	},
/area)
"aK" = (
/turf/simulated/floor/carpet{
	dir = 9;
	icon_state = "green2"
	},
/area)
"aL" = (
/obj/submachine/chef_sink/chem_sink{
	dir = 4;
	pixel_x = -8
	},
/turf/simulated/floor/blue/checker,
/area)
"aM" = (
/turf/simulated/floor/carpet{
	dir = 8;
	icon_state = "red2"
	},
/area)
"aN" = (
/turf/simulated/floor/carpet{
	dir = 5;
	icon_state = "red3"
	},
/area)
"aO" = (
/turf/simulated/floor/carpet{
	dir = 1;
	icon_state = "red2"
	},
/area)
"aP" = (
/turf/simulated/floor/carpet{
	dir = 1;
	icon_state = "green2"
	},
/area)
"aQ" = (
/turf/simulated/floor/carpet{
	dir = 9;
	icon_state = "green3"
	},
/area)
"aR" = (
/turf/simulated/floor/carpet{
	dir = 4;
	icon_state = "green2"
	},
/area)
"aS" = (
/obj/machinery/door/airlock/gannets/glass/toxins,
/turf/simulated/floor/engine,
/area)
"aT" = (
/obj/machinery/door/airlock/gannets/glass/command/alt,
/turf/simulated/floor/carpet{
	dir = 8;
	icon_state = "fblue4"
	},
/area)
"aU" = (
/turf/simulated/floor/carpet{
	dir = 10;
	icon_state = "red3"
	},
/area)
"aV" = (
/turf/simulated/floor/carpet{
	dir = 4;
	icon_state = "red2"
	},
/area)
"aW" = (
/turf/simulated/floor/carpet{
	dir = 8;
	icon_state = "green2"
	},
/area)
"aX" = (
/turf/simulated/floor/carpet{
	dir = 6;
	icon_state = "green3"
	},
/area)
"aY" = (
/obj/machinery/door/airlock/gannets/glass/command/alt,
/turf/simulated/floor/carpet{
	dir = 4;
	icon_state = "fblue4"
	},
/area)
"aZ" = (
/obj/machinery/clonegrinder,
/obj/machinery/power/data_terminal,
/turf/simulated/floor/bluegreen,
/area)
"ba" = (
/turf/unsimulated/wall/setpieces/leadwindow{
	dir = 8;
	icon_state = "leadwindow_1"
	},
/area)
"bb" = (
/obj/storage/closet/biohazard,
/turf/simulated/floor/engine,
/area)
"bc" = (
/obj/machinery/clonepod,
/obj/machinery/power/data_terminal,
/turf/simulated/floor/bluegreen,
/area)
"bd" = (
/turf/simulated/floor/stairs{
	dir = 1
	},
/area)
"be" = (
/obj/ladder{
	desc = "A ladder.";
	id = "artemis";
	layer = 2.5;
	pixel_y = -12
	},
/turf/simulated/floor/black,
/area)
"bf" = (
/obj/stool/chair/office{
	dir = 4;
	icon_state = "office_chair"
	},
/turf/simulated/floor/bluegreen,
/area)
"bg" = (
/obj/machinery/computer/cloning{
	dir = 8;
	icon_state = "dna"
	},
/obj/machinery/power/data_terminal,
/turf/simulated/floor/bluegreen,
/area)
"bh" = (
/obj/ladder{
	desc = "A ladder.";
	icon_state = "ladder_wall";
	id = "artemis";
	layer = 2.5;
	pixel_y = 32
	},
/turf/simulated/floor/black,
/area)
"bi" = (
/obj/machinery/clone_scanner,
/obj/machinery/power/data_terminal,
/turf/simulated/floor/bluegreen,
/area)
"bj" = (
/obj/landmark/ship_marker,
/turf/simulated/floor/black,
/area)
"bl" = (
/obj/machinery/door/airlock/gannets/glass,
/turf/simulated/floor/black,
/area)
"bm" = (
/obj/machinery/door/airlock/gannets/glass/medical,
/turf/simulated/floor/bluegreen,
/area)
"bn" = (
/obj/storage/secure/closet/fridge,
/turf/simulated/floor/blue/checker,
/area)
"bo" = (
/obj/machinery/vending/port_a_nanomed,
/turf/simulated/floor/specialroom/medbay,
/area)
"bp" = (
/obj/table/auto,
/obj/machinery/chem_master,
/obj/machinery/light/incandescent{
	dir = 1
	},
/turf/simulated/floor/specialroom/medbay,
/area)
"bq" = (
/obj/table/auto,
/obj/machinery/chem_dispenser,
/turf/simulated/floor/specialroom/medbay,
/area)
"br" = (
/obj/table/auto,
/obj/machinery/chem_heater,
/turf/simulated/floor/specialroom/medbay,
/area)
"bt" = (
/obj/storage/secure/closet/research/chemical,
/turf/simulated/floor/specialroom/medbay,
/area)
"bu" = (
/obj/stool/chair/office{
	dir = 1;
	icon_state = "office_chair"
	},
/turf/simulated/floor/specialroom/medbay,
/area)
"bv" = (
/obj/machinery/communications_dish,
/obj/machinery/power/data_terminal,
/turf/simulated/floor/circuit/off,
/area)
"bw" = (
/obj/submachine/chef_oven{
	dir = 4;
	icon_state = "oven_off"
	},
/turf/simulated/floor/blue/checker,
/area)
"bx" = (
/obj/stool/chair,
/turf/simulated/floor/blue/checker,
/area)
"by" = (
/obj/storage/secure/closet/medical,
/turf/simulated/floor/specialroom/medbay,
/area)
"bz" = (
/obj/machinery/optable,
/obj/item/surgical_spoon,
/obj/item/suture,
/obj/item/scalpel,
/obj/item/circular_saw,
/turf/simulated/floor/specialroom/medbay,
/area)
"bA" = (
/obj/machinery/door/airlock/gannets/glass/medical,
/turf/simulated/floor/black,
/area)
"bE" = (
/obj/machinery/vending/kitchen,
/turf/simulated/floor/blue/checker,
/area)
"bF" = (
/obj/table/auto,
/obj/item/storage/box/cutlery,
/obj/item/storage/box/plates,
/obj/machinery/light/incandescent{
	dir = 4
	},
/turf/simulated/floor/blue/checker,
/area)
"bG" = (
/obj/machinery/door/airlock/gannets/chemistry,
/turf/simulated/floor/black,
/area)
"bH" = (
/obj/table/auto,
/obj/item/storage/box/iv_box,
/obj/item/storage/box/patchbox,
/obj/item/kitchen/food_box/lollipop,
/turf/simulated/floor/specialroom/medbay,
/area)
"bI" = (
/obj/table/auto,
/obj/item/storage/box/syringes,
/obj/item/remote/porter/port_a_nanomed,
/turf/simulated/floor/specialroom/medbay,
/area)
"bJ" = (
/obj/table/auto,
/obj/item/storage/box/beakerbox,
/turf/simulated/floor/specialroom/medbay,
/area)
"bK" = (
/obj/machinery/networked/mainframe,
/obj/machinery/power/data_terminal,
/turf/simulated/floor/circuit/off,
/area)
"bL" = (
/obj/stool/chair{
	dir = 1;
	icon_state = "chair"
	},
/turf/simulated/floor/blue/checker,
/area)
"bM" = (
/obj/machinery/bathtub{
	anchored = 1;
	dir = 4
	},
/turf/simulated/floor/purple,
/area)
"bN" = (
/obj/submachine/laundry_machine,
/turf/simulated/floor/purple,
/area)
"bO" = (
/obj/stool/chair/couch/red{
	dir = 8;
	icon_state = "chair_couch-red"
	},
/turf/simulated/floor/carpet{
	dir = 9;
	icon_state = "red2"
	},
/area)
"bP" = (
/obj/stool/chair/couch/red{
	dir = 4;
	icon_state = "chair_couch-red"
	},
/turf/simulated/floor/carpet{
	dir = 5;
	icon_state = "red2"
	},
/area)
"bQ" = (
/obj/stool/chair/couch/green{
	dir = 8;
	icon_state = "chair_couch-green"
	},
/turf/simulated/floor/carpet{
	dir = 9;
	icon_state = "green2"
	},
/area)
"bR" = (
/obj/stool/chair/couch/green{
	dir = 4;
	icon_state = "chair_couch-green"
	},
/turf/simulated/floor/carpet{
	dir = 5;
	icon_state = "green2"
	},
/area)
"bS" = (
/obj/machinery/vending/snack,
/turf/simulated/floor/blue/checker,
/area)
"bT" = (
/obj/item/storage/toilet{
	dir = 4;
	icon_state = "toilet"
	},
/turf/simulated/floor/purple,
/area)
"bU" = (
/obj/machinery/door/airlock/gannets/chemistry,
/turf/simulated/floor/purple,
/area)
"bV" = (
/obj/machinery/door/airlock/gannets/glass/security,
/turf/simulated/floor/black,
/area)
"bW" = (
/obj/machinery/door/airlock/gannets/glass,
/turf/simulated/floor/blue/checker,
/area)
"bX" = (
/obj/table/auto,
/obj/submachine/mixer,
/turf/simulated/floor/blue/checker,
/area)
"bY" = (
/obj/stool/bed,
/obj/item/clothing/suit/bedsheet{
	bcolor = "red";
	icon_state = "bedsheet-red"
	},
/turf/simulated/floor/carpet{
	dir = 10;
	icon_state = "red2"
	},
/area)
"bZ" = (
/obj/stool/bed,
/obj/item/clothing/suit/bedsheet{
	bcolor = "red";
	icon_state = "bedsheet-red"
	},
/turf/simulated/floor/carpet{
	dir = 2;
	icon_state = "red2"
	},
/area)
"ca" = (
/obj/stool/bed,
/obj/item/clothing/suit/bedsheet{
	bcolor = "green";
	icon_state = "bedsheet-green"
	},
/turf/simulated/floor/carpet{
	dir = 2;
	icon_state = "green2"
	},
/area)
"cb" = (
/obj/stool/bed,
/obj/item/clothing/suit/bedsheet{
	bcolor = "green";
	icon_state = "bedsheet-green"
	},
/turf/simulated/floor/carpet{
	dir = 6;
	icon_state = "green2"
	},
/area)
"cc" = (
/obj/machinery/vending/cola/red,
/turf/simulated/floor/carpet{
	dir = 10;
	icon_state = "red2"
	},
/area)
"cd" = (
/obj/machinery/vending/cigarette,
/turf/simulated/floor/carpet{
	dir = 6;
	icon_state = "red2"
	},
/area)
"ce" = (
/obj/machinery/door/airlock/gannets/engineering/alt,
/turf/simulated/floor/black,
/area)
"cf" = (
/obj/machinery/vending/coffee,
/turf/simulated/floor/carpet{
	dir = 10;
	icon_state = "green2"
	},
/area)
"cg" = (
/obj/machinery/vending/cola/blue,
/turf/simulated/floor/carpet{
	dir = 6;
	icon_state = "green2"
	},
/area)
"ch" = (
/obj/machinery/power/rtg,
/turf/simulated/floor/engine,
/area)
"ci" = (
/obj/storage/closet/fire,
/turf/simulated/floor/engine,
/area)
"ck" = (
/obj/storage/secure/closet/engineering,
/turf/simulated/floor/engine,
/area)
"cl" = (
/obj/machinery/power/smes,
/turf/simulated/floor/engine,
/area)
"cm" = (
/obj/decal/fakeobjects/shuttlethruster,
/turf/space,
/area)
"cn" = (
/obj/decal/fakeobjects/shuttlethruster,
/obj/decal/fakeobjects/shuttlethruster,
/turf/space,
/area)
"co" = (
/obj/machinery/sim/vr_bed/flight_chair,
/turf/simulated/floor/carpet{
	dir = 10;
	icon_state = "fblue1"
	},
/area)
"cp" = (
/turf/unsimulated/wall/setpieces/leadwindow,
/area)
"jZ" = (
/obj/machinery/light/incandescent{
	dir = 1
	},
/turf/simulated/floor/carpet{
	dir = 1;
	icon_state = "red2"
	},
/area)
"lB" = (
/turf/unsimulated/wall/setpieces/leadwall/junction{
	dir = 1
	},
/area)
"rS" = (
/turf/unsimulated/wall/setpieces/leadwall/junction_four,
/area)
"sV" = (
/obj/machinery/light/incandescent{
	dir = 4
	},
/turf/simulated/floor/black,
/area)
"wM" = (
/obj/machinery/light/incandescent{
	dir = 8
	},
/turf/simulated/floor/black,
/area)
"xa" = (
/obj/stool/chair/comfy/blue{
	dir = 8
	},
/obj/machinery/light/incandescent{
	dir = 4
	},
/turf/simulated/floor/carpet{
	dir = 4;
	icon_state = "fblue2"
	},
/area)
"Ca" = (
/obj/machinery/light/incandescent{
	dir = 1
	},
/turf/simulated/floor/black,
/area)
"CL" = (
/turf/unsimulated/wall/setpieces/leadwall{
	dir = 5;
	icon_state = "leadwall"
	},
/area)
"Eh" = (
/obj/machinery/light/incandescent,
/turf/simulated/floor/blue/checker,
/area)
"GR" = (
/obj/machinery/light/incandescent{
	dir = 8
	},
/turf/simulated/floor/engine,
/area)
"GZ" = (
/obj/stool/chair/comfy/blue{
	dir = 4
	},
/obj/machinery/light/incandescent{
	dir = 8
	},
/turf/simulated/floor/carpet{
	dir = 8;
	icon_state = "fblue2"
	},
/area)
"Kl" = (
/obj/machinery/light/incandescent,
/turf/simulated/floor/bluegreen,
/area)
"PT" = (
/turf/unsimulated/wall/setpieces/leadwall{
	dir = 9;
	icon_state = "leadwall"
	},
/area)
"TY" = (
/turf/unsimulated/wall/setpieces/leadwall/junction{
	dir = 8
	},
/area)
"VN" = (
/obj/machinery/light/incandescent,
/turf/simulated/floor/purple,
/area)

(1,1,1) = {"
ab
ab
ab
ab
ab
ab
ab
ab
ab
ab
ab
ab
ab
ab
ab
ab
ab
ab
ab
ab
ab
ab
ab
ab
ab
ab
ab
ab
ab
ab
ab
ab
ab
ab
ab
ab
ab
ab
ab
ab
ab
ab
ab
ab
ab
"}
(2,1,1) = {"
ab
aa
aa
aa
aa
aa
aa
aa
aa
aa
aa
aa
aa
aa
aa
aa
aa
aa
aa
aa
aa
aa
aa
aa
aa
aa
aa
aa
aa
aa
aa
aa
aa
aa
aa
aa
aa
aa
aa
aa
aa
aa
aa
aa
ab
"}
(3,1,1) = {"
ab
aa
aa
aa
aa
aa
aa
aa
aa
aa
aa
aa
aa
aa
aa
aa
aa
aa
aa
aa
aa
aa
aa
aa
aa
aa
aa
aa
aa
aa
aa
aa
aa
aa
aa
aa
aa
aa
aa
aa
aa
aa
aa
aa
ab
"}
(4,1,1) = {"
ab
aa
aa
aa
aa
aa
aa
aa
aa
aa
aa
aa
aa
aa
aa
aa
aa
aa
aa
aa
aa
aa
aa
aa
aa
aa
aa
aa
aa
aa
aa
aa
aa
aa
aa
aa
aa
aa
aa
aa
aa
aa
aa
aa
ab
"}
(5,1,1) = {"
ab
aa
aa
aa
aa
aa
aa
aa
aa
aa
aa
aa
aa
aa
aa
aa
aa
aa
aa
aa
aa
aa
aa
aa
aa
aa
aa
aa
aa
aa
aa
aa
aa
aa
aa
aa
aa
aa
aa
aa
aa
aa
aa
aa
ab
"}
(6,1,1) = {"
ab
aa
aa
aa
aa
aa
aa
aa
aa
aa
aa
aa
aa
aa
aa
aa
aa
aa
aa
aa
aa
aa
aa
aa
aa
aa
aa
aa
aa
aa
aa
aa
aa
aa
aa
aa
aa
aa
aa
aa
aa
aa
aa
aa
ab
"}
(7,1,1) = {"
ab
aa
aa
aa
aa
aa
aa
aa
aa
aa
aa
aa
aa
aa
aa
aa
aa
aa
aa
aa
aa
aa
aa
aa
aa
aa
aa
aa
aa
aa
aa
aa
aa
aa
aa
aa
aa
aa
aa
aa
aa
aa
aa
aa
ab
"}
(8,1,1) = {"
ab
aa
aa
aa
aa
aa
aa
aa
aa
aa
aa
aa
aa
aa
aa
aa
aa
aa
aa
aa
aa
aa
aa
aa
aa
aa
aa
aa
aa
aa
aa
aa
aa
aa
aa
aa
aa
aa
aa
aa
aa
aa
aa
aa
ab
"}
(9,1,1) = {"
ab
aa
aa
aa
aa
aa
aa
aa
aa
aa
aa
aa
aa
aa
aa
aa
aa
aa
aa
aa
aa
aa
aa
aa
aa
aa
aa
aa
aa
aa
aa
aa
aa
aa
aa
aa
aa
aa
aa
aa
aa
aa
aa
aa
ab
"}
(10,1,1) = {"
ab
aa
aa
aa
aa
aa
aa
aa
aa
aa
aa
aa
aa
aa
aa
aa
aa
aa
aa
aa
aa
aa
aa
aa
aa
aa
aa
aa
aa
aa
aa
aa
aa
aa
aa
aa
aa
aa
aa
aa
aa
aa
aa
aa
ab
"}
(11,1,1) = {"
ab
aa
aa
aa
aa
aa
aa
aa
aa
aa
aa
aa
aa
aa
aa
aa
aa
aa
aa
aa
aa
aa
aa
aa
aa
aa
aa
aa
aa
aa
aa
aa
aa
aa
aa
aa
aa
aa
aa
aa
aa
aa
aa
aa
ab
"}
(12,1,1) = {"
ab
aa
aa
aa
aa
aa
aa
aa
aa
aa
aa
aa
aa
aa
aa
aa
aa
aa
aa
aa
aa
aa
aa
aa
aa
aa
aa
aa
aa
aa
aa
aa
aa
aa
aa
aa
aa
aa
aa
aa
aa
aa
aa
aa
ab
"}
(13,1,1) = {"
ab
aa
aa
aa
aa
aa
aa
aa
aa
aa
aa
aa
aa
aa
aa
aa
aa
aa
aa
aa
aa
aa
aa
aa
aa
aa
PT
cp
cp
af
aa
aa
aa
aa
aa
aa
aa
aa
aa
aa
aa
aa
aa
aa
ab
"}
(14,1,1) = {"
ab
aa
aa
aa
aa
aa
aa
aa
aa
aa
aa
aa
aa
aa
aa
aa
aa
aa
aa
aa
aa
aa
aa
PT
cp
ag
ae
bM
bT
ah
cm
aa
aa
aa
aa
aa
aa
aa
aa
aa
aa
aa
aa
aa
ab
"}
(15,1,1) = {"
ab
aa
aa
aa
aa
aa
aa
aa
aa
aa
aa
aa
aa
aa
aa
aa
aa
aa
aa
aa
aa
PT
cp
ae
aA
aA
bG
aH
VN
ah
cm
aa
aa
aa
aa
aa
aa
aa
aa
aa
aa
aa
aa
aa
ab
"}
(16,1,1) = {"
ab
aa
aa
aa
aa
aa
aa
aa
aa
aa
aa
aa
aa
aa
aa
aa
aa
aa
aa
PT
cp
ae
aA
aA
aA
PT
af
bN
aH
ah
cm
aa
aa
aa
aa
aa
aa
aa
aa
aa
aa
aa
aa
aa
ab
"}
(17,1,1) = {"
ab
aa
aa
aa
aa
aa
aa
aa
aa
aa
aa
aa
aa
aa
aa
aa
aa
aa
PT
ae
aA
aA
aA
PT
ag
TY
rS
ag
bU
CL
af
aa
aa
aa
aa
aa
aa
aa
aa
aa
aa
aa
aa
aa
ab
"}
(18,1,1) = {"
ab
aa
aa
aa
aa
aa
aa
aa
aa
aa
aa
aa
aa
aa
aa
aa
aa
PT
ae
aA
aA
PT
ac
ae
bt
by
ah
bO
aM
bY
ba
aa
aa
aa
aa
aa
aa
aa
aa
aa
aa
aa
aa
aa
ab
"}
(19,1,1) = {"
ab
aa
aa
aa
aa
aa
aa
aa
aa
aa
aa
aa
aa
aa
aa
aa
PT
ae
aA
aA
PT
TY
ae
bo
aE
bz
ah
bP
aN
bZ
ba
aa
aa
aa
aa
aa
aa
aa
aa
aa
aa
aa
aa
aa
ab
"}
(20,1,1) = {"
ab
aa
aa
aa
aa
aa
aa
aa
aa
aa
aa
aa
aa
aa
aa
PT
ae
aA
aA
PT
ae
aB
bm
aE
aE
aE
CL
af
aO
bZ
CL
af
aa
aa
aa
aa
aa
aa
aa
aa
aa
aa
aa
aa
ab
"}
(21,1,1) = {"
ab
aa
aa
aa
aa
aa
aa
aa
aa
aa
aa
aa
PT
cp
ag
ae
aA
aA
PT
ae
aB
Kl
ah
bp
aE
aE
bH
ah
jZ
aU
cc
ba
aa
aa
aa
aa
aa
aa
aa
aa
aa
aa
aa
aa
ab
"}
(22,1,1) = {"
ab
aa
aa
aa
aa
aa
aa
aa
aa
aa
aa
PT
ae
av
GR
aS
aA
PT
ae
aB
bf
aB
ah
bq
bu
aE
bI
ah
aJ
aV
cd
ad
cp
ag
af
aa
aa
aa
aa
aa
aa
aa
aa
aa
ab
"}
(23,1,1) = {"
ab
aa
aa
aa
aa
aa
aa
aa
aa
aa
PT
TY
ag
cp
ag
af
aA
ah
aZ
bc
bg
bi
ah
br
aE
aE
bJ
ad
bV
ag
ac
ae
aA
wM
ah
cm
aa
aa
aa
aa
aa
aa
aa
aa
ab
"}
(24,1,1) = {"
ab
aa
aa
aa
aa
aa
aa
aa
aa
PT
ae
an
GZ
aq
ax
ah
Ca
CL
ag
ag
cp
ag
TY
ag
cp
bA
ag
ae
aA
aA
aj
aA
aA
aA
ah
cm
aa
aa
aa
aa
aa
aa
aa
aa
ab
"}
(25,1,1) = {"
ab
aa
aa
aa
aa
aa
aa
aa
aa
ak
al
ao
ar
aw
ay
aT
aA
aA
aA
wM
aA
aA
aA
wM
aA
aA
aA
wM
aA
aA
ce
aA
aA
aA
ah
cm
aa
aa
aa
aa
aa
aa
aa
aa
ab
"}
(26,1,1) = {"
ab
aa
aa
aa
aa
aa
aa
aa
aa
ak
co
ao
as
aI
ay
aY
aA
aA
aA
aA
aA
aA
bj
aA
aA
aA
aA
aA
aA
aA
ce
aA
aA
aA
ah
cm
aa
aa
aa
aa
aa
aa
aa
aa
ab
"}
(27,1,1) = {"
ab
aa
aa
aa
aa
aa
aa
aa
aa
ak
am
ao
as
aI
ay
aY
aA
aA
aA
aA
aA
aA
aA
aA
aA
aA
aA
aA
aA
aA
ce
aA
aA
aA
ah
cm
aa
aa
aa
aa
aa
aa
aa
aa
ab
"}
(28,1,1) = {"
ab
aa
aa
aa
aa
aa
aa
aa
aa
CL
af
ap
xa
at
az
ah
Ca
aA
aA
aA
aA
aA
aA
aA
aA
aA
aA
sV
aA
aA
aj
aA
aA
aA
ah
cn
aa
aa
aa
aa
aa
aa
aa
aa
ab
"}
(29,1,1) = {"
ab
aa
aa
aa
aa
aa
aa
aa
aa
aa
CL
ac
af
aG
aG
ah
aA
aA
aA
aA
aA
aA
aA
aA
aA
aA
aA
PT
bl
ag
TY
af
aA
sV
ah
cm
aa
aa
aa
aa
aa
aa
aa
aa
ab
"}
(30,1,1) = {"
ab
aa
aa
aa
aa
aa
aa
aa
aa
aa
aa
CL
lB
bv
bK
ah
aA
aA
aA
aA
aA
aA
aA
aA
aA
aA
aA
ah
aK
aW
cf
ad
cp
ag
ae
aa
aa
aa
aa
aa
aa
aa
aa
aa
ab
"}
(31,1,1) = {"
ab
aa
aa
aa
aa
aa
aa
aa
aa
aa
aa
aa
CL
cp
ag
af
be
aA
aA
aA
aA
aA
aA
aA
aA
aA
aA
ah
aP
aX
cg
ba
aa
aa
aa
aa
aa
aa
aa
aa
aa
aa
aa
aa
ab
"}
(32,1,1) = {"
ab
aa
aa
aa
aa
aa
aa
aa
aa
aa
aa
aa
aa
aa
aa
CL
af
sV
aA
aA
aA
aA
aA
aA
aA
aA
PT
ae
aP
ca
PT
ae
aa
aa
aa
aa
aa
aa
aa
aa
aa
aa
aa
aa
ab
"}
(33,1,1) = {"
ab
aa
aa
aa
aa
aa
aa
aa
aa
aa
aa
aa
aa
aa
aa
aa
CL
af
aA
aA
aA
sV
aA
aA
aA
sV
ah
bQ
aQ
ca
ba
aa
aa
aa
aa
aa
aa
aa
aa
aa
aa
aa
aa
aa
ab
"}
(34,1,1) = {"
ab
aa
aa
aa
aa
aa
aa
aa
aa
aa
aa
aa
aa
aa
aa
aa
aa
CL
af
aA
aA
PT
ag
ag
ag
ag
lB
bR
aR
cb
ba
aa
aa
aa
aa
aa
aa
aa
aa
aa
aa
aa
aa
aa
ab
"}
(35,1,1) = {"
ab
aa
aa
aa
aa
aa
aa
aa
aa
aa
aa
aa
aa
aa
aa
aa
aa
aa
CL
af
aA
bl
aD
aL
bw
bE
CL
ag
bW
ac
ae
aa
aa
aa
aa
aa
aa
aa
aa
aa
aa
aa
aa
aa
ab
"}
(36,1,1) = {"
ab
aa
aa
aa
aa
aa
aa
aa
aa
aa
aa
aa
aa
aa
aa
aa
aa
aa
aa
CL
cp
lB
bn
aD
aD
aD
aD
aD
aD
ah
cm
aa
aa
aa
aa
aa
aa
aa
aa
aa
aa
aa
aa
aa
ab
"}
(37,1,1) = {"
ab
aa
aa
aa
aa
aa
aa
aa
aa
aa
aa
aa
aa
aa
aa
aa
aa
aa
aa
aa
aa
CL
cp
af
bx
bF
bL
aD
Eh
ah
cm
aa
aa
aa
aa
aa
aa
aa
aa
aa
aa
aa
aa
aa
ab
"}
(38,1,1) = {"
ab
aa
aa
aa
aa
aa
aa
aa
aa
aa
aa
aa
aa
aa
aa
aa
aa
aa
aa
aa
aa
aa
aa
CL
cp
ag
af
bS
bX
ah
cm
aa
aa
aa
aa
aa
aa
aa
aa
aa
aa
aa
aa
aa
ab
"}
(39,1,1) = {"
ab
aa
aa
aa
aa
aa
aa
aa
aa
aa
aa
aa
aa
aa
aa
aa
aa
aa
aa
aa
aa
aa
aa
aa
aa
aa
CL
cp
cp
ae
aa
aa
aa
aa
aa
aa
aa
aa
aa
aa
aa
aa
aa
aa
ab
"}
(40,1,1) = {"
ab
aa
aa
aa
aa
aa
aa
aa
aa
aa
aa
aa
aa
aa
aa
aa
aa
aa
aa
aa
aa
aa
aa
aa
aa
aa
aa
aa
aa
aa
aa
aa
aa
aa
aa
aa
aa
aa
aa
aa
aa
aa
aa
aa
ab
"}
(41,1,1) = {"
ab
aa
aa
aa
aa
aa
aa
aa
aa
aa
aa
aa
aa
aa
aa
aa
aa
aa
aa
aa
aa
aa
aa
aa
aa
aa
aa
aa
aa
aa
aa
aa
aa
aa
aa
aa
aa
aa
aa
aa
aa
aa
aa
aa
ab
"}
(42,1,1) = {"
ab
aa
aa
aa
aa
aa
aa
aa
aa
aa
aa
aa
aa
aa
aa
aa
aa
aa
aa
aa
aa
aa
aa
aa
aa
aa
aa
aa
aa
aa
aa
aa
aa
aa
aa
aa
aa
aa
aa
aa
aa
aa
aa
aa
ab
"}
(43,1,1) = {"
ab
aa
aa
aa
aa
aa
aa
aa
aa
aa
aa
aa
aa
aa
aa
aa
aa
aa
aa
aa
aa
aa
aa
aa
aa
aa
aa
aa
aa
aa
aa
aa
aa
aa
aa
aa
aa
aa
aa
aa
aa
aa
aa
aa
ab
"}
(44,1,1) = {"
ab
aa
aa
aa
aa
aa
aa
aa
aa
aa
aa
aa
aa
aa
aa
aa
aa
aa
aa
aa
aa
aa
aa
aa
aa
aa
aa
aa
aa
aa
aa
aa
aa
aa
aa
aa
aa
aa
aa
aa
aa
aa
aa
aa
ab
"}
(45,1,1) = {"
ab
aa
aa
aa
aa
aa
aa
aa
aa
aa
aa
aa
aa
aa
aa
aa
aa
aa
aa
aa
aa
aa
aa
aa
aa
aa
aa
aa
aa
aa
aa
aa
aa
aa
aa
aa
aa
aa
aa
aa
aa
aa
aa
aa
ab
"}
(46,1,1) = {"
ab
aa
aa
aa
aa
aa
aa
aa
aa
aa
aa
aa
aa
aa
aa
aa
aa
aa
aa
aa
aa
aa
aa
aa
aa
aa
aa
aa
aa
aa
aa
aa
aa
aa
aa
aa
aa
aa
aa
aa
aa
aa
aa
aa
ab
"}
(47,1,1) = {"
ab
aa
aa
aa
aa
aa
aa
aa
aa
aa
aa
aa
aa
aa
aa
aa
aa
aa
aa
aa
aa
aa
aa
aa
aa
aa
aa
aa
aa
aa
aa
aa
aa
aa
aa
aa
aa
aa
aa
aa
aa
aa
aa
aa
ab
"}
(48,1,1) = {"
ab
aa
aa
aa
aa
aa
aa
aa
aa
aa
aa
aa
aa
aa
aa
aa
aa
aa
aa
aa
aa
aa
aa
aa
aa
aa
aa
aa
aa
aa
aa
aa
aa
aa
aa
aa
aa
aa
aa
aa
aa
aa
aa
aa
ab
"}
(49,1,1) = {"
ab
aa
aa
aa
aa
aa
aa
aa
aa
aa
aa
aa
aa
aa
aa
aa
aa
aa
aa
aa
aa
aa
aa
aa
aa
aa
aa
aa
aa
aa
aa
aa
aa
aa
aa
aa
aa
aa
aa
aa
aa
aa
aa
aa
ab
"}
(50,1,1) = {"
ab
aa
aa
aa
aa
aa
aa
aa
aa
aa
aa
aa
aa
aa
aa
aa
aa
aa
aa
aa
aa
aa
aa
aa
aa
aa
aa
aa
aa
aa
aa
aa
aa
aa
aa
aa
aa
aa
aa
aa
aa
aa
aa
aa
ab
"}
(51,1,1) = {"
ab
ab
ab
ab
ab
ab
ab
ab
ab
ab
ab
ab
ab
ab
ab
ab
ab
ab
ab
ab
ab
ab
ab
ab
ab
ab
ab
ab
ab
ab
ab
ab
ab
ab
ab
ab
ab
ab
ab
ab
ab
ab
ab
ab
ab
"}
(52,1,1) = {"
ab
ab
ab
ab
ab
ab
ab
ab
ab
ab
ab
ab
ab
ab
ab
ab
ab
ab
ab
ab
ab
ab
ab
ab
ab
ab
ab
ab
ab
ab
ab
ab
ab
ab
ab
ab
ab
ab
ab
ab
ab
ab
ab
ab
ab
"}
(53,1,1) = {"
ab
aa
aa
aa
aa
aa
aa
aa
aa
aa
aa
aa
aa
aa
aa
aa
aa
aa
aa
aa
aa
aa
aa
aa
aa
aa
aa
aa
aa
aa
aa
aa
aa
aa
aa
aa
aa
aa
aa
aa
aa
aa
aa
aa
ab
"}
(54,1,1) = {"
ab
aa
aa
aa
aa
aa
aa
aa
aa
aa
aa
aa
aa
aa
aa
aa
aa
aa
aa
aa
aa
aa
aa
aa
aa
aa
aa
aa
aa
aa
aa
aa
aa
aa
aa
aa
aa
aa
aa
aa
aa
aa
aa
aa
ab
"}
(55,1,1) = {"
ab
aa
aa
aa
aa
aa
aa
aa
aa
aa
aa
aa
aa
aa
aa
aa
aa
aa
aa
aa
aa
aa
aa
aa
aa
aa
aa
aa
aa
aa
aa
aa
aa
aa
aa
aa
aa
aa
aa
aa
aa
aa
aa
aa
ab
"}
(56,1,1) = {"
ab
aa
aa
aa
aa
aa
aa
aa
aa
aa
aa
aa
aa
aa
aa
aa
aa
aa
aa
aa
aa
aa
aa
aa
aa
aa
aa
aa
aa
aa
aa
aa
aa
aa
aa
aa
aa
aa
aa
aa
aa
aa
aa
aa
ab
"}
(57,1,1) = {"
ab
aa
aa
aa
aa
aa
aa
aa
aa
aa
aa
aa
aa
aa
aa
aa
aa
aa
aa
aa
aa
aa
aa
aa
aa
aa
aa
aa
aa
aa
aa
aa
aa
aa
aa
aa
aa
aa
aa
aa
aa
aa
aa
aa
ab
"}
(58,1,1) = {"
ab
aa
aa
aa
aa
aa
aa
aa
aa
aa
aa
aa
aa
aa
aa
aa
aa
aa
aa
aa
aa
aa
aa
aa
aa
aa
aa
aa
aa
aa
aa
aa
aa
aa
aa
aa
aa
aa
aa
aa
aa
aa
aa
aa
ab
"}
(59,1,1) = {"
ab
aa
aa
aa
aa
aa
aa
aa
aa
aa
aa
aa
aa
aa
aa
aa
aa
aa
aa
aa
aa
aa
aa
aa
aa
aa
aa
aa
aa
aa
aa
aa
aa
aa
aa
aa
aa
aa
aa
aa
aa
aa
aa
aa
ab
"}
(60,1,1) = {"
ab
aa
aa
aa
aa
aa
aa
aa
aa
aa
aa
aa
aa
aa
aa
aa
aa
aa
aa
aa
aa
aa
aa
aa
aa
aa
aa
aa
aa
aa
aa
aa
aa
aa
aa
aa
aa
aa
aa
aa
aa
aa
aa
aa
ab
"}
(61,1,1) = {"
ab
aa
aa
aa
aa
aa
aa
aa
aa
aa
aa
aa
aa
aa
aa
aa
aa
aa
aa
aa
aa
aa
aa
aa
aa
aa
aa
aa
aa
aa
aa
aa
aa
aa
aa
aa
aa
aa
aa
aa
aa
aa
aa
aa
ab
"}
(62,1,1) = {"
ab
aa
aa
aa
aa
aa
aa
aa
aa
aa
aa
aa
aa
aa
aa
aa
aa
aa
aa
aa
aa
aa
aa
aa
aa
aa
aa
aa
aa
aa
aa
aa
aa
aa
aa
aa
aa
aa
aa
aa
aa
aa
aa
aa
ab
"}
(63,1,1) = {"
ab
aa
aa
aa
aa
aa
aa
aa
aa
aa
aa
aa
aa
aa
aa
aa
aa
aa
aa
aa
aa
aa
aa
aa
aa
aa
aa
aa
aa
aa
aa
aa
aa
aa
aa
aa
aa
aa
aa
aa
aa
aa
aa
aa
ab
"}
(64,1,1) = {"
ab
aa
aa
aa
aa
aa
aa
aa
aa
aa
aa
aa
aa
aa
aa
aa
aa
aa
aa
aa
aa
aa
aa
aa
aa
aa
aa
aa
aa
aa
aa
aa
aa
aa
aa
aa
aa
aa
aa
aa
aa
aa
aa
aa
ab
"}
(65,1,1) = {"
ab
aa
aa
aa
aa
aa
aa
aa
aa
aa
aa
aa
aa
aa
aa
aa
aa
aa
aa
aa
aa
aa
aa
aa
aa
aa
aa
aa
aa
aa
aa
aa
aa
aa
aa
aa
aa
aa
aa
aa
aa
aa
aa
aa
ab
"}
(66,1,1) = {"
ab
aa
aa
aa
aa
aa
aa
aa
aa
aa
aa
aa
aa
aa
aa
aa
aa
aa
aa
aa
aa
aa
aa
aa
aa
aa
aa
aa
aa
aa
aa
aa
aa
aa
aa
aa
aa
aa
aa
aa
aa
aa
aa
aa
ab
"}
(67,1,1) = {"
ab
aa
aa
aa
aa
aa
aa
aa
aa
aa
aa
aa
aa
aa
aa
aa
aa
aa
aa
aa
aa
aa
aa
aa
aa
aa
aa
aa
aa
aa
aa
aa
aa
aa
aa
aa
aa
aa
aa
aa
aa
aa
aa
aa
ab
"}
(68,1,1) = {"
ab
aa
aa
aa
aa
aa
aa
aa
aa
aa
aa
aa
aa
aa
aa
aa
aa
aa
aa
aa
aa
aa
aa
aa
aa
aa
aa
aa
aa
aa
aa
aa
aa
aa
aa
aa
aa
aa
aa
aa
aa
aa
aa
aa
ab
"}
(69,1,1) = {"
ab
aa
aa
aa
aa
aa
aa
aa
aa
aa
aa
aa
aa
aa
aa
aa
aa
aa
aa
aa
aa
aa
aa
aa
aa
aa
aa
aa
aa
aa
aa
aa
aa
aa
aa
aa
aa
aa
aa
aa
aa
aa
aa
aa
ab
"}
(70,1,1) = {"
ab
aa
aa
aa
aa
aa
aa
aa
aa
aa
aa
aa
aa
aa
aa
aa
aa
aa
aa
aa
aa
aa
aa
aa
aa
aa
aa
aa
aa
aa
aa
aa
aa
aa
aa
aa
aa
aa
aa
aa
aa
aa
aa
aa
ab
"}
(71,1,1) = {"
ab
aa
aa
aa
aa
aa
aa
aa
aa
aa
aa
aa
aa
aa
aC
PT
ag
ag
ag
ag
ag
ag
ag
ag
ag
ag
ag
ag
ag
ag
ag
af
aa
aa
aa
aa
aa
aa
aa
aa
aa
aa
aa
aa
ab
"}
(72,1,1) = {"
ab
aa
aa
aa
aa
aa
aa
aa
aa
aa
aa
aa
aa
aa
aC
ah
aA
aA
aA
aA
aA
aA
aA
aA
aA
aA
aA
aA
aA
aA
aA
ah
aa
aa
aa
aa
aa
aa
aa
aa
aa
aa
aa
aa
ab
"}
(73,1,1) = {"
ab
aa
aa
aa
aa
aa
aa
aa
aa
aa
aa
PT
ag
ag
ag
ae
aA
aA
aA
aA
aA
aA
aA
aA
aA
aA
aA
aA
aA
aA
aF
ad
ag
ag
af
aa
aa
aa
aa
aa
aa
aa
aa
aa
ab
"}
(74,1,1) = {"
ab
aa
aa
aa
aa
aa
aa
aa
aa
aa
PT
ae
aA
aA
aA
aA
aA
aA
aA
aA
aA
aA
aA
aA
aA
aA
aA
aA
aA
aA
PT
ae
ci
ck
ah
aa
aa
aa
aa
aa
aa
aa
aa
aa
ab
"}
(75,1,1) = {"
ab
aa
aa
aa
aa
aa
aa
aa
aa
PT
ae
aA
aA
aA
aA
aA
aA
aA
aA
aA
aA
aA
aA
aA
aA
aA
aA
aA
aA
aA
aj
ch
au
au
ah
aa
aa
aa
aa
aa
aa
aa
aa
aa
ab
"}
(76,1,1) = {"
ab
aa
aa
aa
aa
aa
aa
aa
aa
ah
aA
aA
aA
aA
aA
aA
aA
aA
aA
aA
aA
aA
aA
aA
aA
aA
aA
aA
aA
aA
ce
bd
au
cl
ah
aa
aa
aa
aa
aa
aa
aa
aa
aa
ab
"}
(77,1,1) = {"
ab
aa
aa
aa
aa
aa
aa
aa
aa
ah
aA
aA
aA
aA
aA
aA
aA
aA
aA
aA
aA
aA
aA
aA
aA
aA
aA
aA
aA
aA
ce
bd
au
cl
ah
aa
aa
aa
aa
aa
aa
aa
aa
aa
ab
"}
(78,1,1) = {"
ab
aa
aa
aa
aa
aa
aa
aa
aa
ah
aA
aA
aA
aA
aA
aA
aA
aA
aA
aA
aA
aA
aA
aA
aA
aA
aA
aA
aA
aA
ce
bd
au
cl
ah
aa
aa
aa
aa
aa
aa
aa
aa
aa
ab
"}
(79,1,1) = {"
ab
aa
aa
aa
aa
aa
aa
aa
aa
CL
af
aA
aA
aA
aA
aA
aA
aA
aA
aA
aA
aA
aA
aA
aA
aA
aA
aA
aA
aA
aj
ch
au
au
ah
aa
aa
aa
aa
aa
aa
aa
aa
aa
ab
"}
(80,1,1) = {"
ab
aa
aa
aa
aa
aa
aa
aa
aa
aa
CL
af
aA
aA
aA
aA
aA
aA
aA
aA
aA
aA
aA
aA
aA
aA
aA
aA
aA
aA
CL
af
bb
ck
ah
aa
aa
aa
aa
aa
aa
aa
aa
aa
ab
"}
(81,1,1) = {"
ab
aa
aa
aa
aa
aa
aa
aa
aa
aa
aa
CL
ag
ag
ag
af
aA
aA
aA
aA
aA
aA
aA
aA
aA
aA
aA
aA
aA
aA
aF
ad
ag
ag
ae
aa
aa
aa
aa
aa
aa
aa
aa
aa
ab
"}
(82,1,1) = {"
ab
aa
aa
aa
aa
aa
aa
aa
aa
aa
aa
aa
aa
aa
aC
ah
bh
aA
aA
aA
aA
aA
aA
aA
aA
aA
aA
aA
aA
aA
aA
ah
aa
aa
aa
aa
aa
aa
aa
aa
aa
aa
aa
aa
ab
"}
(83,1,1) = {"
ab
aa
aa
aa
aa
aa
aa
aa
aa
aa
aa
aa
aa
aa
aC
CL
ag
ag
ag
ag
ag
ag
ag
ag
ag
ag
ag
ag
ag
ag
ag
ae
aa
aa
aa
aa
aa
aa
aa
aa
aa
aa
aa
aa
ab
"}
(84,1,1) = {"
ab
aa
aa
aa
aa
aa
aa
aa
aa
aa
aa
aa
aa
aa
aa
aa
aa
aa
aa
aa
aa
aa
aa
aa
aa
aa
aa
aa
aa
aa
aa
aa
aa
aa
aa
aa
aa
aa
aa
aa
aa
aa
aa
aa
ab
"}
(85,1,1) = {"
ab
aa
aa
aa
aa
aa
aa
aa
aa
aa
aa
aa
aa
aa
aa
aa
aa
aa
aa
aa
aa
aa
aa
aa
aa
aa
aa
aa
aa
aa
aa
aa
aa
aa
aa
aa
aa
aa
aa
aa
aa
aa
aa
aa
ab
"}
(86,1,1) = {"
ab
aa
aa
aa
aa
aa
aa
aa
aa
aa
aa
aa
aa
aa
aa
aa
aa
aa
aa
aa
aa
aa
aa
aa
aa
aa
aa
aa
aa
aa
aa
aa
aa
aa
aa
aa
aa
aa
aa
aa
aa
aa
aa
aa
ab
"}
(87,1,1) = {"
ab
aa
aa
aa
aa
aa
aa
aa
aa
aa
aa
aa
aa
aa
aa
aa
aa
aa
aa
aa
aa
aa
aa
aa
aa
aa
aa
aa
aa
aa
aa
aa
aa
aa
aa
aa
aa
aa
aa
aa
aa
aa
aa
aa
ab
"}
(88,1,1) = {"
ab
aa
aa
aa
aa
aa
aa
aa
aa
aa
aa
aa
aa
aa
aa
aa
aa
aa
aa
aa
aa
aa
aa
aa
aa
aa
aa
aa
aa
aa
aa
aa
aa
aa
aa
aa
aa
aa
aa
aa
aa
aa
aa
aa
ab
"}
(89,1,1) = {"
ab
aa
aa
aa
aa
aa
aa
aa
aa
aa
aa
aa
aa
aa
aa
aa
aa
aa
aa
aa
aa
aa
aa
aa
aa
aa
aa
aa
aa
aa
aa
aa
aa
aa
aa
aa
aa
aa
aa
aa
aa
aa
aa
aa
ab
"}
(90,1,1) = {"
ab
aa
aa
aa
aa
aa
aa
aa
aa
aa
aa
aa
aa
aa
aa
aa
aa
aa
aa
aa
aa
aa
aa
aa
aa
aa
aa
aa
aa
aa
aa
aa
aa
aa
aa
aa
aa
aa
aa
aa
aa
aa
aa
aa
ab
"}
(91,1,1) = {"
ab
aa
aa
aa
aa
aa
aa
aa
aa
aa
aa
aa
aa
aa
aa
aa
aa
aa
aa
aa
aa
aa
aa
aa
aa
aa
aa
aa
aa
aa
aa
aa
aa
aa
aa
aa
aa
aa
aa
aa
aa
aa
aa
aa
ab
"}
(92,1,1) = {"
ab
aa
aa
aa
aa
aa
aa
aa
aa
aa
aa
aa
aa
aa
aa
aa
aa
aa
aa
aa
aa
aa
aa
aa
aa
aa
aa
aa
aa
aa
aa
aa
aa
aa
aa
aa
aa
aa
aa
aa
aa
aa
aa
aa
ab
"}
(93,1,1) = {"
ab
aa
aa
aa
aa
aa
aa
aa
aa
aa
aa
aa
aa
aa
aa
aa
aa
aa
aa
aa
aa
aa
aa
aa
aa
aa
aa
aa
aa
aa
aa
aa
aa
aa
aa
aa
aa
aa
aa
aa
aa
aa
aa
aa
ab
"}
(94,1,1) = {"
ab
aa
aa
aa
aa
aa
aa
aa
aa
aa
aa
aa
aa
aa
aa
aa
aa
aa
aa
aa
aa
aa
aa
aa
aa
aa
aa
aa
aa
aa
aa
aa
aa
aa
aa
aa
aa
aa
aa
aa
aa
aa
aa
aa
ab
"}
(95,1,1) = {"
ab
aa
aa
aa
aa
aa
aa
aa
aa
aa
aa
aa
aa
aa
aa
aa
aa
aa
aa
aa
aa
aa
aa
aa
aa
aa
aa
aa
aa
aa
aa
aa
aa
aa
aa
aa
aa
aa
aa
aa
aa
aa
aa
aa
ab
"}
(96,1,1) = {"
ab
aa
aa
aa
aa
aa
aa
aa
aa
aa
aa
aa
aa
aa
aa
aa
aa
aa
aa
aa
aa
aa
aa
aa
aa
aa
aa
aa
aa
aa
aa
aa
aa
aa
aa
aa
aa
aa
aa
aa
aa
aa
aa
aa
ab
"}
(97,1,1) = {"
ab
aa
aa
aa
aa
aa
aa
aa
aa
aa
aa
aa
aa
aa
aa
aa
aa
aa
aa
aa
aa
aa
aa
aa
aa
aa
aa
aa
aa
aa
aa
aa
aa
aa
aa
aa
aa
aa
aa
aa
aa
aa
aa
aa
ab
"}
(98,1,1) = {"
ab
aa
aa
aa
aa
aa
aa
aa
aa
aa
aa
aa
aa
aa
aa
aa
aa
aa
aa
aa
aa
aa
aa
aa
aa
aa
aa
aa
aa
aa
aa
aa
aa
aa
aa
aa
aa
aa
aa
aa
aa
aa
aa
aa
ab
"}
(99,1,1) = {"
ab
aa
aa
aa
aa
aa
aa
aa
aa
aa
aa
aa
aa
aa
aa
aa
aa
aa
aa
aa
aa
aa
aa
aa
aa
aa
aa
aa
aa
aa
aa
aa
aa
aa
aa
aa
aa
aa
aa
aa
aa
aa
aa
aa
ab
"}
(100,1,1) = {"
ab
aa
aa
aa
aa
aa
aa
aa
aa
aa
aa
aa
aa
aa
aa
aa
aa
aa
aa
aa
aa
aa
aa
aa
aa
aa
aa
aa
aa
aa
aa
aa
aa
aa
aa
aa
aa
aa
aa
aa
aa
aa
aa
aa
ab
"}
(101,1,1) = {"
ab
aa
aa
aa
aa
aa
aa
aa
aa
aa
aa
aa
aa
aa
aa
aa
aa
aa
aa
aa
aa
aa
aa
aa
aa
aa
aa
aa
aa
aa
aa
aa
aa
aa
aa
aa
aa
aa
aa
aa
aa
aa
aa
aa
ab
"}
(102,1,1) = {"
ab
ab
ab
ab
ab
ab
ab
ab
ab
ab
ab
ab
ab
ab
ab
ab
ab
ab
ab
ab
ab
ab
ab
ab
ab
ab
ab
ab
ab
ab
ab
ab
ab
ab
ab
ab
ab
ab
ab
ab
ab
ab
ab
ab
ab
"}
