//MAP CONVERTED BY dmm2tgm.py THIS HEADER COMMENT PREVENTS RECONVERSION, DO NOT REMOVE
"aa" = (
/turf/background_canvas,
/area)
"ab" = (
/turf/unsimulated/wall/void,
/area)
"cH" = (
/obj/storage/secure/closet/engineering,
/turf/simulated/floor/engine,
/area/ship/manta)
"cM" = (
/obj/machinery/lrteleporter/planetary_teleporter{
	ship_id = "manta"
	},
/turf/simulated/floor/engine,
/area/ship/manta)
"cQ" = (
/obj/machinery/door/airlock/gannets/glass/command/alt,
/turf/simulated/floor/carpet{
	dir = 4;
	icon_state = "fblue4"
	},
/area/ship/manta)
"dv" = (
/obj/stool/bed,
/obj/item/clothing/suit/bedsheet{
	bcolor = "red";
	icon_state = "bedsheet-red"
	},
/turf/simulated/floor/carpet{
	dir = 2;
	icon_state = "red2"
	},
/area/ship/manta)
"dG" = (
/obj/machinery/communications_dish,
/obj/machinery/power/data_terminal,
/turf/simulated/floor/circuit/off,
/area/ship/manta)
"dP" = (
/obj/machinery/door/airlock/gannets/glass/toxins,
/turf/simulated/floor/engine,
/area/ship/manta)
"eA" = (
/obj/machinery/vending/cigarette,
/turf/simulated/floor/carpet{
	dir = 6;
	icon_state = "red2"
	},
/area/ship/manta)
"fc" = (
/obj/machinery/clone_scanner,
/obj/machinery/power/data_terminal,
/turf/simulated/floor/bluegreen,
/area/ship/manta)
"fm" = (
/obj/machinery/door/airlock/gannets/chemistry,
/turf/simulated/floor/purple,
/area/ship/manta)
"fB" = (
/obj/stool/chair/couch/green{
	dir = 8;
	icon_state = "chair_couch-green"
	},
/turf/simulated/floor/carpet{
	dir = 9;
	icon_state = "green2"
	},
/area/ship/manta)
"fJ" = (
/turf/simulated/floor/carpet{
	dir = 10;
	icon_state = "fblue2"
	},
/area/ship/manta)
"fS" = (
/obj/stool/bed,
/obj/item/clothing/suit/bedsheet{
	bcolor = "green";
	icon_state = "bedsheet-green"
	},
/turf/simulated/floor/carpet{
	dir = 2;
	icon_state = "green2"
	},
/area/ship/manta)
"gl" = (
/obj/table/auto,
/obj/submachine/mixer,
/turf/simulated/floor/blue/checker,
/area/ship/manta)
"gm" = (
/obj/machinery/door/airlock/gannets/glass/command/alt,
/turf/simulated/floor/carpet{
	dir = 8;
	icon_state = "fblue4"
	},
/area/ship/manta)
"hq" = (
/turf/simulated/floor/circuit/off,
/area/ship/manta)
"hB" = (
/turf/simulated/floor/carpet{
	dir = 1;
	icon_state = "red2"
	},
/area/ship/manta)
"ia" = (
/obj/storage/secure/closet/medical,
/turf/simulated/floor/specialroom/medbay,
/area/ship/manta)
"iE" = (
/obj/machinery/sim/vr_bed/flight_chair{
	stars_id = "manta"
	},
/turf/simulated/floor/carpet{
	dir = 10;
	icon_state = "fblue1"
	},
/area/ship/manta)
"iO" = (
/turf/simulated/floor/carpet{
	dir = 9;
	icon_state = "green3"
	},
/area/ship/manta)
"jp" = (
/turf/simulated/floor/carpet{
	dir = 5;
	icon_state = "red3"
	},
/area/ship/manta)
"jr" = (
/obj/item/storage/toilet{
	dir = 4;
	icon_state = "toilet"
	},
/turf/simulated/floor/purple,
/area/ship/manta)
"jy" = (
/obj/submachine/chef_oven{
	dir = 4;
	icon_state = "oven_off"
	},
/turf/simulated/floor/blue/checker,
/area/ship/manta)
"jA" = (
/turf/unsimulated/wall/setpieces/leadwindow{
	dir = 8;
	icon_state = "leadwindow_1"
	},
/area/ship/manta)
"jB" = (
/obj/stool/chair{
	dir = 1;
	icon_state = "chair"
	},
/turf/simulated/floor/blue/checker,
/area/ship/manta)
"jX" = (
/obj/submachine/laundry_machine,
/turf/simulated/floor/purple,
/area/ship/manta)
"kF" = (
/obj/storage/secure/closet/research/chemical,
/turf/simulated/floor/specialroom/medbay,
/area/ship/manta)
"kH" = (
/obj/machinery/networked/mainframe,
/obj/machinery/power/data_terminal,
/turf/simulated/floor/circuit/off,
/area/ship/manta)
"lQ" = (
/obj/machinery/clonegrinder,
/obj/machinery/power/data_terminal,
/turf/simulated/floor/bluegreen,
/area/ship/manta)
"lR" = (
/obj/machinery/power/smes,
/turf/simulated/floor/engine,
/area/ship/manta)
"ne" = (
/obj/stool/chair/comfy/blue{
	dir = 8
	},
/turf/simulated/floor/carpet{
	dir = 4;
	icon_state = "fblue2"
	},
/area/ship/manta)
"nw" = (
/obj/table/wood/auto,
/turf/simulated/floor/carpet{
	dir = 5;
	icon_state = "fblue3"
	},
/area/ship/manta)
"ny" = (
/obj/stool/chair/office/blue{
	dir = 1;
	icon_state = "office_chair_blue"
	},
/turf/simulated/floor/carpet{
	dir = 1;
	icon_state = "fblue2"
	},
/area/ship/manta)
"or" = (
/turf/simulated/floor/purple,
/area/ship/manta)
"oE" = (
/turf/simulated/floor/carpet{
	dir = 2;
	icon_state = "fblue2"
	},
/area/ship/manta)
"pl" = (
/turf/unsimulated/wall/auto/lead/blue{
	desc = "Seems pretty sturdy.";
	name = "shield wall"
	},
/area/ship/manta)
"qy" = (
/obj/machinery/door/airlock/gannets/glass/security,
/turf/simulated/floor/black,
/area/ship/manta)
"rv" = (
/turf/simulated/floor/carpet{
	dir = 8;
	icon_state = "red2"
	},
/area/ship/manta)
"sf" = (
/obj/machinery/vending/cola/blue,
/turf/simulated/floor/carpet{
	dir = 6;
	icon_state = "green2"
	},
/area/ship/manta)
"sH" = (
/obj/machinery/optable,
/obj/item/surgical_spoon,
/obj/item/suture,
/obj/item/scalpel,
/obj/item/circular_saw,
/turf/simulated/floor/specialroom/medbay,
/area/ship/manta)
"ti" = (
/obj/machinery/door/airlock/gannets/glass/medical,
/turf/simulated/floor/black,
/area/ship/manta)
"uQ" = (
/turf/simulated/floor/carpet{
	dir = 4;
	icon_state = "green2"
	},
/area/ship/manta)
"vV" = (
/turf/simulated/floor/carpet{
	dir = 9;
	icon_state = "fblue2"
	},
/area/ship/manta)
"wu" = (
/obj/ladder{
	desc = "A ladder.";
	id = "artemis";
	layer = 2.5;
	pixel_y = -12
	},
/turf/simulated/floor/black,
/area/ship/manta)
"wW" = (
/obj/machinery/computer/announcement,
/obj/machinery/power/data_terminal,
/turf/simulated/floor/carpet{
	dir = 4;
	icon_state = "fblue4"
	},
/area/ship/manta)
"xH" = (
/turf/simulated/floor/carpet{
	dir = 1;
	icon_state = "green2"
	},
/area/ship/manta)
"yj" = (
/turf/simulated/floor/carpet{
	dir = 6;
	icon_state = "green3"
	},
/area/ship/manta)
"yK" = (
/turf/simulated/floor/carpet{
	dir = 4;
	icon_state = "red2"
	},
/area/ship/manta)
"zN" = (
/obj/stool/chair/couch/red{
	dir = 4;
	icon_state = "chair_couch-red"
	},
/turf/simulated/floor/carpet{
	dir = 5;
	icon_state = "red2"
	},
/area/ship/manta)
"Aq" = (
/obj/storage/closet/fire,
/turf/simulated/floor/engine,
/area/ship/manta)
"BB" = (
/obj/decal/fakeobjects/shuttlethruster,
/obj/decal/fakeobjects/shuttlethruster,
/turf/space,
/area/ship/manta)
"Cl" = (
/obj/table/wood/auto,
/turf/simulated/floor/carpet{
	dir = 9;
	icon_state = "fblue3"
	},
/area/ship/manta)
"Cn" = (
/obj/machinery/computer/cloning{
	dir = 8;
	icon_state = "dna"
	},
/obj/machinery/power/data_terminal,
/turf/simulated/floor/bluegreen,
/area/ship/manta)
"Dz" = (
/turf/simulated/floor/carpet{
	dir = 6;
	icon_state = "fblue2"
	},
/area/ship/manta)
"Ei" = (
/obj/machinery/door/airlock/gannets/engineering/alt,
/turf/simulated/floor/black,
/area/ship/manta)
"Et" = (
/obj/machinery/door/airlock/gannets/glass,
/turf/simulated/floor/blue/checker,
/area/ship/manta)
"Fe" = (
/obj/decal/fakeobjects/shuttlethruster,
/turf/space,
/area/ship/manta)
"Fw" = (
/obj/machinery/clonepod,
/obj/machinery/power/data_terminal,
/turf/simulated/floor/bluegreen,
/area/ship/manta)
"FK" = (
/obj/table/auto,
/obj/machinery/chem_heater,
/turf/simulated/floor/specialroom/medbay,
/area/ship/manta)
"FY" = (
/obj/submachine/chef_sink/chem_sink{
	dir = 4;
	pixel_x = -8
	},
/turf/simulated/floor/blue/checker,
/area/ship/manta)
"Gf" = (
/obj/machinery/vending/port_a_nanomed,
/turf/simulated/floor/specialroom/medbay,
/area/ship/manta)
"Gv" = (
/obj/stool/chair,
/turf/simulated/floor/blue/checker,
/area/ship/manta)
"GA" = (
/turf/simulated/floor/carpet{
	dir = 5;
	icon_state = "fblue2"
	},
/area/ship/manta)
"GJ" = (
/obj/stool/chair/office{
	dir = 1;
	icon_state = "office_chair"
	},
/turf/simulated/floor/specialroom/medbay,
/area/ship/manta)
"GN" = (
/turf/simulated/floor/specialroom/medbay,
/area/ship/manta)
"GR" = (
/obj/machinery/power/rtg,
/turf/simulated/floor/engine,
/area/ship/manta)
"Ha" = (
/obj/machinery/door/airlock/gannets/glass/medical,
/turf/simulated/floor/bluegreen,
/area/ship/manta)
"Hp" = (
/turf/simulated/floor/bluegreen,
/area/ship/manta)
"Ib" = (
/obj/machinery/door/airlock/gannets/chemistry,
/turf/simulated/floor/black,
/area/ship/manta)
"Ik" = (
/turf/unsimulated/wall/setpieces/leadwindow{
	dir = 4;
	icon_state = "leadwindow_1"
	},
/area/ship/manta)
"Ju" = (
/obj/machinery/vending/snack,
/turf/simulated/floor/blue/checker,
/area/ship/manta)
"Jw" = (
/obj/table/auto,
/obj/machinery/chem_master,
/turf/simulated/floor/specialroom/medbay,
/area/ship/manta)
"JI" = (
/obj/table/auto,
/obj/item/storage/box/cutlery,
/obj/item/storage/box/plates,
/turf/simulated/floor/blue/checker,
/area/ship/manta)
"JZ" = (
/obj/ladder{
	desc = "A ladder.";
	icon_state = "ladder_wall";
	id = "artemis";
	layer = 2.5;
	pixel_y = 32
	},
/turf/simulated/floor/black,
/area/ship/manta)
"Kc" = (
/obj/storage/secure/closet/fridge,
/turf/simulated/floor/blue/checker,
/area/ship/manta)
"KH" = (
/obj/stool/chair/couch/red{
	dir = 8;
	icon_state = "chair_couch-red"
	},
/turf/simulated/floor/carpet{
	dir = 9;
	icon_state = "red2"
	},
/area/ship/manta)
"KQ" = (
/turf/simulated/floor/carpet{
	dir = 8;
	icon_state = "green2"
	},
/area/ship/manta)
"LF" = (
/obj/table/auto,
/obj/machinery/chem_dispenser,
/turf/simulated/floor/specialroom/medbay,
/area/ship/manta)
"LK" = (
/obj/decal/fakeobjects/shuttlethruster{
	dir = 1;
	icon_state = "propulsion"
	},
/turf/background_canvas,
/area/ship/manta)
"Mn" = (
/obj/table/auto,
/obj/item/storage/box/syringes,
/obj/item/remote/porter/port_a_nanomed,
/turf/simulated/floor/specialroom/medbay,
/area/ship/manta)
"Na" = (
/turf/simulated/floor/blue/checker,
/area/ship/manta)
"Nm" = (
/turf/simulated/floor/black,
/area/ship/manta)
"Oe" = (
/obj/machinery/computer/communications,
/obj/machinery/power/data_terminal,
/turf/simulated/floor/carpet{
	dir = 8;
	icon_state = "fblue4"
	},
/area/ship/manta)
"Oy" = (
/obj/stool/bed,
/obj/item/clothing/suit/bedsheet{
	bcolor = "red";
	icon_state = "bedsheet-red"
	},
/turf/simulated/floor/carpet{
	dir = 10;
	icon_state = "red2"
	},
/area/ship/manta)
"QR" = (
/obj/table/auto,
/obj/item/storage/box/iv_box,
/obj/item/storage/box/patchbox,
/obj/item/kitchen/food_box/lollipop,
/turf/simulated/floor/specialroom/medbay,
/area/ship/manta)
"Rq" = (
/obj/machinery/vending/cola/red,
/turf/simulated/floor/carpet{
	dir = 10;
	icon_state = "red2"
	},
/area/ship/manta)
"RO" = (
/obj/machinery/vending/kitchen,
/turf/simulated/floor/blue/checker,
/area/ship/manta)
"St" = (
/obj/machinery/bathtub{
	anchored = 1;
	dir = 4
	},
/turf/simulated/floor/purple,
/area/ship/manta)
"Ta" = (
/obj/stool/chair/couch/green{
	dir = 4;
	icon_state = "chair_couch-green"
	},
/turf/simulated/floor/carpet{
	dir = 5;
	icon_state = "green2"
	},
/area/ship/manta)
"Tb" = (
/obj/storage/closet/biohazard,
/turf/simulated/floor/engine,
/area/ship/manta)
"TS" = (
/obj/machinery/door/airlock/gannets/glass,
/turf/simulated/floor/black,
/area/ship/manta)
"Ud" = (
/turf/unsimulated/wall/setpieces/leadwindow,
/area/ship/manta)
"Vc" = (
/turf/simulated/floor/carpet{
	dir = 10;
	icon_state = "red3"
	},
/area/ship/manta)
"Vg" = (
/obj/stool/bed,
/obj/item/clothing/suit/bedsheet{
	bcolor = "green";
	icon_state = "bedsheet-green"
	},
/turf/simulated/floor/carpet{
	dir = 6;
	icon_state = "green2"
	},
/area/ship/manta)
"WB" = (
/turf/simulated/floor/engine,
/area/ship/manta)
"Xg" = (
/turf/simulated/floor/carpet{
	dir = 5;
	icon_state = "red2"
	},
/area/ship/manta)
"Xs" = (
/obj/table/wood/auto,
/turf/simulated/floor/carpet{
	dir = 10;
	icon_state = "fblue3"
	},
/area/ship/manta)
"Xu" = (
/turf/simulated/floor/carpet{
	dir = 9;
	icon_state = "green2"
	},
/area/ship/manta)
"Xy" = (
/obj/rack,
/obj/item/clothing/suit/rad,
/obj/item/clothing/head/rad_hood,
/turf/simulated/floor/black,
/area/ship/manta)
"XI" = (
/obj/stool/chair/office{
	dir = 4;
	icon_state = "office_chair"
	},
/turf/simulated/floor/bluegreen,
/area/ship/manta)
"XN" = (
/obj/machinery/vending/coffee,
/turf/simulated/floor/carpet{
	dir = 10;
	icon_state = "green2"
	},
/area/ship/manta)
"XR" = (
/obj/stool/chair/comfy/blue{
	dir = 4
	},
/turf/simulated/floor/carpet{
	dir = 8;
	icon_state = "fblue2"
	},
/area/ship/manta)
"Zc" = (
/turf/simulated/floor/stairs{
	dir = 1
	},
/area/ship/manta)
"Zt" = (
/obj/table/wood/auto,
/turf/simulated/floor/carpet{
	dir = 6;
	icon_state = "fblue3"
	},
/area/ship/manta)
"Zu" = (
/obj/table/auto,
/obj/item/storage/box/beakerbox,
/turf/simulated/floor/specialroom/medbay,
/area/ship/manta)

(1,1,1) = {"
ab
ab
ab
ab
ab
ab
ab
ab
ab
ab
ab
ab
ab
ab
ab
ab
ab
ab
ab
ab
ab
ab
ab
ab
ab
ab
ab
ab
ab
ab
ab
ab
ab
ab
ab
ab
ab
ab
ab
ab
ab
ab
ab
ab
ab
"}
(2,1,1) = {"
ab
aa
aa
aa
aa
aa
aa
aa
aa
aa
aa
aa
aa
aa
aa
aa
aa
aa
aa
aa
aa
aa
aa
aa
aa
aa
aa
aa
aa
aa
aa
aa
aa
aa
aa
aa
aa
aa
aa
aa
aa
aa
aa
aa
ab
"}
(3,1,1) = {"
ab
aa
aa
aa
aa
aa
aa
aa
aa
aa
aa
aa
aa
aa
aa
aa
aa
aa
aa
aa
aa
aa
aa
aa
aa
aa
aa
aa
aa
aa
aa
aa
aa
aa
aa
aa
aa
aa
aa
aa
aa
aa
aa
aa
ab
"}
(4,1,1) = {"
ab
aa
aa
aa
aa
aa
aa
aa
aa
aa
aa
aa
aa
aa
aa
aa
aa
aa
aa
aa
aa
aa
aa
aa
aa
aa
aa
aa
aa
aa
aa
aa
aa
aa
aa
aa
aa
aa
aa
aa
aa
aa
aa
aa
ab
"}
(5,1,1) = {"
ab
aa
aa
aa
aa
aa
aa
aa
aa
aa
aa
aa
aa
aa
aa
aa
aa
aa
aa
aa
aa
aa
aa
aa
aa
aa
aa
aa
aa
aa
aa
aa
aa
aa
aa
aa
aa
aa
aa
aa
aa
aa
aa
aa
ab
"}
(6,1,1) = {"
ab
aa
aa
aa
aa
aa
aa
aa
aa
aa
aa
aa
aa
aa
aa
aa
aa
aa
aa
aa
aa
aa
aa
aa
aa
aa
aa
aa
aa
aa
aa
aa
aa
aa
aa
aa
aa
aa
aa
aa
aa
aa
aa
aa
ab
"}
(7,1,1) = {"
ab
aa
aa
aa
aa
aa
aa
aa
aa
aa
aa
aa
aa
aa
aa
aa
aa
aa
aa
aa
aa
aa
aa
aa
aa
aa
aa
aa
aa
aa
aa
aa
aa
aa
aa
aa
aa
aa
aa
aa
aa
aa
aa
aa
ab
"}
(8,1,1) = {"
ab
aa
aa
aa
aa
aa
aa
aa
aa
aa
aa
aa
aa
aa
aa
aa
aa
aa
aa
aa
aa
aa
aa
aa
aa
aa
aa
aa
aa
aa
aa
aa
aa
aa
aa
aa
aa
aa
aa
aa
aa
aa
aa
aa
ab
"}
(9,1,1) = {"
ab
aa
aa
aa
aa
aa
aa
aa
aa
aa
aa
aa
aa
aa
aa
aa
aa
aa
aa
aa
aa
aa
aa
aa
aa
aa
aa
aa
aa
aa
aa
aa
aa
aa
aa
aa
aa
aa
aa
aa
aa
aa
aa
aa
ab
"}
(10,1,1) = {"
ab
aa
aa
aa
aa
aa
aa
aa
aa
aa
aa
aa
aa
aa
aa
aa
aa
aa
aa
aa
aa
aa
aa
aa
aa
aa
aa
aa
aa
aa
aa
aa
aa
aa
aa
aa
aa
aa
aa
aa
aa
aa
aa
aa
ab
"}
(11,1,1) = {"
ab
aa
aa
aa
aa
aa
aa
aa
aa
aa
aa
aa
aa
aa
aa
aa
aa
aa
aa
aa
aa
aa
aa
aa
aa
aa
aa
aa
aa
aa
aa
aa
aa
aa
aa
aa
aa
aa
aa
aa
aa
aa
aa
aa
ab
"}
(12,1,1) = {"
ab
aa
aa
aa
aa
aa
aa
aa
aa
aa
aa
aa
aa
aa
aa
aa
aa
aa
aa
aa
aa
aa
aa
aa
aa
aa
aa
aa
aa
aa
aa
aa
aa
aa
aa
aa
aa
aa
aa
aa
aa
aa
aa
aa
ab
"}
(13,1,1) = {"
ab
aa
aa
aa
aa
aa
aa
aa
aa
aa
aa
aa
aa
aa
aa
aa
aa
aa
aa
aa
aa
aa
aa
aa
aa
aa
pl
Ud
Ud
pl
aa
aa
aa
aa
aa
aa
aa
aa
aa
aa
aa
aa
aa
aa
ab
"}
(14,1,1) = {"
ab
aa
aa
aa
aa
aa
aa
aa
aa
aa
aa
aa
aa
aa
aa
aa
aa
aa
aa
aa
aa
aa
aa
pl
Ud
pl
pl
St
jr
pl
Fe
aa
aa
aa
aa
aa
aa
aa
aa
aa
aa
aa
aa
aa
ab
"}
(15,1,1) = {"
ab
aa
aa
aa
aa
aa
aa
aa
aa
aa
aa
aa
aa
aa
aa
aa
aa
aa
aa
aa
aa
pl
Ud
pl
Nm
Nm
Ib
or
or
pl
Fe
aa
aa
aa
aa
aa
aa
aa
aa
aa
aa
aa
aa
aa
ab
"}
(16,1,1) = {"
ab
aa
aa
aa
aa
aa
aa
aa
aa
aa
aa
aa
aa
aa
aa
aa
aa
aa
aa
pl
Ud
pl
Nm
Nm
Nm
pl
pl
jX
or
pl
Fe
aa
aa
aa
aa
aa
aa
aa
aa
aa
aa
aa
aa
aa
ab
"}
(17,1,1) = {"
ab
aa
aa
aa
aa
aa
aa
aa
aa
aa
aa
aa
aa
aa
aa
aa
aa
aa
pl
pl
Nm
Nm
Nm
pl
pl
pl
pl
pl
fm
pl
pl
aa
aa
aa
aa
aa
aa
aa
aa
aa
aa
aa
aa
aa
ab
"}
(18,1,1) = {"
ab
aa
aa
aa
aa
aa
aa
aa
aa
aa
aa
aa
aa
aa
aa
aa
aa
pl
pl
Nm
Nm
pl
pl
pl
kF
ia
pl
KH
rv
Oy
jA
aa
aa
aa
aa
aa
aa
aa
aa
aa
aa
aa
aa
aa
ab
"}
(19,1,1) = {"
ab
aa
aa
aa
aa
aa
aa
aa
aa
aa
aa
aa
aa
aa
aa
aa
pl
pl
Nm
Nm
pl
pl
pl
Gf
GN
sH
pl
zN
jp
dv
jA
aa
aa
aa
aa
aa
aa
aa
aa
aa
aa
aa
aa
aa
ab
"}
(20,1,1) = {"
ab
aa
aa
aa
aa
aa
aa
aa
aa
aa
aa
aa
aa
aa
aa
pl
pl
Nm
Nm
pl
pl
Hp
Ha
GN
GN
GN
pl
pl
hB
dv
pl
pl
aa
aa
aa
aa
aa
aa
aa
aa
aa
aa
aa
aa
ab
"}
(21,1,1) = {"
ab
aa
aa
aa
aa
aa
aa
aa
aa
aa
aa
aa
pl
Ud
pl
pl
Nm
Nm
pl
pl
Hp
Hp
pl
Jw
GN
GN
QR
pl
hB
Vc
Rq
jA
aa
aa
aa
aa
aa
aa
aa
aa
aa
aa
aa
aa
ab
"}
(22,1,1) = {"
ab
aa
aa
aa
aa
aa
aa
aa
aa
aa
aa
pl
pl
cM
WB
dP
Nm
pl
pl
Hp
XI
Hp
pl
LF
GJ
GN
Mn
pl
Xg
yK
eA
pl
Ud
pl
pl
aa
aa
aa
aa
aa
aa
aa
aa
aa
ab
"}
(23,1,1) = {"
ab
aa
aa
aa
aa
aa
aa
aa
aa
aa
pl
pl
pl
Ud
pl
pl
Nm
pl
lQ
Fw
Cn
fc
pl
FK
GN
GN
Zu
pl
qy
pl
pl
pl
Nm
Nm
pl
Fe
aa
aa
aa
aa
aa
aa
aa
aa
ab
"}
(24,1,1) = {"
ab
aa
aa
aa
aa
aa
aa
aa
aa
pl
pl
vV
XR
XR
fJ
pl
Nm
pl
pl
pl
Ud
pl
pl
pl
Ud
ti
pl
pl
Nm
Nm
pl
Nm
Nm
Nm
pl
Fe
aa
aa
aa
aa
aa
aa
aa
aa
ab
"}
(25,1,1) = {"
ab
aa
aa
aa
aa
aa
aa
aa
aa
Ik
Oe
ny
Zt
nw
oE
gm
Nm
Nm
Nm
Nm
Nm
Nm
Nm
Nm
Nm
Nm
Nm
Nm
Nm
Nm
Ei
Nm
Nm
Nm
pl
Fe
aa
aa
aa
aa
aa
aa
aa
aa
ab
"}
(26,1,1) = {"
ab
aa
aa
aa
aa
aa
aa
aa
aa
Ik
iE
ny
Xs
Cl
oE
cQ
Nm
Nm
Nm
Nm
Nm
Nm
Nm
Nm
Nm
Nm
Nm
Nm
Nm
Nm
Ei
Nm
Nm
Nm
pl
Fe
aa
aa
aa
aa
aa
aa
aa
aa
ab
"}
(27,1,1) = {"
ab
aa
aa
aa
aa
aa
aa
aa
aa
Ik
wW
ny
Xs
Cl
oE
cQ
Nm
Nm
Nm
Nm
Nm
Nm
Nm
Nm
Nm
Nm
Nm
Nm
Nm
Nm
Ei
Nm
Nm
Nm
pl
Fe
aa
aa
aa
aa
aa
aa
aa
aa
ab
"}
(28,1,1) = {"
ab
aa
aa
aa
aa
aa
aa
aa
aa
pl
pl
GA
ne
ne
Dz
pl
Nm
Nm
Nm
Nm
Nm
Nm
Nm
Nm
Nm
Nm
Nm
Nm
Nm
Nm
pl
Nm
Nm
Nm
pl
BB
aa
aa
aa
aa
aa
aa
aa
aa
ab
"}
(29,1,1) = {"
ab
aa
aa
aa
aa
aa
aa
aa
aa
aa
pl
pl
pl
hq
hq
pl
Nm
Nm
Nm
Nm
Nm
Nm
Nm
Nm
Nm
Nm
Nm
pl
TS
pl
pl
pl
Nm
Nm
pl
Fe
aa
aa
aa
aa
aa
aa
aa
aa
ab
"}
(30,1,1) = {"
ab
aa
aa
aa
aa
aa
aa
aa
aa
aa
aa
pl
pl
dG
kH
pl
Nm
Nm
Nm
Nm
Nm
Nm
Nm
Nm
Nm
Nm
Nm
pl
Xu
KQ
XN
pl
Ud
pl
pl
aa
aa
aa
aa
aa
aa
aa
aa
aa
ab
"}
(31,1,1) = {"
ab
aa
aa
aa
aa
aa
aa
aa
aa
aa
aa
aa
pl
Ud
pl
pl
wu
Nm
Nm
Nm
Nm
Nm
Nm
Nm
Nm
Nm
Nm
pl
xH
yj
sf
jA
aa
aa
aa
aa
aa
aa
aa
aa
aa
aa
aa
aa
ab
"}
(32,1,1) = {"
ab
aa
aa
aa
aa
aa
aa
aa
aa
aa
aa
aa
aa
aa
aa
pl
pl
Nm
Nm
Nm
Nm
Nm
Nm
Nm
Nm
Nm
pl
pl
xH
fS
pl
pl
aa
aa
aa
aa
aa
aa
aa
aa
aa
aa
aa
aa
ab
"}
(33,1,1) = {"
ab
aa
aa
aa
aa
aa
aa
aa
aa
aa
aa
aa
aa
aa
aa
aa
pl
pl
Nm
Nm
Nm
Nm
Nm
Nm
Nm
Nm
pl
fB
iO
fS
jA
aa
aa
aa
aa
aa
aa
aa
aa
aa
aa
aa
aa
aa
ab
"}
(34,1,1) = {"
ab
aa
aa
aa
aa
aa
aa
aa
aa
aa
aa
aa
aa
aa
aa
aa
aa
pl
pl
Nm
Nm
pl
pl
pl
pl
pl
pl
Ta
uQ
Vg
jA
aa
aa
aa
aa
aa
aa
aa
aa
aa
aa
aa
aa
aa
ab
"}
(35,1,1) = {"
ab
aa
aa
aa
aa
aa
aa
aa
aa
aa
aa
aa
aa
aa
aa
aa
aa
aa
pl
pl
Nm
TS
Na
FY
jy
RO
pl
pl
Et
pl
pl
aa
aa
aa
aa
aa
aa
aa
aa
aa
aa
aa
aa
aa
ab
"}
(36,1,1) = {"
ab
aa
aa
aa
aa
aa
aa
aa
aa
aa
aa
aa
aa
aa
aa
aa
aa
aa
aa
pl
Ud
pl
Kc
Na
Na
Na
Na
Na
Na
pl
Fe
aa
aa
aa
aa
aa
aa
aa
aa
aa
aa
aa
aa
aa
ab
"}
(37,1,1) = {"
ab
aa
aa
aa
aa
aa
aa
aa
aa
aa
aa
aa
aa
aa
aa
aa
aa
aa
aa
aa
aa
pl
Ud
pl
Gv
JI
jB
Na
Na
pl
Fe
aa
aa
aa
aa
aa
aa
aa
aa
aa
aa
aa
aa
aa
ab
"}
(38,1,1) = {"
ab
aa
aa
aa
aa
aa
aa
aa
aa
aa
aa
aa
aa
aa
aa
aa
aa
aa
aa
aa
aa
aa
aa
pl
Ud
pl
pl
Ju
gl
pl
Fe
aa
aa
aa
aa
aa
aa
aa
aa
aa
aa
aa
aa
aa
ab
"}
(39,1,1) = {"
ab
aa
aa
aa
aa
aa
aa
aa
aa
aa
aa
aa
aa
aa
aa
aa
aa
aa
aa
aa
aa
aa
aa
aa
aa
aa
pl
Ud
Ud
pl
aa
aa
aa
aa
aa
aa
aa
aa
aa
aa
aa
aa
aa
aa
ab
"}
(40,1,1) = {"
ab
aa
aa
aa
aa
aa
aa
aa
aa
aa
aa
aa
aa
aa
aa
aa
aa
aa
aa
aa
aa
aa
aa
aa
aa
aa
aa
aa
aa
aa
aa
aa
aa
aa
aa
aa
aa
aa
aa
aa
aa
aa
aa
aa
ab
"}
(41,1,1) = {"
ab
aa
aa
aa
aa
aa
aa
aa
aa
aa
aa
aa
aa
aa
aa
aa
aa
aa
aa
aa
aa
aa
aa
aa
aa
aa
aa
aa
aa
aa
aa
aa
aa
aa
aa
aa
aa
aa
aa
aa
aa
aa
aa
aa
ab
"}
(42,1,1) = {"
ab
aa
aa
aa
aa
aa
aa
aa
aa
aa
aa
aa
aa
aa
aa
aa
aa
aa
aa
aa
aa
aa
aa
aa
aa
aa
aa
aa
aa
aa
aa
aa
aa
aa
aa
aa
aa
aa
aa
aa
aa
aa
aa
aa
ab
"}
(43,1,1) = {"
ab
aa
aa
aa
aa
aa
aa
aa
aa
aa
aa
aa
aa
aa
aa
aa
aa
aa
aa
aa
aa
aa
aa
aa
aa
aa
aa
aa
aa
aa
aa
aa
aa
aa
aa
aa
aa
aa
aa
aa
aa
aa
aa
aa
ab
"}
(44,1,1) = {"
ab
aa
aa
aa
aa
aa
aa
aa
aa
aa
aa
aa
aa
aa
aa
aa
aa
aa
aa
aa
aa
aa
aa
aa
aa
aa
aa
aa
aa
aa
aa
aa
aa
aa
aa
aa
aa
aa
aa
aa
aa
aa
aa
aa
ab
"}
(45,1,1) = {"
ab
aa
aa
aa
aa
aa
aa
aa
aa
aa
aa
aa
aa
aa
aa
aa
aa
aa
aa
aa
aa
aa
aa
aa
aa
aa
aa
aa
aa
aa
aa
aa
aa
aa
aa
aa
aa
aa
aa
aa
aa
aa
aa
aa
ab
"}
(46,1,1) = {"
ab
aa
aa
aa
aa
aa
aa
aa
aa
aa
aa
aa
aa
aa
aa
aa
aa
aa
aa
aa
aa
aa
aa
aa
aa
aa
aa
aa
aa
aa
aa
aa
aa
aa
aa
aa
aa
aa
aa
aa
aa
aa
aa
aa
ab
"}
(47,1,1) = {"
ab
aa
aa
aa
aa
aa
aa
aa
aa
aa
aa
aa
aa
aa
aa
aa
aa
aa
aa
aa
aa
aa
aa
aa
aa
aa
aa
aa
aa
aa
aa
aa
aa
aa
aa
aa
aa
aa
aa
aa
aa
aa
aa
aa
ab
"}
(48,1,1) = {"
ab
aa
aa
aa
aa
aa
aa
aa
aa
aa
aa
aa
aa
aa
aa
aa
aa
aa
aa
aa
aa
aa
aa
aa
aa
aa
aa
aa
aa
aa
aa
aa
aa
aa
aa
aa
aa
aa
aa
aa
aa
aa
aa
aa
ab
"}
(49,1,1) = {"
ab
aa
aa
aa
aa
aa
aa
aa
aa
aa
aa
aa
aa
aa
aa
aa
aa
aa
aa
aa
aa
aa
aa
aa
aa
aa
aa
aa
aa
aa
aa
aa
aa
aa
aa
aa
aa
aa
aa
aa
aa
aa
aa
aa
ab
"}
(50,1,1) = {"
ab
aa
aa
aa
aa
aa
aa
aa
aa
aa
aa
aa
aa
aa
aa
aa
aa
aa
aa
aa
aa
aa
aa
aa
aa
aa
aa
aa
aa
aa
aa
aa
aa
aa
aa
aa
aa
aa
aa
aa
aa
aa
aa
aa
ab
"}
(51,1,1) = {"
ab
ab
ab
ab
ab
ab
ab
ab
ab
ab
ab
ab
ab
ab
ab
ab
ab
ab
ab
ab
ab
ab
ab
ab
ab
ab
ab
ab
ab
ab
ab
ab
ab
ab
ab
ab
ab
ab
ab
ab
ab
ab
ab
ab
ab
"}
(52,1,1) = {"
ab
ab
ab
ab
ab
ab
ab
ab
ab
ab
ab
ab
ab
ab
ab
ab
ab
ab
ab
ab
ab
ab
ab
ab
ab
ab
ab
ab
ab
ab
ab
ab
ab
ab
ab
ab
ab
ab
ab
ab
ab
ab
ab
ab
ab
"}
(53,1,1) = {"
ab
aa
aa
aa
aa
aa
aa
aa
aa
aa
aa
aa
aa
aa
aa
aa
aa
aa
aa
aa
aa
aa
aa
aa
aa
aa
aa
aa
aa
aa
aa
aa
aa
aa
aa
aa
aa
aa
aa
aa
aa
aa
aa
aa
ab
"}
(54,1,1) = {"
ab
aa
aa
aa
aa
aa
aa
aa
aa
aa
aa
aa
aa
aa
aa
aa
aa
aa
aa
aa
aa
aa
aa
aa
aa
aa
aa
aa
aa
aa
aa
aa
aa
aa
aa
aa
aa
aa
aa
aa
aa
aa
aa
aa
ab
"}
(55,1,1) = {"
ab
aa
aa
aa
aa
aa
aa
aa
aa
aa
aa
aa
aa
aa
aa
aa
aa
aa
aa
aa
aa
aa
aa
aa
aa
aa
aa
aa
aa
aa
aa
aa
aa
aa
aa
aa
aa
aa
aa
aa
aa
aa
aa
aa
ab
"}
(56,1,1) = {"
ab
aa
aa
aa
aa
aa
aa
aa
aa
aa
aa
aa
aa
aa
aa
aa
aa
aa
aa
aa
aa
aa
aa
aa
aa
aa
aa
aa
aa
aa
aa
aa
aa
aa
aa
aa
aa
aa
aa
aa
aa
aa
aa
aa
ab
"}
(57,1,1) = {"
ab
aa
aa
aa
aa
aa
aa
aa
aa
aa
aa
aa
aa
aa
aa
aa
aa
aa
aa
aa
aa
aa
aa
aa
aa
aa
aa
aa
aa
aa
aa
aa
aa
aa
aa
aa
aa
aa
aa
aa
aa
aa
aa
aa
ab
"}
(58,1,1) = {"
ab
aa
aa
aa
aa
aa
aa
aa
aa
aa
aa
aa
aa
aa
aa
aa
aa
aa
aa
aa
aa
aa
aa
aa
aa
aa
aa
aa
aa
aa
aa
aa
aa
aa
aa
aa
aa
aa
aa
aa
aa
aa
aa
aa
ab
"}
(59,1,1) = {"
ab
aa
aa
aa
aa
aa
aa
aa
aa
aa
aa
aa
aa
aa
aa
aa
aa
aa
aa
aa
aa
aa
aa
aa
aa
aa
aa
aa
aa
aa
aa
aa
aa
aa
aa
aa
aa
aa
aa
aa
aa
aa
aa
aa
ab
"}
(60,1,1) = {"
ab
aa
aa
aa
aa
aa
aa
aa
aa
aa
aa
aa
aa
aa
aa
aa
aa
aa
aa
aa
aa
aa
aa
aa
aa
aa
aa
aa
aa
aa
aa
aa
aa
aa
aa
aa
aa
aa
aa
aa
aa
aa
aa
aa
ab
"}
(61,1,1) = {"
ab
aa
aa
aa
aa
aa
aa
aa
aa
aa
aa
aa
aa
aa
aa
aa
aa
aa
aa
aa
aa
aa
aa
aa
aa
aa
aa
aa
aa
aa
aa
aa
aa
aa
aa
aa
aa
aa
aa
aa
aa
aa
aa
aa
ab
"}
(62,1,1) = {"
ab
aa
aa
aa
aa
aa
aa
aa
aa
aa
aa
aa
aa
aa
aa
aa
aa
aa
aa
aa
aa
aa
aa
aa
aa
aa
aa
aa
aa
aa
aa
aa
aa
aa
aa
aa
aa
aa
aa
aa
aa
aa
aa
aa
ab
"}
(63,1,1) = {"
ab
aa
aa
aa
aa
aa
aa
aa
aa
aa
aa
aa
aa
aa
aa
aa
aa
aa
aa
aa
aa
aa
aa
aa
aa
aa
aa
aa
aa
aa
aa
aa
aa
aa
aa
aa
aa
aa
aa
aa
aa
aa
aa
aa
ab
"}
(64,1,1) = {"
ab
aa
aa
aa
aa
aa
aa
aa
aa
aa
aa
aa
aa
aa
aa
aa
aa
aa
aa
aa
aa
aa
aa
aa
aa
aa
aa
aa
aa
aa
aa
aa
aa
aa
aa
aa
aa
aa
aa
aa
aa
aa
aa
aa
ab
"}
(65,1,1) = {"
ab
aa
aa
aa
aa
aa
aa
aa
aa
aa
aa
aa
aa
aa
aa
aa
aa
aa
aa
aa
aa
aa
aa
aa
aa
aa
aa
aa
aa
aa
aa
aa
aa
aa
aa
aa
aa
aa
aa
aa
aa
aa
aa
aa
ab
"}
(66,1,1) = {"
ab
aa
aa
aa
aa
aa
aa
aa
aa
aa
aa
aa
aa
aa
aa
aa
aa
aa
aa
aa
aa
aa
aa
aa
aa
aa
aa
aa
aa
aa
aa
aa
aa
aa
aa
aa
aa
aa
aa
aa
aa
aa
aa
aa
ab
"}
(67,1,1) = {"
ab
aa
aa
aa
aa
aa
aa
aa
aa
aa
aa
aa
aa
aa
aa
aa
aa
aa
aa
aa
aa
aa
aa
aa
aa
aa
aa
aa
aa
aa
aa
aa
aa
aa
aa
aa
aa
aa
aa
aa
aa
aa
aa
aa
ab
"}
(68,1,1) = {"
ab
aa
aa
aa
aa
aa
aa
aa
aa
aa
aa
aa
aa
aa
aa
aa
aa
aa
aa
aa
aa
aa
aa
aa
aa
aa
aa
aa
aa
aa
aa
aa
aa
aa
aa
aa
aa
aa
aa
aa
aa
aa
aa
aa
ab
"}
(69,1,1) = {"
ab
aa
aa
aa
aa
aa
aa
aa
aa
aa
aa
aa
aa
aa
aa
aa
aa
aa
aa
aa
aa
aa
aa
aa
aa
aa
aa
aa
aa
aa
aa
aa
aa
aa
aa
aa
aa
aa
aa
aa
aa
aa
aa
aa
ab
"}
(70,1,1) = {"
ab
aa
aa
aa
aa
aa
aa
aa
aa
aa
aa
aa
aa
aa
aa
aa
aa
aa
aa
aa
aa
aa
aa
aa
aa
aa
aa
aa
aa
aa
aa
aa
aa
aa
aa
aa
aa
aa
aa
aa
aa
aa
aa
aa
ab
"}
(71,1,1) = {"
ab
aa
aa
aa
aa
aa
aa
aa
aa
aa
aa
aa
aa
aa
LK
pl
pl
pl
pl
pl
pl
pl
pl
pl
pl
pl
pl
pl
pl
pl
pl
pl
aa
aa
aa
aa
aa
aa
aa
aa
aa
aa
aa
aa
ab
"}
(72,1,1) = {"
ab
aa
aa
aa
aa
aa
aa
aa
aa
aa
aa
aa
aa
aa
LK
pl
Nm
Nm
Nm
Nm
Nm
Nm
Nm
Nm
Nm
Nm
Nm
Nm
Nm
Nm
Nm
pl
aa
aa
aa
aa
aa
aa
aa
aa
aa
aa
aa
aa
ab
"}
(73,1,1) = {"
ab
aa
aa
aa
aa
aa
aa
aa
aa
aa
aa
pl
pl
pl
pl
pl
Nm
Nm
Nm
Nm
Nm
Nm
Nm
Nm
Nm
Nm
Nm
Nm
Nm
Nm
Xy
pl
pl
pl
pl
aa
aa
aa
aa
aa
aa
aa
aa
aa
ab
"}
(74,1,1) = {"
ab
aa
aa
aa
aa
aa
aa
aa
aa
aa
pl
pl
Nm
Nm
Nm
Nm
Nm
Nm
Nm
Nm
Nm
Nm
Nm
Nm
Nm
Nm
Nm
Nm
Nm
Nm
pl
pl
Aq
cH
pl
aa
aa
aa
aa
aa
aa
aa
aa
aa
ab
"}
(75,1,1) = {"
ab
aa
aa
aa
aa
aa
aa
aa
aa
pl
pl
Nm
Nm
Nm
Nm
Nm
Nm
Nm
Nm
Nm
Nm
Nm
Nm
Nm
Nm
Nm
Nm
Nm
Nm
Nm
pl
GR
WB
WB
pl
aa
aa
aa
aa
aa
aa
aa
aa
aa
ab
"}
(76,1,1) = {"
ab
aa
aa
aa
aa
aa
aa
aa
aa
pl
Nm
Nm
Nm
Nm
Nm
Nm
Nm
Nm
Nm
Nm
Nm
Nm
Nm
Nm
Nm
Nm
Nm
Nm
Nm
Nm
Ei
Zc
WB
lR
pl
aa
aa
aa
aa
aa
aa
aa
aa
aa
ab
"}
(77,1,1) = {"
ab
aa
aa
aa
aa
aa
aa
aa
aa
pl
Nm
Nm
Nm
Nm
Nm
Nm
Nm
Nm
Nm
Nm
Nm
Nm
Nm
Nm
Nm
Nm
Nm
Nm
Nm
Nm
Ei
Zc
WB
lR
pl
aa
aa
aa
aa
aa
aa
aa
aa
aa
ab
"}
(78,1,1) = {"
ab
aa
aa
aa
aa
aa
aa
aa
aa
pl
Nm
Nm
Nm
Nm
Nm
Nm
Nm
Nm
Nm
Nm
Nm
Nm
Nm
Nm
Nm
Nm
Nm
Nm
Nm
Nm
Ei
Zc
WB
lR
pl
aa
aa
aa
aa
aa
aa
aa
aa
aa
ab
"}
(79,1,1) = {"
ab
aa
aa
aa
aa
aa
aa
aa
aa
pl
pl
Nm
Nm
Nm
Nm
Nm
Nm
Nm
Nm
Nm
Nm
Nm
Nm
Nm
Nm
Nm
Nm
Nm
Nm
Nm
pl
GR
WB
WB
pl
aa
aa
aa
aa
aa
aa
aa
aa
aa
ab
"}
(80,1,1) = {"
ab
aa
aa
aa
aa
aa
aa
aa
aa
aa
pl
pl
Nm
Nm
Nm
Nm
Nm
Nm
Nm
Nm
Nm
Nm
Nm
Nm
Nm
Nm
Nm
Nm
Nm
Nm
pl
pl
Tb
cH
pl
aa
aa
aa
aa
aa
aa
aa
aa
aa
ab
"}
(81,1,1) = {"
ab
aa
aa
aa
aa
aa
aa
aa
aa
aa
aa
pl
pl
pl
pl
pl
Nm
Nm
Nm
Nm
Nm
Nm
Nm
Nm
Nm
Nm
Nm
Nm
Nm
Nm
Xy
pl
pl
pl
pl
aa
aa
aa
aa
aa
aa
aa
aa
aa
ab
"}
(82,1,1) = {"
ab
aa
aa
aa
aa
aa
aa
aa
aa
aa
aa
aa
aa
aa
LK
pl
JZ
Nm
Nm
Nm
Nm
Nm
Nm
Nm
Nm
Nm
Nm
Nm
Nm
Nm
Nm
pl
aa
aa
aa
aa
aa
aa
aa
aa
aa
aa
aa
aa
ab
"}
(83,1,1) = {"
ab
aa
aa
aa
aa
aa
aa
aa
aa
aa
aa
aa
aa
aa
LK
pl
pl
pl
pl
pl
pl
pl
pl
pl
pl
pl
pl
pl
pl
pl
pl
pl
aa
aa
aa
aa
aa
aa
aa
aa
aa
aa
aa
aa
ab
"}
(84,1,1) = {"
ab
aa
aa
aa
aa
aa
aa
aa
aa
aa
aa
aa
aa
aa
aa
aa
aa
aa
aa
aa
aa
aa
aa
aa
aa
aa
aa
aa
aa
aa
aa
aa
aa
aa
aa
aa
aa
aa
aa
aa
aa
aa
aa
aa
ab
"}
(85,1,1) = {"
ab
aa
aa
aa
aa
aa
aa
aa
aa
aa
aa
aa
aa
aa
aa
aa
aa
aa
aa
aa
aa
aa
aa
aa
aa
aa
aa
aa
aa
aa
aa
aa
aa
aa
aa
aa
aa
aa
aa
aa
aa
aa
aa
aa
ab
"}
(86,1,1) = {"
ab
aa
aa
aa
aa
aa
aa
aa
aa
aa
aa
aa
aa
aa
aa
aa
aa
aa
aa
aa
aa
aa
aa
aa
aa
aa
aa
aa
aa
aa
aa
aa
aa
aa
aa
aa
aa
aa
aa
aa
aa
aa
aa
aa
ab
"}
(87,1,1) = {"
ab
aa
aa
aa
aa
aa
aa
aa
aa
aa
aa
aa
aa
aa
aa
aa
aa
aa
aa
aa
aa
aa
aa
aa
aa
aa
aa
aa
aa
aa
aa
aa
aa
aa
aa
aa
aa
aa
aa
aa
aa
aa
aa
aa
ab
"}
(88,1,1) = {"
ab
aa
aa
aa
aa
aa
aa
aa
aa
aa
aa
aa
aa
aa
aa
aa
aa
aa
aa
aa
aa
aa
aa
aa
aa
aa
aa
aa
aa
aa
aa
aa
aa
aa
aa
aa
aa
aa
aa
aa
aa
aa
aa
aa
ab
"}
(89,1,1) = {"
ab
aa
aa
aa
aa
aa
aa
aa
aa
aa
aa
aa
aa
aa
aa
aa
aa
aa
aa
aa
aa
aa
aa
aa
aa
aa
aa
aa
aa
aa
aa
aa
aa
aa
aa
aa
aa
aa
aa
aa
aa
aa
aa
aa
ab
"}
(90,1,1) = {"
ab
aa
aa
aa
aa
aa
aa
aa
aa
aa
aa
aa
aa
aa
aa
aa
aa
aa
aa
aa
aa
aa
aa
aa
aa
aa
aa
aa
aa
aa
aa
aa
aa
aa
aa
aa
aa
aa
aa
aa
aa
aa
aa
aa
ab
"}
(91,1,1) = {"
ab
aa
aa
aa
aa
aa
aa
aa
aa
aa
aa
aa
aa
aa
aa
aa
aa
aa
aa
aa
aa
aa
aa
aa
aa
aa
aa
aa
aa
aa
aa
aa
aa
aa
aa
aa
aa
aa
aa
aa
aa
aa
aa
aa
ab
"}
(92,1,1) = {"
ab
aa
aa
aa
aa
aa
aa
aa
aa
aa
aa
aa
aa
aa
aa
aa
aa
aa
aa
aa
aa
aa
aa
aa
aa
aa
aa
aa
aa
aa
aa
aa
aa
aa
aa
aa
aa
aa
aa
aa
aa
aa
aa
aa
ab
"}
(93,1,1) = {"
ab
aa
aa
aa
aa
aa
aa
aa
aa
aa
aa
aa
aa
aa
aa
aa
aa
aa
aa
aa
aa
aa
aa
aa
aa
aa
aa
aa
aa
aa
aa
aa
aa
aa
aa
aa
aa
aa
aa
aa
aa
aa
aa
aa
ab
"}
(94,1,1) = {"
ab
aa
aa
aa
aa
aa
aa
aa
aa
aa
aa
aa
aa
aa
aa
aa
aa
aa
aa
aa
aa
aa
aa
aa
aa
aa
aa
aa
aa
aa
aa
aa
aa
aa
aa
aa
aa
aa
aa
aa
aa
aa
aa
aa
ab
"}
(95,1,1) = {"
ab
aa
aa
aa
aa
aa
aa
aa
aa
aa
aa
aa
aa
aa
aa
aa
aa
aa
aa
aa
aa
aa
aa
aa
aa
aa
aa
aa
aa
aa
aa
aa
aa
aa
aa
aa
aa
aa
aa
aa
aa
aa
aa
aa
ab
"}
(96,1,1) = {"
ab
aa
aa
aa
aa
aa
aa
aa
aa
aa
aa
aa
aa
aa
aa
aa
aa
aa
aa
aa
aa
aa
aa
aa
aa
aa
aa
aa
aa
aa
aa
aa
aa
aa
aa
aa
aa
aa
aa
aa
aa
aa
aa
aa
ab
"}
(97,1,1) = {"
ab
aa
aa
aa
aa
aa
aa
aa
aa
aa
aa
aa
aa
aa
aa
aa
aa
aa
aa
aa
aa
aa
aa
aa
aa
aa
aa
aa
aa
aa
aa
aa
aa
aa
aa
aa
aa
aa
aa
aa
aa
aa
aa
aa
ab
"}
(98,1,1) = {"
ab
aa
aa
aa
aa
aa
aa
aa
aa
aa
aa
aa
aa
aa
aa
aa
aa
aa
aa
aa
aa
aa
aa
aa
aa
aa
aa
aa
aa
aa
aa
aa
aa
aa
aa
aa
aa
aa
aa
aa
aa
aa
aa
aa
ab
"}
(99,1,1) = {"
ab
aa
aa
aa
aa
aa
aa
aa
aa
aa
aa
aa
aa
aa
aa
aa
aa
aa
aa
aa
aa
aa
aa
aa
aa
aa
aa
aa
aa
aa
aa
aa
aa
aa
aa
aa
aa
aa
aa
aa
aa
aa
aa
aa
ab
"}
(100,1,1) = {"
ab
aa
aa
aa
aa
aa
aa
aa
aa
aa
aa
aa
aa
aa
aa
aa
aa
aa
aa
aa
aa
aa
aa
aa
aa
aa
aa
aa
aa
aa
aa
aa
aa
aa
aa
aa
aa
aa
aa
aa
aa
aa
aa
aa
ab
"}
(101,1,1) = {"
ab
aa
aa
aa
aa
aa
aa
aa
aa
aa
aa
aa
aa
aa
aa
aa
aa
aa
aa
aa
aa
aa
aa
aa
aa
aa
aa
aa
aa
aa
aa
aa
aa
aa
aa
aa
aa
aa
aa
aa
aa
aa
aa
aa
ab
"}
(102,1,1) = {"
ab
ab
ab
ab
ab
ab
ab
ab
ab
ab
ab
ab
ab
ab
ab
ab
ab
ab
ab
ab
ab
ab
ab
ab
ab
ab
ab
ab
ab
ab
ab
ab
ab
ab
ab
ab
ab
ab
ab
ab
ab
ab
ab
ab
ab
"}
