//MAP CONVERTED BY dmm2tgm.py THIS HEADER COMMENT PREVENTS RECONVERSION, DO NOT REMOVE
"aa" = (
/turf/simulated/wall/auto/shuttle{
	icon_state = "7"
	},
/area/shuttle/escape/centcom/donut3)
"ak" = (
/obj/machinery/door/airlock/pyro/glass/command,
/turf/unsimulated/floor/plating,
/area/shuttle/escape/centcom/donut3)
"ar" = (
/obj/item/storage/wall/medical{
	dir = 4;
	pixel_x = -32;
	pixel_z = -1
	},
/turf/unsimulated/floor/void,
/area/shuttle/escape/centcom/donut3)
"aA" = (
/obj/stool/chair/comfy/shuttle{
	dir = 4
	},
/obj/decal/cleanable/dirt/dirt4,
/turf/unsimulated/floor/plating,
/area/shuttle/escape/centcom/donut3)
"cH" = (
/obj/decal/cleanable/paper,
/turf/unsimulated/floor/void,
/area/shuttle/escape/centcom/donut3)
"dc" = (
/obj/indestructible/shuttle_corner{
	dir = 1
	},
/turf/unsimulated/outdoors/grass,
/area/shuttle/escape/centcom/donut3)
"dq" = (
/obj/decal/skeleton{
	desc = "The remains of the captain of this, uh, part of station. Not sure if all of the station parts are from the same place.";
	icon = 'icons/misc/hstation.dmi';
	icon_state = "body7"
	},
/obj/decal/cleanable/blood/splatter{
	icon_state = "floor2"
	},
/obj/decal/cleanable/blood/splatter{
	icon_state = "floor4"
	},
/turf/unsimulated/floor/plating,
/area/shuttle/escape/centcom/donut3)
"eO" = (
/obj/stool/chair/comfy/shuttle{
	dir = 1
	},
/obj/machinery/light,
/obj/decal/cleanable/dirt/dirt4,
/turf/unsimulated/floor/plating,
/area/shuttle/escape/centcom/donut3)
"fK" = (
/obj/wingrille_spawn/auto,
/obj/machinery/shuttle/engine/heater{
	icon_state = "alt_heater-R"
	},
/turf/space,
/area/shuttle/escape/centcom/donut3)
"fM" = (
/obj/machinery/light,
/obj/decal/cleanable/blood/splatter{
	icon_state = "gibbl2"
	},
/turf/unsimulated/floor/plating,
/area/shuttle/escape/centcom/donut3)
"fW" = (
/obj/stool/chair/comfy/shuttle/brown{
	dir = 8
	},
/obj/machinery/light{
	dir = 4;
	layer = 9.1;
	pixel_x = 10
	},
/obj/decal/cleanable/dirt/dirt2,
/turf/unsimulated/floor/plating,
/area/shuttle/escape/centcom/donut3)
"gp" = (
/obj/stool/chair/comfy/shuttle/pilot{
	dir = 1
	},
/obj/decal/cleanable/blood/splatter,
/obj/decal/cleanable/dirt/dirt3,
/turf/unsimulated/floor/plating/damaged1,
/area/shuttle/escape/centcom/donut3)
"gS" = (
/obj/decal/cleanable/blood/splatter{
	icon_state = "floor2"
	},
/turf/unsimulated/floor/plating,
/area/shuttle/escape/centcom/donut3)
"he" = (
/obj/machinery/shuttle/engine/propulsion{
	icon_state = "alt_propulsion"
	},
/turf/unsimulated/outdoors/grass,
/area/shuttle/escape/centcom/donut3)
"hP" = (
/obj/stool/chair/comfy/shuttle/brown{
	dir = 1
	},
/obj/decal/skeleton{
	desc = "Eugh, the stench is horrible!";
	icon = 'icons/misc/hstation.dmi';
	icon_state = "body3";
	name = "decomposed corpse"
	},
/obj/decal/cleanable/blood/splatter,
/obj/decal/cleanable/blood/splatter{
	icon_state = "floor4"
	},
/turf/unsimulated/floor/plating,
/area/shuttle/escape/centcom/donut3)
"iq" = (
/obj/stool/chair/comfy/shuttle/brown{
	dir = 4
	},
/obj/decal/cleanable/dirt/dirt2,
/turf/unsimulated/floor/plating,
/area/shuttle/escape/centcom/donut3)
"iz" = (
/obj/machinery/door/airlock/pyro/medical/alt,
/turf/unsimulated/floor/void,
/area/shuttle/escape/centcom/donut3)
"iJ" = (
/obj/machinery/door/airlock/pyro/security,
/turf/unsimulated/floor/plating,
/area/shuttle/escape/centcom/donut3)
"iU" = (
/obj/item/storage/wall/emergency{
	pixel_y = 32
	},
/obj/decal/cleanable/dirt/dirt3,
/turf/unsimulated/floor/plating,
/area/shuttle/escape/centcom/donut3)
"jm" = (
/obj/stool/chair/comfy/shuttle/brown{
	dir = 4
	},
/turf/unsimulated/floor/plating,
/area/shuttle/escape/centcom/donut3)
"jK" = (
/obj/decal/cleanable/blood/splatter,
/turf/unsimulated/floor/plating,
/area/shuttle/escape/centcom/donut3)
"kJ" = (
/obj/stool/chair/comfy/shuttle/brown,
/obj/decal/cleanable/dirt/dirt2,
/obj/decal/cleanable/dirt/dirt3,
/turf/unsimulated/floor/plating,
/area/shuttle/escape/centcom/donut3)
"lC" = (
/obj/decal/cleanable/machine_debris,
/turf/unsimulated/floor/plating/damaged1,
/area/shuttle/escape/centcom/donut3)
"lD" = (
/obj/decal/cleanable/blood/splatter{
	icon_state = "floor4"
	},
/turf/unsimulated/floor/plating/damaged1,
/area/shuttle/escape/centcom/donut3)
"lS" = (
/obj/stool/chair/comfy/shuttle/brown{
	dir = 1
	},
/turf/unsimulated/floor/plating,
/area/shuttle/escape/centcom/donut3)
"lT" = (
/obj/machinery/light/small/floor,
/obj/decal/cleanable/blood/splatter{
	icon_state = "gibbl2"
	},
/turf/unsimulated/floor/plating,
/area/shuttle/escape/centcom/donut3)
"lX" = (
/obj/decal/cleanable/dirt/jen,
/turf/unsimulated/floor/plating/scorched,
/area/shuttle/escape/centcom/donut3)
"nf" = (
/obj/machinery/sleeper/compact{
	dir = 4
	},
/turf/unsimulated/floor/plating,
/area/shuttle/escape/centcom/donut3)
"nz" = (
/obj/decal/cleanable/blood/splatter{
	icon_state = "gibbl2"
	},
/turf/unsimulated/floor/plating/damaged3,
/area/shuttle/escape/centcom/donut3)
"nT" = (
/obj/decal/cleanable/blood/splatter{
	icon_state = "floor2"
	},
/obj/decal/cleanable/dirt/dirt2,
/obj/decal/cleanable/dirt/dirt4,
/turf/unsimulated/floor/plating,
/area/shuttle/escape/centcom/donut3)
"pE" = (
/obj/stool/chair/comfy/shuttle/red{
	dir = 1
	},
/turf/unsimulated/floor/plating/scorched,
/area/shuttle/escape/centcom/donut3)
"ql" = (
/turf/simulated/wall/auto/shuttle{
	icon_state = "3"
	},
/area/shuttle/escape/centcom/donut3)
"qS" = (
/obj/lattice{
	dir = 1;
	icon_state = "lattice-dir-b"
	},
/turf/unsimulated/outdoors/grass,
/area/centcom/outside)
"ra" = (
/turf/unsimulated/floor/plating/scorched,
/area/shuttle/escape/centcom/donut3)
"ri" = (
/obj/indestructible/shuttle_corner{
	dir = 8
	},
/turf/unsimulated/outdoors/grass,
/area/shuttle/escape/centcom/donut3)
"rt" = (
/turf/unsimulated/floor/plating/damaged3,
/area/shuttle/escape/centcom/donut3)
"rX" = (
/obj/stool/chair/comfy/shuttle/brown,
/turf/unsimulated/floor/plating,
/area/shuttle/escape/centcom/donut3)
"sm" = (
/obj/indestructible/shuttle_corner{
	dir = 0;
	icon_state = "7"
	},
/turf/simulated/wall/auto/shuttle{
	icon_state = "3"
	},
/area/shuttle/escape/centcom/donut3)
"tJ" = (
/obj/wingrille_spawn/auto,
/obj/machinery/shuttle/engine/heater{
	icon_state = "alt_heater-L"
	},
/turf/simulated/floor/plating/airless,
/area/shuttle/escape/centcom/donut3)
"uh" = (
/obj/stool/chair/comfy/shuttle/brown{
	dir = 4
	},
/obj/decal/skeleton{
	desc = "Eugh, the stench is horrible!";
	icon = 'icons/misc/hstation.dmi';
	icon_state = "body3";
	name = "decomposed corpse"
	},
/obj/decal/cleanable/blood/splatter{
	icon_state = "floor4"
	},
/turf/unsimulated/floor/plating/damaged3,
/area/shuttle/escape/centcom/donut3)
"uD" = (
/obj/indestructible/shuttle_corner{
	dir = 0
	},
/turf/unsimulated/floor/plating,
/area/shuttle/escape/centcom/donut3)
"vl" = (
/obj/decal/cleanable/dirt/dirt2,
/turf/unsimulated/floor/plating,
/area/shuttle/escape/centcom/donut3)
"vs" = (
/turf/simulated/wall/auto/shuttle{
	icon_state = "12"
	},
/area/shuttle/escape/centcom/donut3)
"wQ" = (
/obj/stool/chair/comfy/shuttle/brown{
	dir = 4
	},
/obj/machinery/light{
	dir = 8;
	layer = 9.1;
	pixel_x = -10
	},
/turf/unsimulated/floor/plating,
/area/shuttle/escape/centcom/donut3)
"wZ" = (
/obj/decal/cleanable/dirt/dirt2,
/turf/unsimulated/floor/plating/damaged3,
/area/shuttle/escape/centcom/donut3)
"xC" = (
/obj/stool/chair/comfy/shuttle/brown,
/obj/decal/skeleton{
	desc = "The remains of some poor cosmonaut fellow.";
	icon = 'icons/misc/hstation.dmi';
	icon_state = "body9";
	name = "corpse"
	},
/obj/decal/cleanable/blood/splatter{
	icon_state = "floor4"
	},
/turf/unsimulated/floor/plating,
/area/shuttle/escape/centcom/donut3)
"xK" = (
/turf/unsimulated/floor/plating/damaged1,
/area/shuttle/escape/centcom/donut3)
"yh" = (
/obj/machinery/door/airlock/pyro/glass,
/turf/unsimulated/floor/plating/scorched,
/area/shuttle/escape/centcom/donut3)
"yW" = (
/turf/simulated/wall/auto/shuttle{
	icon_state = "8"
	},
/area/shuttle/escape/centcom/donut3)
"zi" = (
/obj/table/reinforced/auto,
/obj/item/storage/toolbox/emergency,
/turf/unsimulated/floor/plating/scorched,
/area/shuttle/escape/centcom/donut3)
"zx" = (
/obj/wingrille_spawn/auto,
/obj/machinery/shuttle/engine/heater{
	icon_state = "alt_heater-R"
	},
/turf/simulated/floor/plating/airless,
/area/shuttle/escape/centcom/donut3)
"zY" = (
/obj/decal/cleanable/dirt/dirt3,
/obj/decal/skeleton,
/obj/decal/cleanable/blood/splatter,
/obj/decal/cleanable/blood/splatter{
	icon_state = "floor4"
	},
/turf/unsimulated/floor/plating,
/area/shuttle/escape/centcom/donut3)
"AF" = (
/obj/decal/cleanable/blood/splatter{
	icon_state = "gibbl2"
	},
/obj/decal/cleanable/machine_debris{
	icon_state = "gib7"
	},
/obj/decal/cleanable/oil,
/turf/unsimulated/floor/plating,
/area/shuttle/escape/centcom/donut3)
"Be" = (
/obj/stool/chair/comfy/shuttle/brown,
/obj/decal/cleanable/blood/splatter,
/turf/unsimulated/floor/plating,
/area/shuttle/escape/centcom/donut3)
"Cb" = (
/obj/lattice{
	icon_state = "lattice-dir"
	},
/turf/unsimulated/outdoors/grass,
/area/centcom/outside)
"Ce" = (
/obj/stool/chair/comfy/shuttle/brown{
	dir = 1
	},
/obj/decal/cleanable/blood/splatter{
	icon_state = "gibbl2"
	},
/obj/decal/cleanable/dirt/dirt3,
/turf/unsimulated/floor/plating,
/area/shuttle/escape/centcom/donut3)
"Cg" = (
/turf/simulated/wall/auto/shuttle{
	icon_state = "14"
	},
/area/shuttle/escape/centcom/donut3)
"Cu" = (
/obj/table/auto,
/obj/mug_rack{
	pixel_x = -26;
	pixel_y = 4
	},
/obj/machinery/coffeemaker{
	pixel_x = -1;
	pixel_y = 2
	},
/obj/machinery/light,
/turf/unsimulated/floor/plating,
/area/shuttle/escape/centcom/donut3)
"DH" = (
/obj/decal/cleanable/dirt/jen,
/turf/unsimulated/floor/plating,
/area/shuttle/escape/centcom/donut3)
"DN" = (
/turf/unsimulated/floor/plating/damaged2,
/area/shuttle/escape/centcom/donut3)
"DS" = (
/obj/wingrille_spawn/auto,
/turf/unsimulated/floor/plating,
/area/shuttle/escape/centcom/donut3)
"Et" = (
/obj/stool/chair/comfy/shuttle/brown{
	dir = 4
	},
/obj/machinery/light{
	dir = 8;
	layer = 9.1;
	pixel_x = -10
	},
/obj/decal/cleanable/dirt/dirt2,
/turf/unsimulated/floor/plating,
/area/shuttle/escape/centcom/donut3)
"Ez" = (
/obj/machinery/door/airlock/pyro/external{
	dir = 4
	},
/turf/unsimulated/floor/plating,
/area/shuttle/escape/centcom/donut3)
"Fh" = (
/turf/simulated/wall/auto/shuttle{
	icon_state = "4"
	},
/area/shuttle/escape/centcom/donut3)
"Fq" = (
/obj/decal/cleanable/blood/splatter{
	icon_state = "floor2"
	},
/obj/decal/cleanable/blood/splatter{
	icon_state = "gibbl2"
	},
/obj/decal/cleanable/blood/splatter,
/turf/unsimulated/floor/plating,
/area/shuttle/escape/centcom/donut3)
"FE" = (
/obj/stool/chair/comfy/shuttle/brown{
	dir = 8
	},
/turf/unsimulated/floor/plating,
/area/shuttle/escape/centcom/donut3)
"FS" = (
/obj/machinery/light,
/turf/unsimulated/floor/plating/damaged3,
/area/shuttle/escape/centcom/donut3)
"Gf" = (
/obj/decal/cleanable/dirt/dirt2,
/turf/unsimulated/floor/plating/damaged2,
/area/shuttle/escape/centcom/donut3)
"HB" = (
/obj/indestructible/shuttle_corner{
	dir = 0
	},
/obj/indestructible/shuttle_corner{
	dir = 0;
	icon_state = "7"
	},
/turf/unsimulated/floor/shuttle,
/area/shuttle/escape/centcom/donut3)
"HR" = (
/obj/machinery/computer/announcement,
/turf/unsimulated/floor/plating,
/area/shuttle/escape/centcom/donut3)
"If" = (
/obj/decal/cleanable/dirt/dirt2,
/turf/unsimulated/floor/plating/damaged1,
/area/shuttle/escape/centcom/donut3)
"Ix" = (
/obj/decal/cleanable/blood/splatter{
	icon_state = "gibbl2"
	},
/turf/unsimulated/floor/plating/damaged1,
/area/shuttle/escape/centcom/donut3)
"IW" = (
/obj/stool/chair/comfy/shuttle{
	dir = 1
	},
/turf/unsimulated/floor/plating,
/area/shuttle/escape/centcom/donut3)
"Jq" = (
/obj/stool/chair/comfy/shuttle/brown{
	dir = 8
	},
/obj/machinery/light{
	dir = 4;
	layer = 9.1;
	pixel_x = 10
	},
/turf/unsimulated/floor/plating/damaged3,
/area/shuttle/escape/centcom/donut3)
"JW" = (
/obj/indestructible/shuttle_corner{
	dir = 1
	},
/turf/unsimulated/floor/plating,
/area/shuttle/escape/centcom/donut3)
"Kb" = (
/obj/machinery/sleeper/compact{
	dir = 4
	},
/obj/decal/skeleton,
/turf/unsimulated/floor/plating,
/area/shuttle/escape/centcom/donut3)
"Kc" = (
/obj/machinery/computer/shuttle,
/turf/unsimulated/floor/plating/damaged3,
/area/shuttle/escape/centcom/donut3)
"Lb" = (
/obj/stool/chair/comfy/shuttle/brown{
	dir = 1
	},
/obj/decal/cleanable/blood/splatter{
	icon_state = "gibbl2"
	},
/obj/decal/cleanable/dirt/dirt3,
/turf/unsimulated/floor/plating/damaged3,
/area/shuttle/escape/centcom/donut3)
"Lh" = (
/obj/stool/chair/comfy/shuttle/brown{
	dir = 4
	},
/obj/decal/cleanable/blood/splatter{
	icon_state = "gibbl2"
	},
/obj/decal/cleanable/dirt/dirt4,
/turf/unsimulated/floor/plating/damaged3,
/area/shuttle/escape/centcom/donut3)
"LF" = (
/obj/critter/crunched,
/turf/unsimulated/floor/void,
/area/shuttle/escape/centcom/donut3)
"LR" = (
/obj/decal/cleanable/blood/splatter{
	icon_state = "gibbl2"
	},
/obj/decal/cleanable/dirt/jen,
/obj/decal/cleanable/blood/splatter{
	icon_state = "floor4"
	},
/turf/unsimulated/floor/plating,
/area/shuttle/escape/centcom/donut3)
"LS" = (
/obj/decal/skeleton,
/obj/decal/cleanable/blood/splatter{
	icon_state = "floor4"
	},
/turf/unsimulated/floor/plating/damaged3,
/area/shuttle/escape/centcom/donut3)
"Nh" = (
/obj/machinery/shuttle/engine/heater{
	icon_state = "alt_heater"
	},
/turf/simulated/wall/auto/shuttle{
	icon_state = "3"
	},
/area/shuttle/escape/centcom/donut3)
"Nr" = (
/obj/stool/chair/comfy/shuttle,
/obj/machinery/light{
	dir = 1;
	pixel_y = 21
	},
/obj/decal/cleanable/dirt/jen,
/turf/unsimulated/floor/plating/damaged3,
/area/shuttle/escape/centcom/donut3)
"NW" = (
/turf/simulated/wall/auto/shuttle{
	icon_state = "11"
	},
/area/shuttle/escape/centcom/donut3)
"Og" = (
/obj/stool/chair/comfy/shuttle{
	dir = 4
	},
/obj/decal/cleanable/dirt/dirt4,
/turf/unsimulated/floor/plating/damaged2,
/area/shuttle/escape/centcom/donut3)
"Oi" = (
/obj/machinery/light{
	dir = 1;
	pixel_y = 21
	},
/turf/unsimulated/floor/plating/damaged2,
/area/shuttle/escape/centcom/donut3)
"OX" = (
/obj/decal/skeleton{
	desc = "Eugh, the stench is horrible!";
	icon = 'icons/misc/hstation.dmi';
	icon_state = "body8";
	name = "decomposed corpse"
	},
/obj/decal/cleanable/blood/splatter{
	icon_state = "floor4"
	},
/turf/unsimulated/floor/plating/damaged1,
/area/shuttle/escape/centcom/donut3)
"OZ" = (
/obj/table/reinforced/auto,
/obj/item/storage/firstaid/regular{
	pixel_x = 7
	},
/obj/item/device/radio{
	pixel_x = -6;
	pixel_y = 5
	},
/turf/unsimulated/floor/plating,
/area/shuttle/escape/centcom/donut3)
"Qy" = (
/obj/wingrille_spawn/auto,
/obj/machinery/shuttle/engine/heater{
	icon_state = "alt_heater-M"
	},
/turf/simulated/floor/plating/airless,
/area/shuttle/escape/centcom/donut3)
"QT" = (
/obj/indestructible/shuttle_corner{
	dir = 4
	},
/turf/unsimulated/outdoors/grass,
/area/shuttle/escape/centcom/donut3)
"Rg" = (
/turf/simulated/wall/auto/shuttle{
	icon_state = "13"
	},
/area/shuttle/escape/centcom/donut3)
"RB" = (
/obj/indestructible/shuttle_corner{
	dir = 0
	},
/turf/unsimulated/outdoors/grass,
/area/shuttle/escape/centcom/donut3)
"Sk" = (
/obj/item/storage/wall/fire{
	pixel_y = 32
	},
/turf/unsimulated/floor/plating/damaged3,
/area/shuttle/escape/centcom/donut3)
"Ss" = (
/obj/decal/cleanable/blood/splatter{
	icon_state = "floor4"
	},
/obj/decal/cleanable/dirt/dirt2,
/turf/unsimulated/floor/plating,
/area/shuttle/escape/centcom/donut3)
"Sx" = (
/obj/stool/chair/comfy/shuttle/green{
	dir = 8
	},
/turf/unsimulated/floor/plating,
/area/shuttle/escape/centcom/donut3)
"SS" = (
/obj/table/auto,
/obj/item/kitchen/food_box/donut_box,
/turf/unsimulated/floor/plating,
/area/shuttle/escape/centcom/donut3)
"TP" = (
/obj/indestructible/shuttle_corner{
	dir = 4
	},
/turf/unsimulated/floor/plating,
/area/shuttle/escape/centcom/donut3)
"UW" = (
/obj/stool/chair/comfy/shuttle/brown,
/turf/unsimulated/floor/plating/damaged3,
/area/shuttle/escape/centcom/donut3)
"VV" = (
/obj/decal/cleanable/blood/splatter{
	icon_state = "floor2"
	},
/turf/unsimulated/floor/plating/scorched,
/area/shuttle/escape/centcom/donut3)
"VW" = (
/obj/indestructible/shuttle_corner{
	dir = 8
	},
/turf/unsimulated/floor/plating,
/area/shuttle/escape/centcom/donut3)
"Wb" = (
/turf/unsimulated/outdoors/grass,
/area/centcom/outside)
"Xb" = (
/turf/unsimulated/floor/void,
/area/shuttle/escape/centcom/donut3)
"Xf" = (
/obj/item/reagent_containers/food/snacks/donut/custom/frosted{
	desc = "IT HIM, IT REALLY HIM";
	name = "smol donut"
	},
/obj/reagent_dispensers/cleanable/ants,
/turf/unsimulated/outdoors/grass,
/area/centcom/outside)
"XE" = (
/obj/stool/chair/comfy/shuttle,
/obj/machinery/light{
	dir = 1;
	pixel_y = 21
	},
/obj/decal/cleanable/dirt/dirt3,
/turf/unsimulated/floor/plating/damaged2,
/area/shuttle/escape/centcom/donut3)
"Yh" = (
/obj/decal/skeleton,
/turf/unsimulated/floor/plating/scorched,
/area/shuttle/escape/centcom/donut3)
"YN" = (
/obj/machinery/sleeper/compact{
	dir = 4
	},
/obj/machinery/light{
	dir = 1;
	pixel_y = 21
	},
/turf/unsimulated/floor/plating,
/area/shuttle/escape/centcom/donut3)
"YQ" = (
/turf/unsimulated/floor/plating,
/area/shuttle/escape/centcom/donut3)
"Zf" = (
/obj/decal/cleanable/dirt/dirt2,
/turf/unsimulated/floor/void,
/area/shuttle/escape/centcom/donut3)
"Zi" = (
/obj/stool/chair/comfy/shuttle/red{
	dir = 1
	},
/obj/machinery/light,
/obj/decal/cleanable/dirt/dirt4,
/turf/unsimulated/floor/plating/damaged1,
/area/shuttle/escape/centcom/donut3)

(1,1,1) = {"
Wb
Wb
Wb
Wb
RB
DS
DS
Ez
Ez
DS
DS
Xb
Xb
Xb
ql
sm
Nh
he
Wb
"}
(2,1,1) = {"
Cb
Cb
qS
RB
VW
wQ
jm
OX
nT
Lh
Et
Xb
Xb
Xb
Og
JW
aa
QT
Wb
"}
(3,1,1) = {"
Wb
Wb
Wb
vs
Be
xK
Yh
xK
Gf
Xb
Zf
Xb
Xb
Xb
Xb
aA
JW
tJ
he
"}
(4,1,1) = {"
qS
RB
DS
Rg
UW
VV
DH
cH
Xb
LF
DN
nz
iJ
Xb
jK
If
IW
Qy
he
"}
(5,1,1) = {"
RB
VW
zi
yW
xC
DH
Xb
Xb
Xb
Xb
jK
hP
Fh
Gf
wZ
Ss
eO
zx
he
"}
(6,1,1) = {"
DS
XE
lX
ak
YQ
FS
DS
DS
DS
Xb
Xb
lS
Cg
ql
ql
ql
HB
ri
Wb
"}
(7,1,1) = {"
DS
HR
gp
Fh
Sk
Lb
DS
Xf
Wb
Xb
Xb
DN
yh
ra
lD
Cu
vs
Wb
Wb
"}
(8,1,1) = {"
DS
Kc
zY
yW
iU
Ce
DS
Wb
Wb
Xb
Xb
cH
Xb
Xb
Sx
SS
vs
Wb
Wb
"}
(9,1,1) = {"
DS
Nr
LR
AF
lC
fM
DS
DS
DS
DS
Oi
Xb
LF
ql
ql
ql
NW
QT
Wb
"}
(10,1,1) = {"
dc
TP
OZ
Fh
rX
LS
jm
uh
iq
jm
Xb
Xb
Xb
Xb
ar
ra
Zi
tJ
he
"}
(11,1,1) = {"
qS
dc
DS
Rg
kJ
If
lT
YQ
xK
Xb
Xb
Xb
iz
Xb
Xb
dq
pE
Qy
he
"}
(12,1,1) = {"
Wb
Wb
Wb
vs
rX
vl
jK
Ix
Fq
Xb
FE
FE
Fh
Xb
Gf
Kb
uD
fK
he
"}
(13,1,1) = {"
Cb
Cb
qS
dc
TP
Jq
FE
gS
rt
FE
fW
FE
vs
YN
nf
uD
NW
ri
Wb
"}
(14,1,1) = {"
Wb
Wb
Wb
Wb
dc
DS
DS
Ez
Ez
DS
DS
ql
NW
ql
ql
NW
Nh
he
Wb
"}
