//MAP CONVERTED BY dmm2tgm.py THIS HEADER COMMENT PREVENTS RECONVERSION, DO NOT REMOVE
"aa" = (
/turf/simulated/wall/auto/shuttle{
	icon_state = "7"
	},
/area/shuttle/escape/centcom/donut3)
"ak" = (
/obj/machinery/door/airlock/pyro/glass/command,
/turf/unsimulated/floor/shuttle{
	icon_state = "floor2"
	},
/area/shuttle/escape/centcom/donut3)
"ar" = (
/obj/item/storage/wall/medical{
	dir = 4;
	pixel_x = -32;
	pixel_z = -1
	},
/turf/unsimulated/floor/shuttle{
	icon_state = "floor3"
	},
/area/shuttle/escape/centcom/donut3)
"dc" = (
/obj/indestructible/shuttle_corner{
	dir = 1
	},
/turf/unsimulated/outdoors/grass,
/area/shuttle/escape/centcom/donut3)
"eO" = (
/obj/stool/chair/comfy/shuttle{
	dir = 1
	},
/obj/machinery/light,
/turf/unsimulated/floor/shuttle{
	icon_state = "floor4"
	},
/area/shuttle/escape/centcom/donut3)
"fK" = (
/obj/wingrille_spawn/auto,
/obj/machinery/shuttle/engine/heater{
	icon_state = "alt_heater-R"
	},
/turf/space,
/area/shuttle/escape/centcom/donut3)
"gp" = (
/obj/stool/chair/comfy/shuttle/pilot{
	dir = 1
	},
/turf/unsimulated/floor/shuttle{
	icon_state = "floor2"
	},
/area/shuttle/escape/centcom/donut3)
"he" = (
/obj/machinery/shuttle/engine/propulsion{
	icon_state = "alt_propulsion"
	},
/turf/unsimulated/outdoors/grass,
/area/shuttle/escape/centcom/donut3)
"iz" = (
/obj/machinery/door/airlock/pyro/medical/alt,
/turf/unsimulated/floor/shuttle,
/area/shuttle/escape/centcom/donut3)
"iJ" = (
/obj/machinery/door/airlock/pyro/security,
/turf/unsimulated/floor/shuttle,
/area/shuttle/escape/centcom/donut3)
"iU" = (
/obj/item/storage/wall/emergency{
	pixel_y = 32
	},
/turf/unsimulated/floor/shuttle,
/area/shuttle/escape/centcom/donut3)
"jm" = (
/obj/stool/chair/comfy/shuttle/brown{
	dir = 4
	},
/turf/unsimulated/floor/shuttle,
/area/shuttle/escape/centcom/donut3)
"lX" = (
/turf/unsimulated/floor/shuttle{
	icon_state = "floor2"
	},
/area/shuttle/escape/centcom/donut3)
"mG" = (
/obj/stool/chair/comfy/shuttle{
	dir = 4
	},
/obj/machinery/light{
	dir = 1;
	pixel_y = 21
	},
/turf/unsimulated/floor/shuttle{
	icon_state = "floor4"
	},
/area/shuttle/escape/centcom/donut3)
"nf" = (
/obj/machinery/sleeper/compact{
	dir = 4
	},
/turf/unsimulated/floor/shuttle{
	icon_state = "floor3"
	},
/area/shuttle/escape/centcom/donut3)
"nJ" = (
/obj/wingrille_spawn/auto,
/turf/unsimulated/floor/shuttle{
	icon_state = "floor2"
	},
/area/shuttle/escape/centcom/donut3)
"pE" = (
/obj/stool/chair/comfy/shuttle/red{
	dir = 1
	},
/turf/unsimulated/floor/shuttle{
	icon_state = "floor3"
	},
/area/shuttle/escape/centcom/donut3)
"pP" = (
/turf/unsimulated/floor/shuttle{
	icon_state = "floor4"
	},
/area/shuttle/escape/centcom/donut3)
"pV" = (
/obj/indestructible/shuttle_corner{
	dir = 8
	},
/turf/unsimulated/floor/shuttle{
	icon_state = "floor2"
	},
/area/shuttle/escape/centcom/donut3)
"ql" = (
/turf/simulated/wall/auto/shuttle{
	icon_state = "3"
	},
/area/shuttle/escape/centcom/donut3)
"qS" = (
/obj/lattice{
	dir = 1;
	icon_state = "lattice-dir-b"
	},
/turf/unsimulated/outdoors/grass,
/area/centcom/outside)
"ra" = (
/turf/unsimulated/floor/shuttle{
	icon_state = "floor6"
	},
/area/shuttle/escape/centcom/donut3)
"ri" = (
/obj/indestructible/shuttle_corner{
	dir = 8
	},
/turf/unsimulated/outdoors/grass,
/area/shuttle/escape/centcom/donut3)
"sm" = (
/obj/indestructible/shuttle_corner{
	dir = 0;
	icon_state = "7"
	},
/turf/simulated/wall/auto/shuttle{
	icon_state = "3"
	},
/area/shuttle/escape/centcom/donut3)
"tJ" = (
/obj/wingrille_spawn/auto,
/obj/machinery/shuttle/engine/heater{
	icon_state = "alt_heater-L"
	},
/turf/simulated/floor/plating/airless,
/area/shuttle/escape/centcom/donut3)
"uD" = (
/obj/indestructible/shuttle_corner{
	dir = 0
	},
/turf/unsimulated/floor/shuttle{
	icon_state = "floor3"
	},
/area/shuttle/escape/centcom/donut3)
"vs" = (
/turf/simulated/wall/auto/shuttle{
	icon_state = "12"
	},
/area/shuttle/escape/centcom/donut3)
"wQ" = (
/obj/stool/chair/comfy/shuttle/brown{
	dir = 4
	},
/obj/machinery/light{
	dir = 8;
	layer = 9.1;
	pixel_x = -10
	},
/turf/unsimulated/floor/shuttle,
/area/shuttle/escape/centcom/donut3)
"yh" = (
/obj/machinery/door/airlock/pyro/glass,
/turf/unsimulated/floor/shuttle{
	icon_state = "floor6"
	},
/area/shuttle/escape/centcom/donut3)
"yL" = (
/obj/indestructible/shuttle_corner{
	dir = 4
	},
/turf/unsimulated/floor/shuttle,
/area/shuttle/escape/centcom/donut3)
"yW" = (
/turf/simulated/wall/auto/shuttle{
	icon_state = "8"
	},
/area/shuttle/escape/centcom/donut3)
"zi" = (
/obj/table/reinforced/auto,
/obj/item/storage/toolbox/emergency,
/turf/unsimulated/floor/shuttle{
	icon_state = "floor2"
	},
/area/shuttle/escape/centcom/donut3)
"zx" = (
/obj/wingrille_spawn/auto,
/obj/machinery/shuttle/engine/heater{
	icon_state = "alt_heater-R"
	},
/turf/simulated/floor/plating/airless,
/area/shuttle/escape/centcom/donut3)
"Be" = (
/obj/stool/chair/comfy/shuttle/brown,
/turf/unsimulated/floor/shuttle,
/area/shuttle/escape/centcom/donut3)
"Cb" = (
/obj/lattice{
	icon_state = "lattice-dir"
	},
/turf/unsimulated/outdoors/grass,
/area/centcom/outside)
"Cg" = (
/turf/simulated/wall/auto/shuttle{
	icon_state = "14"
	},
/area/shuttle/escape/centcom/donut3)
"Cj" = (
/obj/stool/chair/comfy/shuttle/brown{
	dir = 8
	},
/turf/unsimulated/floor/shuttle,
/area/shuttle/escape/centcom/donut3)
"Cu" = (
/obj/table/auto,
/obj/mug_rack{
	pixel_x = -26;
	pixel_y = 4
	},
/obj/machinery/coffeemaker{
	pixel_x = -1;
	pixel_y = 2
	},
/obj/machinery/light,
/turf/unsimulated/floor/shuttle{
	icon_state = "floor6"
	},
/area/shuttle/escape/centcom/donut3)
"DH" = (
/obj/machinery/light/small/floor,
/turf/unsimulated/floor/shuttle,
/area/shuttle/escape/centcom/donut3)
"DS" = (
/obj/wingrille_spawn/auto,
/turf/unsimulated/floor/shuttle,
/area/shuttle/escape/centcom/donut3)
"Ez" = (
/obj/machinery/door/airlock/pyro/external{
	dir = 4
	},
/turf/unsimulated/floor/shuttle,
/area/shuttle/escape/centcom/donut3)
"Fh" = (
/turf/simulated/wall/auto/shuttle{
	icon_state = "4"
	},
/area/shuttle/escape/centcom/donut3)
"FA" = (
/obj/stool/chair/comfy/shuttle/green{
	dir = 8
	},
/turf/unsimulated/floor/shuttle{
	icon_state = "floor6"
	},
/area/shuttle/escape/centcom/donut3)
"FS" = (
/obj/machinery/light,
/turf/unsimulated/floor/shuttle,
/area/shuttle/escape/centcom/donut3)
"HB" = (
/obj/indestructible/shuttle_corner{
	dir = 0
	},
/obj/indestructible/shuttle_corner{
	dir = 0;
	icon_state = "7"
	},
/turf/unsimulated/floor/shuttle,
/area/shuttle/escape/centcom/donut3)
"HR" = (
/obj/machinery/computer/announcement,
/turf/unsimulated/floor/shuttle{
	icon_state = "floor2"
	},
/area/shuttle/escape/centcom/donut3)
"IW" = (
/obj/stool/chair/comfy/shuttle{
	dir = 1
	},
/turf/unsimulated/floor/shuttle{
	icon_state = "floor4"
	},
/area/shuttle/escape/centcom/donut3)
"Jq" = (
/obj/stool/chair/comfy/shuttle/brown{
	dir = 8
	},
/obj/machinery/light{
	dir = 4;
	layer = 9.1;
	pixel_x = 10
	},
/turf/unsimulated/floor/shuttle,
/area/shuttle/escape/centcom/donut3)
"JW" = (
/obj/indestructible/shuttle_corner{
	dir = 1
	},
/turf/unsimulated/floor/shuttle{
	icon_state = "floor4"
	},
/area/shuttle/escape/centcom/donut3)
"Kc" = (
/obj/machinery/computer/shuttle,
/turf/unsimulated/floor/shuttle{
	icon_state = "floor2"
	},
/area/shuttle/escape/centcom/donut3)
"Lb" = (
/obj/stool/chair/comfy/shuttle/brown{
	dir = 1
	},
/turf/unsimulated/floor/shuttle,
/area/shuttle/escape/centcom/donut3)
"Nh" = (
/obj/machinery/shuttle/engine/heater{
	icon_state = "alt_heater"
	},
/turf/simulated/wall/auto/shuttle{
	icon_state = "3"
	},
/area/shuttle/escape/centcom/donut3)
"Nl" = (
/obj/table/auto,
/obj/table/auto,
/obj/item/storage/firstaid/fire{
	pixel_x = -6
	},
/obj/item/storage/firstaid/brute{
	pixel_x = 7
	},
/obj/item/storage/firstaid/oxygen{
	pixel_x = 1;
	pixel_y = 10
	},
/turf/unsimulated/floor/shuttle{
	icon_state = "floor3"
	},
/area/shuttle/escape/centcom/donut3)
"NW" = (
/turf/simulated/wall/auto/shuttle{
	icon_state = "11"
	},
/area/shuttle/escape/centcom/donut3)
"Og" = (
/obj/stool/chair/comfy/shuttle{
	dir = 4
	},
/turf/unsimulated/floor/shuttle{
	icon_state = "floor4"
	},
/area/shuttle/escape/centcom/donut3)
"OZ" = (
/obj/table/reinforced/auto,
/obj/item/storage/firstaid/regular{
	pixel_x = 7
	},
/obj/item/device/radio{
	pixel_x = -6;
	pixel_y = 5
	},
/turf/unsimulated/floor/shuttle{
	icon_state = "floor2"
	},
/area/shuttle/escape/centcom/donut3)
"Qy" = (
/obj/wingrille_spawn/auto,
/obj/machinery/shuttle/engine/heater{
	icon_state = "alt_heater-M"
	},
/turf/simulated/floor/plating/airless,
/area/shuttle/escape/centcom/donut3)
"QN" = (
/obj/machinery/light{
	dir = 1;
	pixel_y = 21
	},
/turf/unsimulated/floor/shuttle,
/area/shuttle/escape/centcom/donut3)
"QT" = (
/obj/indestructible/shuttle_corner{
	dir = 4
	},
/turf/unsimulated/outdoors/grass,
/area/shuttle/escape/centcom/donut3)
"Rg" = (
/turf/simulated/wall/auto/shuttle{
	icon_state = "13"
	},
/area/shuttle/escape/centcom/donut3)
"RB" = (
/obj/indestructible/shuttle_corner{
	dir = 0
	},
/turf/unsimulated/outdoors/grass,
/area/shuttle/escape/centcom/donut3)
"Sk" = (
/obj/item/storage/wall/fire{
	pixel_y = 32
	},
/turf/unsimulated/floor/shuttle,
/area/shuttle/escape/centcom/donut3)
"SS" = (
/obj/table/auto,
/obj/item/kitchen/food_box/donut_box,
/turf/unsimulated/floor/shuttle{
	icon_state = "floor6"
	},
/area/shuttle/escape/centcom/donut3)
"TP" = (
/obj/indestructible/shuttle_corner{
	dir = 4
	},
/turf/unsimulated/floor/shuttle{
	icon_state = "floor2"
	},
/area/shuttle/escape/centcom/donut3)
"VW" = (
/obj/indestructible/shuttle_corner{
	dir = 8
	},
/turf/unsimulated/floor/shuttle,
/area/shuttle/escape/centcom/donut3)
"Wb" = (
/turf/unsimulated/outdoors/grass,
/area/centcom/outside)
"Xb" = (
/turf/unsimulated/floor/shuttle{
	icon_state = "floor3"
	},
/area/shuttle/escape/centcom/donut3)
"Xf" = (
/obj/item/reagent_containers/food/snacks/donut/custom/frosted{
	desc = "IT HIM, IT REALLY HIM";
	name = "smol donut";
	doants = 0
	},
/obj/reagent_dispensers/cleanable/ants,
/turf/unsimulated/outdoors/grass,
/area/centcom/outside)
"XE" = (
/obj/stool/chair/comfy/shuttle,
/obj/machinery/light{
	dir = 1;
	pixel_y = 21
	},
/turf/unsimulated/floor/shuttle{
	icon_state = "floor2"
	},
/area/shuttle/escape/centcom/donut3)
"YN" = (
/obj/machinery/sleeper/compact{
	dir = 4
	},
/obj/machinery/light{
	dir = 1;
	pixel_y = 21
	},
/turf/unsimulated/floor/shuttle{
	icon_state = "floor3"
	},
/area/shuttle/escape/centcom/donut3)
"YQ" = (
/turf/unsimulated/floor/shuttle,
/area/shuttle/escape/centcom/donut3)
"Zi" = (
/obj/stool/chair/comfy/shuttle/red{
	dir = 1
	},
/obj/machinery/light,
/turf/unsimulated/floor/shuttle{
	icon_state = "floor3"
	},
/area/shuttle/escape/centcom/donut3)

(1,1,1) = {"
Wb
Wb
Wb
Wb
RB
DS
DS
Ez
Ez
DS
DS
ql
aa
ql
ql
sm
Nh
he
Wb
"}
(2,1,1) = {"
Cb
Cb
qS
RB
VW
wQ
jm
YQ
YQ
jm
wQ
jm
vs
mG
Og
JW
aa
QT
Wb
"}
(3,1,1) = {"
Wb
Wb
Wb
vs
Be
YQ
YQ
YQ
YQ
YQ
jm
jm
yW
pP
pP
Og
JW
tJ
he
"}
(4,1,1) = {"
qS
RB
nJ
Rg
Be
YQ
DH
YQ
YQ
DH
YQ
YQ
iJ
pP
pP
pP
IW
Qy
he
"}
(5,1,1) = {"
RB
pV
zi
yW
Be
YQ
Cj
Cj
Cj
Cj
YQ
Lb
Fh
pP
pP
pP
eO
zx
he
"}
(6,1,1) = {"
nJ
XE
lX
ak
YQ
FS
DS
DS
DS
DS
QN
Lb
Cg
ql
ql
ql
HB
ri
Wb
"}
(7,1,1) = {"
nJ
HR
gp
Fh
Sk
Lb
DS
Xf
Wb
DS
YQ
YQ
yh
ra
ra
Cu
vs
Wb
Wb
"}
(8,1,1) = {"
nJ
Kc
gp
yW
iU
Lb
DS
Wb
Wb
DS
YQ
YQ
yh
FA
FA
SS
vs
Wb
Wb
"}
(9,1,1) = {"
nJ
XE
lX
ak
YQ
FS
DS
DS
DS
DS
QN
Lb
Cg
ql
ql
ql
NW
QT
Wb
"}
(10,1,1) = {"
dc
TP
OZ
Fh
Be
YQ
jm
jm
jm
jm
YQ
Lb
yW
Nl
ar
Xb
Zi
tJ
he
"}
(11,1,1) = {"
qS
dc
nJ
Rg
Be
YQ
DH
YQ
YQ
DH
YQ
YQ
iz
Xb
Xb
Xb
pE
Qy
he
"}
(12,1,1) = {"
Wb
Wb
Wb
vs
Be
YQ
YQ
YQ
YQ
YQ
Cj
Cj
Fh
Xb
Xb
nf
uD
fK
he
"}
(13,1,1) = {"
Cb
Cb
qS
dc
yL
Jq
Cj
YQ
YQ
Cj
Jq
Cj
vs
YN
nf
uD
NW
ri
Wb
"}
(14,1,1) = {"
Wb
Wb
Wb
Wb
dc
DS
DS
Ez
Ez
DS
DS
ql
NW
ql
ql
NW
Nh
he
Wb
"}
