"aa" = (/turf/unsimulated/wall,/area)
"ab" = (/turf/space,/area)
"ac" = (/turf/unsimulated/wall/cave,/area)
"ad" = (/turf/unsimulated/wall/cave{name = "rock"},/area)
"ae" = (/obj/decal/fakeobjects/carcosa/brokenwall/four,/turf/unsimulated/floor/setpieces/carcosa/carcosa_dirt,/area)
"af" = (/turf/unsimulated/floor/setpieces/carcosa/carcosa_dirt,/area)
"ag" = (/obj/decal/fakeobjects/carcosa/brokenwall/four,/turf/space,/area)
"ah" = (/obj/decal/fakeobjects/carcosa/brokenwall/up_two,/turf/unsimulated/floor/setpieces/carcosa/carcosa_dirt_inner,/area)
"ai" = (/turf/unsimulated/floor/setpieces/carcosa/carcosa_dirt_inner,/area)
"aj" = (/obj/decal/fakeobjects/carcosa/brokenwall/up_two,/obj/decal/fakeobjects/carcosa/rubble/two,/turf/unsimulated/floor/setpieces/carcosa/carcosa_dirt_inner,/area)
"ak" = (/obj/decal/fakeobjects/carcosa/brokenwall/up_one,/turf/unsimulated/floor/setpieces/carcosa/carcosa_dirt_inner,/area)
"al" = (/obj/decal/fakeobjects/carcosa/rubble/three,/turf/unsimulated/floor/setpieces/carcosa/carcosa_dirt,/area)
"am" = (/obj/decal/fakeobjects/carcosa/carcosa_plant/five,/obj/decal/lightshaft,/turf/unsimulated/floor/setpieces/carcosa/carcosa_dirt,/area)
"an" = (/turf/unsimulated/floor/cave,/area)
"ao" = (/obj/decal/fakeobjects/carcosa/carcosa_plant/three,/obj/decal/lightshaft,/obj/decal/fakeobjects/carcosa/rubble/one,/turf/unsimulated/floor/setpieces/carcosa/carcosa_dirt,/area)
"ap" = (/obj/decal/fakeobjects/carcosa/rubble/one,/turf/unsimulated/floor/setpieces/carcosa/carcosa_dirt_inner,/area)
"aq" = (/obj/decal/fakeobjects/carcosa/rubble/two,/turf/unsimulated/floor/setpieces/carcosa/carcosa_dirt_inner,/area)
"ar" = (/obj/decal/fakeobjects/carcosa/brokenwall/arch_one,/obj/decal/fakeobjects/carcosa/brokenwall/up_two,/turf/unsimulated/floor/setpieces/carcosa/carcosa_dirt_inner,/area)
"as" = (/obj/decal/fakeobjects/carcosa/brokenwall/ruined_one,/turf/unsimulated/floor/setpieces/carcosa/carcosa_dirt_inner,/area)
"at" = (/obj/decal/fakeobjects/carcosa/brokenwall/up_two,/obj/decal/fakeobjects/carcosa/brokenwall/up_two,/turf/unsimulated/floor/setpieces/carcosa/carcosa_dirt_inner,/area)
"au" = (/obj/decal/fakeobjects/carcosa/rubble/three,/turf/unsimulated/floor/setpieces/carcosa/carcosa_dirt_inner,/area)
"av" = (/obj/decal/fakeobjects/carcosa/brokenwall/arch_one,/turf/unsimulated/floor/setpieces/carcosa/carcosa_dirt_inner,/area)
"aw" = (/obj/decal/fakeobjects/carcosa/brokenwall/ruined_two,/turf/unsimulated/floor/setpieces/carcosa/carcosa_dirt_inner,/area)
"ax" = (/obj/decal/fakeobjects/carcosa/brokenwall/arch_one,/obj/decal/fakeobjects/carcosa/brokenwall/up_one,/turf/unsimulated/floor/setpieces/carcosa/carcosa_dirt_inner,/area)
"ay" = (/obj/decal/fakeobjects/carcosa/carcosa_plant/four,/turf/unsimulated/floor/setpieces/carcosa/carcosa_dirt,/area)
"az" = (/obj/decal/fakeobjects/carcosa/carcosa_plant/two,/turf/unsimulated/floor/setpieces/carcosa/carcosa_dirt,/area)
"aA" = (/obj/decal/fakeobjects/carcosa/brokenwall/four,/turf/unsimulated/floor/setpieces/carcosa/carcosa_dirt_inner,/area)
"aB" = (/obj/decal/fakeobjects/carcosa/brokenwall/one,/turf/unsimulated/floor/setpieces/carcosa/carcosa_dirt_inner,/area)
"aC" = (/obj/decal/fakeobjects/carcosa/brokenwall/two,/turf/unsimulated/floor/setpieces/carcosa/carcosa_dirt_inner,/area)
"aD" = (/obj/decal/fakeobjects/carcosa/brokenwall/up_two,/obj/decal/fakeobjects/carcosa/brokenwall/three,/turf/unsimulated/floor/setpieces/carcosa/carcosa_dirt_inner,/area)
"aE" = (/obj/decal/fakeobjects/carcosa/brokenwall/ruined_one,/obj/decal/fakeobjects/carcosa/brokenwall/up_one,/obj/decal/fakeobjects/carcosa/brokenwall/ruined_two,/turf/unsimulated/floor/setpieces/carcosa/carcosa_dirt_inner,/area)
"aF" = (/obj/decal/fakeobjects/carcosa/carcosa_plant/five,/turf/unsimulated/floor/setpieces/carcosa/carcosa_dirt,/area)
"aG" = (/obj/decal/fakeobjects/carcosa/rubble/one,/obj/decal/fakeobjects/carcosa/carcosa_plant/one,/turf/unsimulated/floor/setpieces/carcosa/carcosa_dirt,/area)
"aH" = (/obj/decal/fakeobjects/carcosa/brokenwall/ruined_two,/obj/decal/fakeobjects/carcosa/carcosa_plant/three,/obj/decal/fakeobjects/carcosa/brokenwall/up_two,/obj/decal/fakeobjects/carcosa/brokenwall/ruined_one,/turf/unsimulated/floor/setpieces/carcosa/carcosa_dirt_inner,/area)
"aI" = (/obj/decal/fakeobjects/carcosa/brokenwall/up_one,/obj/decal/fakeobjects/carcosa/brokenwall/three,/turf/unsimulated/floor/setpieces/carcosa/carcosa_dirt_inner,/area)
"aJ" = (/obj/decal/fakeobjects/carcosa/brokenwall/three,/turf/unsimulated/floor/setpieces/carcosa/carcosa_dirt_inner,/area)
"aK" = (/obj/decal/fakeobjects/carcosa/brokenwall/up_one,/obj/decal/fakeobjects/carcosa/brokenwall/two,/turf/unsimulated/floor/setpieces/carcosa/carcosa_dirt_inner,/area)
"aL" = (/obj/decal/fakeobjects/carcosa/brokenwall/two,/turf/unsimulated/floor/setpieces/carcosa/carcosa_dirt,/area)
"aM" = (/obj/decal/fakeobjects/carcosa/brokenwall/ruined_one,/obj/decal/fakeobjects/carcosa/grtrans/south,/turf/unsimulated/floor/cave,/area)
"aN" = (/obj/decal/fakeobjects/carcosa/grtrans/south,/obj/decal/fakeobjects/carcosa/rubble/three,/turf/unsimulated/floor/cave,/area)
"aO" = (/obj/decal/fakeobjects/carcosa/brokenwall/ruined_two,/obj/decal/fakeobjects/carcosa/grtrans/south,/turf/unsimulated/floor/cave,/area)
"aP" = (/obj/decal/lightshaft,/obj/decal/fakeobjects/carcosa/rubble/three,/obj/decal/cleanable/water,/turf/unsimulated/floor/setpieces/carcosa/carcosa_dirt_inner,/area)
"aQ" = (/obj/decal/cleanable/water,/turf/unsimulated/floor/setpieces/carcosa/carcosa_dirt,/area)
"aR" = (/obj/decal/fakeobjects/carcosa/carcosa_plant/four,/obj/decal/fakeobjects/carcosa/rubble/one,/obj/decal/fakeobjects/carcosa/carcosa_plant/six,/obj/decal/lightshaft,/turf/unsimulated/floor/setpieces/carcosa/carcosa_dirt,/area)
"aS" = (/obj/decal/fakeobjects/carcosa/carcosa_plant/three,/turf/unsimulated/floor/setpieces/carcosa/carcosa_dirt,/area)
"aT" = (/obj/decal/fakeobjects/carcosa/rubble/three,/obj/decal/lightshaft,/obj/decal/fakeobjects/carcosa/carcosa_plant/six,/turf/unsimulated/floor/setpieces/carcosa/carcosa_dirt,/area)
"aU" = (/obj/decal/fakeobjects/carcosa/brokenwall/up_two,/obj/decal/fakeobjects/carcosa/brokenwall/two,/turf/unsimulated/floor/setpieces/carcosa/carcosa_dirt_inner,/area)
"aV" = (/obj/decal/fakeobjects/carcosa/brokenwall/up_two,/obj/decal/fakeobjects/carcosa/carcosa_plant/two,/obj/decal/fakeobjects/carcosa/rubble/one,/turf/unsimulated/floor/setpieces/carcosa/carcosa_dirt,/area)
"aW" = (/obj/decal/fakeobjects/carcosa/carcosa_plant/one,/turf/unsimulated/floor/setpieces/carcosa/carcosa_dirt,/area)
"aX" = (/obj/decal/fakeobjects/carcosa/rubble/two,/turf/unsimulated/floor/setpieces/carcosa/carcosa_dirt,/area)
"aY" = (/obj/decal/fakeobjects/carcosa/brokenwall/ruined_two,/obj/decal/fakeobjects/carcosa/brokenwall/ruined_one,/turf/unsimulated/floor/setpieces/carcosa/carcosa_dirt_inner,/area)
"aZ" = (/obj/decal/fakeobjects/carcosa/brokenwall/up_one,/obj/decal/fakeobjects/carcosa/brokenwall/four,/turf/unsimulated/floor/setpieces/carcosa/carcosa_dirt_inner,/area)
"ba" = (/obj/decal/fakeobjects/carcosa/rubble/one,/turf/unsimulated/floor/setpieces/carcosa/carcosa_dirt,/area)
"bb" = (/obj/decal/lightshaft,/obj/decal/fakeobjects/carcosa/rubble/three,/obj/decal/fakeobjects/carcosa/carcosa_plant/one,/turf/unsimulated/floor/setpieces/carcosa/carcosa_dirt,/area)
"bc" = (/obj/decal/fakeobjects/carcosa/brokenwall/up_two,/obj/decal/fakeobjects/carcosa/brokenwall/ruined_one,/turf/unsimulated/floor/setpieces/carcosa/carcosa_dirt_inner,/area)
"bd" = (/obj/decal/fakeobjects/carcosa/tree/three,/obj/decal/fakeobjects/carcosa/carcosa_plant/three,/turf/unsimulated/floor/setpieces/carcosa/carcosa_dirt,/area)
"be" = (/obj/decal/fakeobjects/carcosa/brokenwall/up_one,/obj/decal/fakeobjects/carcosa/brokenwall/ruined_two,/turf/unsimulated/floor/setpieces/carcosa/carcosa_dirt_inner,/area)
"bf" = (/obj/decal/fakeobjects/carcosa/brokenwall/up_two,/obj/decal/fakeobjects/carcosa/brokenwall/four,/turf/unsimulated/floor/setpieces/carcosa/carcosa_dirt_inner,/area)
"bg" = (/obj/decal/fakeobjects/carcosa/carcosa_plant/six,/turf/unsimulated/floor/setpieces/carcosa/carcosa_dirt,/area)
"bh" = (/obj/decal/fakeobjects/carcosa/tree/five,/turf/unsimulated/floor/setpieces/carcosa/carcosa_dirt,/area)
"bi" = (/obj/decal/fakeobjects/carcosa/rubble/two,/obj/decal/fakeobjects/carcosa/carcosa_plant/four,/obj/decal/fakeobjects/carcosa/brokenwall/up_one,/turf/unsimulated/floor/setpieces/carcosa/carcosa_dirt,/area)
"bj" = (/obj/decal/fakeobjects/carcosa/tree/four,/turf/unsimulated/floor/setpieces/carcosa/carcosa_dirt,/area)
"bk" = (/obj/decal/fakeobjects/carcosa/carcosa_plant/one,/obj/decal/fakeobjects/carcosa/tree/three,/turf/unsimulated/floor/setpieces/carcosa/carcosa_dirt,/area)
"bl" = (/obj/decal/fakeobjects/carcosa/carcosa_plant/one,/obj/decal/fakeobjects/carcosa/carcosa_plant/two,/turf/unsimulated/floor/setpieces/carcosa/carcosa_dirt,/area)
"bm" = (/obj/decal/fakeobjects/carcosa/brokenwall/ruined_two,/turf/unsimulated/wall/cave{name = "rock"},/area)
"bn" = (/obj/decal/fakeobjects/carcosa/carcosa_plant/three,/turf/unsimulated/wall/cave{name = "rock"},/area)
"bo" = (/obj/decal/fakeobjects/carcosa/tree/two,/turf/unsimulated/floor/setpieces/carcosa/carcosa_dirt,/area)
"bp" = (/obj/decal/fakeobjects/carcosa/carcosa_plant/three,/obj/decal/fakeobjects/carcosa/carcosa_plant/two,/turf/unsimulated/floor/setpieces/carcosa/carcosa_dirt,/area)
"bq" = (/obj/decal/fakeobjects/carcosa/statue,/turf/unsimulated/floor/setpieces/carcosa/carcosa_dirt,/area)
"br" = (/obj/decal/fakeobjects/carcosa/statue/broken,/obj/decal/fakeobjects/carcosa/carcosa_plant/one,/turf/unsimulated/floor/setpieces/carcosa/carcosa_dirt,/area)
"bs" = (/obj/decal/fakeobjects/carcosa/brokenwall/arch_one,/turf/unsimulated/floor/setpieces/carcosa/carcosa_dirt,/area)
"bt" = (/obj/decal/fakeobjects/carcosa/brokenwall/one,/turf/unsimulated/floor/setpieces/carcosa/carcosa_dirt,/area)
"bu" = (/obj/decal/fakeobjects/carcosa/brokenwall/ruined_one,/turf/unsimulated/floor/setpieces/carcosa/carcosa_dirt,/area)
"bv" = (/obj/decal/fakeobjects/carcosa/brokenwall/three,/turf/unsimulated/floor/setpieces/carcosa/carcosa_dirt,/area)
"bw" = (/obj/decal/fakeobjects/carcosa/carcosa_plant/two,/obj/decal/fakeobjects/carcosa/carcosa_plant/three,/turf/unsimulated/floor/setpieces/carcosa/carcosa_dirt,/area)
"bx" = (/obj/decal/fakeobjects/carcosa/brokenwall/ruined_two,/turf/unsimulated/floor/setpieces/carcosa/carcosa_dirt,/area)
"by" = (/obj/decal/fakeobjects/carcosa/carcosa_plant/one,/obj/decal/fakeobjects/carcosa/carcosa_plant/three,/turf/unsimulated/floor/setpieces/carcosa/carcosa_dirt,/area)
"bz" = (/obj/decal/fakeobjects/carcosa/rubble/three,/obj/decal/fakeobjects/carcosa/carcosa_plant/three,/turf/unsimulated/floor/setpieces/carcosa/carcosa_dirt,/area)
"bA" = (/obj/decal/fakeobjects/carcosa/brokenwall/two,/turf/unsimulated/wall/cave{name = "rock"},/area)
"bB" = (/obj/decal/fakeobjects/carcosa/brokenwall/up_one,/obj/decal/fakeobjects/carcosa/brokenwall/ruined_one,/obj/decal/fakeobjects/carcosa/brokenwall/ruined_two,/turf/unsimulated/floor/setpieces/carcosa/carcosa_dirt_inner,/area)
"bC" = (/obj/decal/fakeobjects/carcosa/brokenwall/up_one,/obj/decal/fakeobjects/carcosa/rubble/three,/turf/unsimulated/floor/setpieces/carcosa/carcosa_dirt_inner,/area)
"bD" = (/obj/decal/fakeobjects/carcosa/brokenwall/up_two,/obj/decal/fakeobjects/carcosa/brokenwall/ruined_two,/obj/decal/fakeobjects/carcosa/brokenwall/ruined_one,/turf/unsimulated/floor/setpieces/carcosa/carcosa_dirt_inner,/area)
"bE" = (/obj/decal/fakeobjects/carcosa/grtrans/east,/turf/unsimulated/floor/setpieces/carcosa/carcosa_dirt,/area)
"bF" = (/obj/decal/fakeobjects/carcosa/grtrans/west,/turf/unsimulated/floor/setpieces/carcosa/carcosa_dirt,/area)
"bG" = (/obj/decal/fakeobjects/carcosa/grtrans/east,/obj/decal/fakeobjects/carcosa/grtrans/north,/turf/unsimulated/floor/setpieces/carcosa/carcosa_dirt,/area)
"bH" = (/obj/decal/fakeobjects/carcosa/grtrans/north,/obj/decal/fakeobjects/carcosa/carcosa_plant/one,/turf/unsimulated/floor/setpieces/carcosa/carcosa_dirt,/area)
"bI" = (/obj/decal/fakeobjects/carcosa/grtrans/north,/obj/decal/fakeobjects/carcosa/rubble/three,/turf/unsimulated/floor/setpieces/carcosa/carcosa_dirt,/area)
"bJ" = (/obj/decal/fakeobjects/carcosa/grtrans/southwest,/obj/decal/fakeobjects/carcosa/rubble/one,/turf/unsimulated/floor/setpieces/carcosa/carcosa_dirt,/area)
"bK" = (/obj/decal/fakeobjects/carcosa/brokenwall/ruined_two,/obj/decal/fakeobjects/carcosa/grtrans/north,/turf/unsimulated/floor/setpieces/carcosa/carcosa_dirt,/area)
"bL" = (/obj/decal/fakeobjects/carcosa/brokenwall/four,/turf/unsimulated/wall/cave{name = "rock"},/area)
"bM" = (/obj/decal/lightshaft,/turf/unsimulated/floor/setpieces/carcosa/carcosa_dirt,/area)
"bN" = (/obj/decal/fakeobjects/carcosa/grtrans/east,/obj/decal/fakeobjects/carcosa/grtrans/south,/obj/decal/fakeobjects/carcosa/brokenwall/ruined_two,/turf/unsimulated/floor/setpieces/carcosa/carcosa_dirt,/area)
"bO" = (/obj/decal/fakeobjects/carcosa/grtrans/south,/turf/unsimulated/floor/setpieces/carcosa/carcosa_dirt,/area)
"bP" = (/obj/decal/fakeobjects/carcosa/brokenwall/up_two,/obj/decal/fakeobjects/carcosa/carcosa_plant/four,/turf/unsimulated/floor/setpieces/carcosa/carcosa_dirt,/area)
"bQ" = (/obj/decal/fakeobjects/carcosa/brokenwall/up_two,/obj/decal/fakeobjects/carcosa/brokenwall/four,/turf/unsimulated/floor/setpieces/carcosa/carcosa_dirt,/area)
"bR" = (/obj/decal/fakeobjects/carcosa/brokenwall/up_two,/obj/decal/fakeobjects/carcosa/brokenwall/one,/turf/unsimulated/floor/setpieces/carcosa/carcosa_dirt_inner,/area)
"bS" = (/obj/decal/fakeobjects/carcosa/rubble/three,/obj/decal/fakeobjects/carcosa/carcosa_plant/four,/turf/unsimulated/floor/setpieces/carcosa/carcosa_dirt,/area)
"bT" = (/obj/decal/fakeobjects/carcosa/brokenwall/up_one,/obj/decal/fakeobjects/carcosa/brokenwall/ruined_two,/turf/unsimulated/floor/setpieces/carcosa/carcosa_dirt,/area)
"bU" = (/obj/decal/fakeobjects/carcosa/brokenwall/up_two,/obj/decal/fakeobjects/carcosa/brokenwall/ruined_one,/turf/unsimulated/floor/setpieces/carcosa/carcosa_dirt,/area)
"bV" = (/obj/decal/fakeobjects/carcosa/tree/three,/turf/unsimulated/floor/setpieces/carcosa/carcosa_dirt,/area)

(1,1,1) = {"
aaaaaaaaaaaaaaaaaaaaaaaaaaaaaaaaaaaaaaaaaaaaaaaaaaaaaaaaaaaaaaaaaaaaaaaaaaaaaaaaaaaaaaaaaaaaaaaaaaaa
aaababababababababababababababababababababababababababababababababababababababababababababababababaa
aaababababababababababababababababababababababababababababababababababababababababababababababababaa
aaababababababababababababababababababababababababababababababababababababababababababababababababaa
aaababababababababababababababababababababababababababababababababababababababababababababababababaa
aaababababababababababababababababababababababababababababababababababababababababababababababababaa
aaababababababababababababababababababababababababababababababababababababababababababababababababaa
aaababababababababababababababababababababababababababababababababababababababababababababababababaa
aaababababababababababababababababababababababababababababababababababababababababababababababababaa
aaababababababababababababababababababababababababababababababababababababababababababababababababaa
aaababababababababababababababababababababababababababababababababababababababababababababababababaa
aaababababababababababababababababababababababababababababababababababababababababababababababababaa
aaababababababababababababababababababababababababababababababababababababababababababababababababaa
aaababababababababababababababababababababababababababababababababababababababababababababababababaa
aaababababababababababababababababababababababababababababababababababababababababababababababababaa
aaababababababababababababababababababababababababababababababababababababababababababababababababaa
aaababababababababababababababababababababababababababababababababababababababababababababababababaa
aaababababababababababababababababababababababababababababababababababababababababababababababababaa
aaababababababababababababababababababababababababababababababababababababababababababababababababaa
aaababababababababababababababababababababababababababababababababababababababababababababababababaa
aaababababababababababababababababababababababababababababababababababababababababababababababababaa
aaababababababababababababababababababababababababababababababababababababababababababababababababaa
aaababababababababababababababababababababababababababababababababababababababababababababababababaa
aaababababababababababababababababababababababababababababababababababababababababababababababababaa
aaababababababababababababababababababababababababababababababababababababababababababababababababaa
aaababababababababababababababababababababababababababababababababababababababababababababababababaa
aaababababababababababababababababababababababababababababababababababababababababababababababababaa
aaababababababababababababababababababababababababababababababababababababababababababababababababaa
aaababababababababababababababababababababababababababababababababababababababababababababababababaa
aaababababababababababababababababababababababababababababababababababababababababababababababababaa
aaababababababababababababababababababababababababababababababababababababababababababababababababaa
aaababababababababababababababababababababababababababababababababababababababababababababababababaa
aaababababababababababababababababababababababababababababababababababababababababababababababababaa
aaababababababababababababababababababababababababababababababababababababababababababababababababaa
aaababababababababababababababababababababababababababababababababababababababababababababababababaa
aaababababababababababababababababababababababababababababababababababababababababababababababababaa
aaababababababababababababababababababababababababababababababababababababababababababababababababaa
aaababababababababababababababababababababababababababababababababababababababababababababababababaa
aaababababababababababababababababababababababababababababababababababababababababababababababababaa
aaababababababababababababababababababababababababababababababababababababababababababababababababaa
aaababababababababababababababababababababababababababababababababababababababababababababababababaa
aaababababababababababababababababababababababababababababababababababababababababababababababababaa
aaababababababababababababababababababababababababababababababababababababababababababababababababaa
aaababababababababababababababababababababababababababababababababababababababababababababababababaa
aaababababababababababababababababababababababababababababababababababababababababababababababababaa
aaababababababababababababababababababababababababababababababababababababababababababababababababaa
aaababababababababababababababababababababababababababababababababababababababababababababababababaa
aaababababababababababababababababababababababababababababababababababababababababababababababababaa
aaababababababababababababababababababababababababababababababababababababababababababababababababaa
aaababababababababababababababababababababababababababababababababababababababababababababababababaa
aaababababababababababababababababababababababababababababababababababababababababababababababababaa
aaaaaaaaaaaaaaaaaaaaaaaaaaaaaaaaaaaaaaaaaaaaaaaaaaaaaaaaaaaaaaaaaaaaaaaaaaaaaaaaaaaaaaaaaaaaaaaaaaaa
aaacacacacacacacacacacacacacacacacadaeafaeafaeafaeafaeafaeafaeafaeabaeafaeafaeafaeafaeaeabaeagafadaa
aaacacacacacacacacacacacacacacacacadahaiaiaiaiaiaiaiajaiaiaiakaiaiaiahaiaiaiakaialamafaiaiaiakaiadaa
aaacacacacacacacananananananacacacadaiaiaiaiaiaiaiaiaiafaoafaiaiaiaiaiaiaiaiapaiaqafaiaiaiaiaiaiadaa
aaacacacacacacananananananananacacadaraiasaiaiaiaiaiatauafaiakaiavaiahaiaiaiakaiaiaiaiaiawaiaxaiadaa
aaacacacacacacacanananacananananacadahaiahaiaiaiaiaiaiaiaiaiaiaqayazaiaiaiaiaiaiaiaiaiaiakaiaiaiadaa
aaacacacacacaeafaeafaeafananananacadahafaAaiaBaiaCaiaDaiavaiaEaiaFaGaHaiavaiaIaiaAaiaJaiaKaiakaiadaa
aaadaLafaeafahaiaiaiakaiaMaNaOanadadaPaQahaiaiaiaiaiaiaiaiaiaqazalaRaSaiaiaiaiaiaiaiaiaiakaiaiaiadaa
aaadahaiaTafaUaiavaiaKaiaiaqakaiadadaVaSahaiaiaiaiaiaiaiaiaiaiaiazafazaWaiauaiaiaiaiaiaiaiaiakaiadaa
aaadaiaXaSayaiaiaiaiaiaiaiaiaiaiadadajafaUaiavaiaYaiaCaiavaiaAaiaJaiaCaiavaiaYaiaAaiavaiaZaiaiaiadaa
aaadahaiaiaiasaqaiaiawaiaiaiakaiadadaiaiahaiafbaaiaiahaiaiaiaiaiaiaiaiaiaiaiakaibbayaiaiakaiakaiadaa
aaadaiaiaiaiahaiaiaiakaiaiaiaiaiadadaraibcaWbdafaiaiaiaiaiaiaiaiaiaiaiaiaiaiaiaiaqayaiaibeaiaxaiadaa
aaadbfaiaJaiaUaiavaiaZaiaJaiaZaiadadaiaiaiaiayafaAaibfaiaCaiasaiaiaiaiaiawaiaZabaAaiaiaiaiaiaiaiadaa
aaadadadbgbhafafafafafafafazaWadadadahauaiaibiayazbjafaSahaiaiaiaiaiaiaiakaiazbkblaFahaiaiaiakaiadaa
aaadadadadaWafafafafafazazaWaFadadadaiaiaiaiaiaibgaSaWaWaiaiaiaiaiaiaiaiaiaiaSafayayaiaiaiaiaiaiadaa
aaadadadadafafafafafaSafaWafadadbmbnaUaiaJaiaKaiayafafaSaDaiaAaiavaiaAaiaIaiaWafafazbfaiaJaiaKaiadaa
aaadadadadafafafafafafafafayadadboazbpafafafaSafafafafafafaybqaSafafbrafaWafafafafafafaWafafbhayadaa
aaadadadadadaeafbsafaeafadadadadafafafafafafafafafafafafafafazaWaWafafayafafafafafafafafafafafafadaa
aaadadadadadahaiaiaiakaiadadadafafafafafafafafafafafafafafafafafafafafafafafafafafafafafafafafafadaa
aaadadadadadaiaiaiaiaiaiadadadafafafafafafafafafafafafafafafafafafafafafafafafafafafafafafafafafadaa
aaadadadadadbfaiavaiaZaiadadadadafafafafafafafafaFaWafafafafafafafafafafafafafafafafafafafafafadadaa
aaadadadadaWafafafafaWafafadadadbtafaLafbuadadadadaSafafafafafafafafafafafafafafafafafafafadadadadaa
aaadadadadafafafafafafafafafadadahaiaiaiaiadadadadadadafadadadafafafadadbvafaLafbuafafafadadadadadaa
aaadadadafafafafafaWafafafafafafaDaiasaqafafadadadadadadadadadadbhafadadahaiaiaiaiauafafadadadadadaa
aaadadadafafafafafaWafafafafafafafafafafaWafadadadadadadadadadadadadadadaiaiaiaiaiafafafafadadadadaa
aaadadadadadadafbtafbsafbvafbuafafafafaWaSafafafafafbjafadadadadadadadadaDaiaYaiaBaibuafafafadadadaa
aaadadadadadadadahaiaiaiakaiafafaSafafafafafafafafafafafafafafafadadadadafafafafafafafafafafafadadaa
aaadadadadadadadaiaiaiaiaiaiazbwbwaWafafafafafafafafafafafafafafadadadafafafafafafafafbabxafaeafadaa
aaadadadadazaFaWaDaiaAaiaIaiazbgaSblafafafafafafafafafafafafafafafadadadafafafafafafafaXafaiakaiadaa
aaadadazazbyafafafayafafafaWaSaWaWbyazafafafafbxafbtafaLafbubzafafadbAadbsafaLafafafafafafafaiaiadaa
aaadadbgaSaWazafafafafafafafafafafafafafafafafayaiaiaiakaiboafafadadahaiaiaiakaiaWafbxaiaBaiaZaiadaa
aaadaWafafafafafafafafafafafafafafafafafafafafaiaiaiaiaiaiaWafafadadaiaiawaiaAaiafafafafafafafafadaa
aaadafaWafaSbhafazafafafafadaeafbvafaeafbubaaWbvafaAaibBaiafafadadadahaiaiaiakaiafafafafafafbgadadaa
aaadafafafafaWafayafafafadadahaiaiaiaiaiaiafafahaiaiaiakaiafafadadadaCaiasaiawaiafafaSafaSaWaSadadaa
aaadadadafafafafafafafafadadaiaiaiaiaiaiafafafaiaiaiaiaiaiafafaWadadahaiaiaibCaiafafaWafbjafadadadaa
aaadadadadafafafafafafaWadadbfaiavaiaKaibubxafbDaiavaiaZaiafafafadadaiaiaiaiaiaiafafafafaWaSadadadaa
aaadadadadaeafbsafaeafadadadadafafafafafafafafafafafafafafafbvafbAadaDaiavaiaIaiaeafbvafadadadadadaa
aaadadadadahbEafbFakaiadadadadadaWafafafafafafafafafafafafadahaibeaiaiaiaiaibGbHbcaiakaiadadadadadaa
aaadadadadasbIafbJbKaiadadadadadadadaLafbvafbsafbvafbLadadadaiaiaiaiaiaiaibEaSbMbFaiaiaiadadadadadaa
aaadadadadaWafafafafafafaSadadadadadahaiaiaiaiaiaiaiakaibAadaDaiaAaiasaiaiaibNbOaAaiaIaiadaWadadadaa
aaadadadafafayafafafafafaFaSadadadadaUaiaCafaiaiaiaibeaiasaiaiaiakaiaiaiaiaiaiaibPafafafafafafadadaa
aaadadadafafaSafafafbhafaSazadadadadadadadadbQafaiaiaiaiaiaiapaWaiaiaiaiaiaiaiaiafafafafafafafadadaa
aaadadadaSafazaWafafafafafayafadananadanadadadadbRaiaCaiasbSafaXbTaiaJaiavaiaJaibUafafafafafafadadaa
aaadadadadbgafaSafafafaWafafananananananananadadadananadadafafafafafafafafafafafafafafafafadadadadaa
aaadadadadadbVafafafaWaSafadadadadanananananananananananadadafafafafafafafafadafafafafbjafadadadadaa
aaadadadadadadadafafafafadadadadadanananananadanananananadadadadadadafayafadadadaWafadadadadadadadaa
aaadadadadadadadadadadadadadadadadadananadadadadanananadadadadadadadadadadadadadadadadadadadadadadaa
aaadadadadadadadadadadadadadadadadadadadadadadadadadadadadadadadadadadadadadadadadadadadadadadadadaa
aaaaaaaaaaaaaaaaaaaaaaaaaaaaaaaaaaaaaaaaaaaaaaaaaaaaaaaaaaaaaaaaaaaaaaaaaaaaaaaaaaaaaaaaaaaaaaaaaaaa
"}
