//MAP CONVERTED BY dmm2tgm.py THIS HEADER COMMENT PREVENTS RECONVERSION, DO NOT REMOVE
"a" = (
/obj/item/organ/brain/flockdrone,
/turf/unsimulated/floor/feather,
/area/space)
"b" = (
/turf/unsimulated/wall/auto/feather,
/area/space)
"c" = (
/turf/unsimulated/floor/feather,
/area/space)
"d" = (
/obj/machinery/door/feather,
/turf/unsimulated/floor/feather,
/area/space)
"e" = (
/obj/machinery/door/feather{
	icon_state = "door1";
	dir = 4
	},
/turf/unsimulated/floor/feather,
/area/space)
"f" = (
/turf/unsimulated/wall/nothing,
/area/space)
"g" = (
/turf/unsimulated/floor/feather/broken,
/area/space)
"h" = (
/obj/window/feather,
/turf/unsimulated/floor/feather,
/area/space)
"i" = (
/turf/unsimulated/floor/nothing,
/area/space)
"j" = (
/turf/unsimulated/wall/nothing{
	icon_state = "platform1"
	},
/area/space)
"k" = (
/turf/unsimulated/wall/nothing{
	icon_state = "platform2"
	},
/area/space)
"l" = (
/turf/unsimulated/floor/nothing{
	icon_state = "platform";
	dir = 9
	},
/area/space)
"m" = (
/turf/unsimulated/floor/nothing{
	icon_state = "platform";
	dir = 5
	},
/area/space)
"n" = (
/obj/decal/fakeobjects/brokendrone,
/turf/unsimulated/floor/nothing,
/area/space)
"o" = (
/obj/decal/fakeobjects/brokendrone,
/turf/unsimulated/floor/feather,
/area/space)
"p" = (
/obj/decal/cleanable/flockdrone_debris,
/turf/unsimulated/floor/nothing,
/area/space)
"q" = (
/obj/decal/cleanable/flockdrone_debris,
/turf/unsimulated/floor/feather,
/area/space)
"r" = (
/obj/decal/cleanable/flockdrone_debris{
	pixel_x = 9;
	pixel_y = 5
	},
/turf/unsimulated/floor/nothing,
/area/space)
"s" = (
/obj/decal/cleanable/flockdrone_debris{
	pixel_x = -6;
	pixel_y = -5
	},
/turf/unsimulated/floor/nothing,
/area/space)
"t" = (
/obj/decal/fakeobjects/brokendrone{
	pixel_x = 7;
	pixel_y = 4
	},
/turf/unsimulated/floor/nothing,
/area/space)
"u" = (
/obj/decal/cleanable/flockdrone_debris/fluid{
	icon_state = "fluid1"
	},
/turf/unsimulated/floor/nothing,
/area/space)
"v" = (
/obj/decal/cleanable/flockdrone_debris/fluid{
	icon_state = "fluid1"
	},
/turf/unsimulated/floor/feather,
/area/space)
"w" = (
/obj/decal/cleanable/flockdrone_debris/fluid{
	icon_state = "fluid1"
	},
/turf/unsimulated/floor/feather/broken,
/area/space)
"x" = (
/obj/decal/cleanable/flockdrone_debris/fluid{
	icon_state = "fluid1"
	},
/obj/decal/cleanable/flockdrone_debris/fluid{
	icon_state = "fluid1"
	},
/turf/unsimulated/floor/feather,
/area/space)
"y" = (
/obj/decal/fakeobjects/permanentcage,
/turf/unsimulated/floor/feather,
/area/space)
"z" = (
/obj/decal/cleanable/flockdrone_debris/fluid{
	icon_state = "fluid1"
	},
/obj/decal/fakeobjects/permanentcage,
/turf/unsimulated/floor/feather,
/area/space)
"A" = (
/obj/decal/fakeobjects/permanentcage,
/turf/unsimulated/floor/feather/broken,
/area/space)
"B" = (
/obj/decal/fakeobjects/brokendrone,
/obj/decal/fakeobjects/permanentcage,
/turf/unsimulated/floor/feather,
/area/space)
"C" = (
/obj/item/organ/brain/flockdrone,
/obj/decal/fakeobjects/permanentcage,
/turf/unsimulated/floor/feather,
/area/space)
"D" = (
/obj/decal/cleanable/flockdrone_debris,
/obj/decal/fakeobjects/permanentcage,
/turf/unsimulated/floor/feather,
/area/space)

(1,1,1) = {"
f
f
f
f
f
f
f
f
f
f
f
f
f
f
f
f
f
f
f
f
f
f
f
f
f
f
f
f
f
f
f
f
f
f
f
f
f
f
f
f
f
f
f
f
f
f
f
f
f
f
f
f
f
f
f
f
f
f
f
f
f
f
f
f
f
f
f
f
f
f
f
f
f
f
f
f
f
f
f
f
f
f
f
f
f
f
f
f
f
f
f
f
f
f
f
f
f
f
f
f
"}
(2,1,1) = {"
f
f
f
f
f
f
f
f
f
f
f
f
f
f
f
f
f
f
f
f
f
f
f
f
f
f
f
f
f
f
f
f
f
f
f
f
f
f
f
f
f
f
f
f
f
f
f
f
f
f
f
f
f
f
f
f
f
f
f
f
f
f
f
f
f
f
f
f
f
f
f
f
f
f
f
f
f
f
f
f
f
f
f
f
f
f
f
f
f
f
f
f
f
f
f
f
f
f
f
f
"}
(3,1,1) = {"
f
f
f
f
f
f
f
f
f
f
f
f
f
f
f
f
f
f
f
f
f
f
f
f
f
f
f
f
f
f
f
f
f
f
f
f
f
f
f
f
f
f
f
f
f
f
f
f
f
f
f
f
f
f
f
f
f
f
f
f
f
f
f
f
f
f
f
f
f
f
f
f
f
f
f
f
f
f
f
f
f
f
f
f
f
f
f
f
f
f
f
f
f
f
f
f
f
f
f
f
"}
(4,1,1) = {"
f
f
f
f
f
f
f
f
f
f
f
f
f
f
f
f
f
f
f
f
f
f
f
f
f
f
f
f
f
f
f
f
f
f
f
f
f
f
f
f
f
f
f
f
f
f
f
f
f
f
f
f
f
f
f
f
f
f
f
f
f
f
f
f
f
f
f
f
f
f
f
f
f
f
f
f
f
f
f
f
f
f
f
f
f
f
f
f
f
f
f
f
f
f
f
f
f
f
f
f
"}
(5,1,1) = {"
f
f
f
f
f
f
f
f
f
f
f
f
f
f
f
f
f
f
f
f
f
f
f
f
f
f
f
f
f
f
f
f
f
f
f
f
f
f
f
f
f
f
f
f
f
f
f
f
f
f
f
f
f
f
f
f
f
f
f
f
f
f
f
f
f
f
f
f
f
f
f
f
f
f
f
f
f
f
f
f
f
f
f
f
f
f
f
f
f
f
f
f
f
f
f
f
f
f
f
f
"}
(6,1,1) = {"
f
f
f
f
f
f
f
f
f
f
f
f
f
f
f
f
f
f
f
f
f
f
f
f
f
f
f
f
f
f
f
f
f
f
f
f
f
f
f
f
f
f
f
f
f
f
f
f
f
f
f
f
f
f
f
f
f
f
f
f
f
f
f
f
f
f
f
f
f
f
f
f
f
f
f
f
f
f
f
f
f
f
f
f
f
f
f
f
f
f
f
f
f
f
f
f
f
f
f
f
"}
(7,1,1) = {"
f
f
f
f
f
f
f
f
f
f
f
f
f
f
f
f
f
f
f
f
f
f
f
f
f
f
f
f
f
f
f
f
f
f
f
f
f
f
f
f
f
f
f
f
f
f
f
f
f
f
f
f
f
f
f
f
f
f
f
f
f
f
f
f
f
f
f
f
f
f
f
f
f
f
f
f
f
f
f
f
f
f
f
f
f
f
f
f
f
f
f
f
f
f
f
f
f
f
f
f
"}
(8,1,1) = {"
f
f
f
f
f
f
f
f
f
f
f
f
f
f
f
f
f
f
f
f
f
f
f
f
f
f
f
f
f
f
f
f
f
f
f
f
f
f
f
f
f
f
f
f
f
f
f
f
f
f
f
f
f
f
f
f
f
f
f
f
f
f
f
f
f
f
f
f
f
f
f
f
f
f
f
f
f
f
f
f
f
f
f
f
f
f
f
f
f
f
f
f
f
f
f
f
f
f
f
f
"}
(9,1,1) = {"
f
f
f
f
f
f
f
f
f
f
f
f
f
f
f
f
f
f
f
f
f
f
f
f
f
f
f
f
f
f
f
f
f
f
f
f
f
f
f
f
f
f
f
f
f
f
f
f
f
f
f
f
f
f
f
f
f
f
f
f
f
f
f
f
f
f
f
f
f
f
f
f
f
f
f
f
f
f
f
f
f
f
f
f
f
f
f
f
f
f
f
f
f
f
f
f
f
f
f
f
"}
(10,1,1) = {"
f
f
f
f
f
f
f
f
f
f
f
f
f
f
f
f
f
f
f
f
f
f
f
f
f
f
f
f
f
f
f
f
f
f
f
f
f
f
f
f
f
f
f
f
f
f
f
f
f
f
f
f
f
f
f
f
f
f
f
f
f
f
f
f
f
f
f
f
f
f
f
f
f
f
f
f
f
f
f
f
f
f
f
f
f
f
f
f
f
f
f
f
f
f
f
f
f
f
f
f
"}
(11,1,1) = {"
f
f
f
f
f
f
f
f
f
f
f
f
f
f
f
f
f
f
f
f
f
f
f
f
f
f
f
f
f
f
f
f
f
f
f
f
f
f
f
f
f
f
f
f
f
f
f
f
f
f
f
f
f
f
f
f
f
f
f
f
f
f
f
f
f
f
f
f
f
f
f
f
f
f
f
f
f
f
f
f
f
f
f
f
f
f
f
f
f
f
f
f
f
f
f
f
f
f
f
f
"}
(12,1,1) = {"
f
f
f
f
f
f
f
f
f
f
f
f
f
f
f
f
f
f
f
f
f
f
f
f
f
f
f
f
f
f
f
f
f
f
f
f
f
f
f
f
f
f
f
f
f
f
f
f
f
f
f
f
f
f
f
f
f
f
f
f
f
f
f
f
f
f
f
f
f
f
f
f
f
f
f
f
f
f
f
f
f
f
f
f
f
f
f
f
f
f
f
f
f
f
f
f
f
f
f
f
"}
(13,1,1) = {"
f
f
f
f
f
f
f
f
f
f
f
f
f
f
f
f
f
f
f
f
f
f
f
f
f
f
f
f
f
f
f
f
f
f
f
f
f
f
f
f
f
f
f
f
f
f
f
f
f
f
f
f
f
f
f
f
f
f
f
f
f
f
f
f
f
f
f
f
f
f
f
f
f
f
f
f
f
f
f
f
f
f
f
f
f
f
f
f
f
f
f
f
f
f
f
f
f
f
f
f
"}
(14,1,1) = {"
f
f
f
f
f
f
f
f
f
f
f
f
f
f
f
f
f
f
f
f
f
f
f
f
f
f
f
f
f
f
f
f
f
f
f
f
f
f
f
f
f
f
f
f
f
f
f
f
f
f
f
f
f
f
f
f
f
f
f
f
f
f
f
f
f
f
f
f
f
f
f
f
f
f
f
f
f
f
f
f
f
f
f
f
f
f
f
f
f
f
f
f
f
f
f
f
f
f
f
f
"}
(15,1,1) = {"
f
f
f
f
f
f
f
f
f
f
f
f
f
f
f
f
f
f
f
f
f
f
f
f
f
f
f
f
f
f
f
f
f
f
f
f
f
f
f
f
f
f
f
f
f
f
f
f
f
f
f
f
f
f
f
f
f
f
f
f
f
f
f
f
f
f
f
f
f
f
f
f
f
f
f
f
f
f
f
f
f
f
f
f
f
f
f
f
f
f
f
f
f
f
f
f
f
f
f
f
"}
(16,1,1) = {"
f
f
f
f
f
f
f
f
f
f
f
f
f
f
f
f
f
f
f
f
f
f
f
f
f
f
f
f
f
f
f
f
f
f
f
f
f
f
f
f
f
f
f
f
f
f
f
f
f
f
f
f
f
f
f
f
f
f
f
f
f
f
f
f
f
f
f
f
f
f
f
f
f
f
f
f
f
f
f
f
f
f
f
f
f
f
f
f
f
f
f
f
f
f
f
f
f
f
f
f
"}
(17,1,1) = {"
f
f
f
f
f
f
f
f
f
f
f
f
f
f
f
f
f
f
f
f
f
f
f
f
f
f
f
f
f
f
f
f
f
f
f
f
f
f
f
f
f
f
f
f
f
f
f
f
f
f
f
f
f
f
f
f
f
f
f
f
f
f
f
f
f
f
f
f
f
f
f
f
f
f
f
f
f
f
f
f
f
f
f
f
f
f
f
f
f
f
f
f
f
f
f
f
f
f
f
f
"}
(18,1,1) = {"
f
f
f
f
f
f
f
f
f
f
f
f
f
f
f
f
f
f
f
f
f
f
f
f
f
f
f
f
f
f
f
f
f
f
f
f
f
f
f
f
f
f
f
f
f
f
f
f
f
f
f
f
f
f
f
f
f
f
f
f
f
f
f
f
f
f
f
f
f
f
f
f
f
f
f
f
f
f
f
f
f
f
f
f
f
f
f
f
f
f
f
f
f
f
f
f
f
f
f
f
"}
(19,1,1) = {"
f
f
f
f
f
f
f
f
f
f
f
f
f
f
f
f
f
f
f
f
f
f
f
f
f
f
f
f
f
f
f
f
f
f
f
f
f
f
f
f
f
f
f
f
f
f
f
f
f
f
f
f
f
f
f
f
f
f
f
f
f
f
f
f
f
f
f
f
f
f
f
f
f
f
f
f
f
f
f
f
f
f
f
f
f
f
f
f
f
f
f
f
f
f
f
f
f
f
f
f
"}
(20,1,1) = {"
f
f
f
f
f
f
f
f
f
f
f
f
f
f
f
f
f
f
f
f
f
f
f
f
f
f
f
f
f
f
f
f
f
f
f
f
f
f
f
f
f
f
f
f
f
f
f
f
f
f
f
f
f
f
f
f
f
f
f
f
f
f
f
f
f
f
f
f
f
f
f
f
f
f
f
f
f
f
f
f
f
f
f
f
f
f
f
f
f
f
f
f
f
f
f
f
f
f
f
f
"}
(21,1,1) = {"
f
f
f
f
f
f
f
f
f
f
f
f
f
f
f
f
f
f
f
f
f
f
f
f
f
f
f
f
f
f
f
f
f
f
f
f
f
f
f
f
f
f
f
f
f
f
f
f
f
f
f
f
f
f
f
f
f
f
f
f
f
f
f
f
f
f
f
f
f
f
f
f
f
f
f
f
f
f
f
f
f
f
f
f
f
f
f
f
f
f
f
f
f
f
f
f
f
f
f
f
"}
(22,1,1) = {"
f
f
f
f
f
f
f
f
f
f
f
f
f
f
f
f
f
f
f
f
f
f
f
f
f
f
f
f
f
f
f
f
f
f
f
f
f
f
f
f
f
f
f
f
f
f
f
f
f
f
f
f
f
f
f
f
f
f
f
f
f
f
f
f
f
f
f
f
f
f
f
f
f
f
f
f
f
f
f
f
f
f
f
f
f
f
f
f
f
f
f
f
f
f
f
f
f
f
f
f
"}
(23,1,1) = {"
f
f
f
f
f
f
f
f
f
f
f
f
f
f
f
f
f
f
f
f
f
f
f
f
f
l
i
i
i
j
k
f
f
f
f
f
f
f
f
f
f
f
f
f
f
f
f
f
f
f
f
f
f
f
f
f
f
f
f
f
f
f
f
f
f
f
f
f
f
f
f
f
f
f
f
f
f
f
f
f
f
f
f
f
f
f
f
f
f
f
f
f
f
f
f
f
f
f
f
f
"}
(24,1,1) = {"
f
f
f
f
f
f
f
f
f
f
f
f
f
f
f
f
f
f
f
f
f
f
f
f
l
i
i
i
i
i
j
k
f
f
f
f
f
f
f
f
f
f
f
f
f
f
f
f
f
f
f
f
f
f
f
f
f
f
f
f
f
f
f
f
f
f
f
f
f
f
f
f
f
f
f
f
f
f
f
f
f
f
f
f
f
f
f
f
f
f
f
f
f
f
f
f
f
f
f
f
"}
(25,1,1) = {"
f
f
f
f
f
f
f
f
f
f
f
f
f
f
f
f
f
f
f
f
f
f
f
l
i
i
i
i
i
i
j
k
f
f
f
f
f
f
f
f
f
f
f
f
f
f
f
f
f
f
f
f
f
f
f
f
f
f
f
f
f
f
f
f
f
f
f
f
f
f
f
f
f
f
f
f
f
f
f
f
f
f
f
f
f
f
f
f
f
f
f
f
f
f
f
f
f
f
f
f
"}
(26,1,1) = {"
f
f
f
f
f
f
f
f
f
f
f
f
f
f
f
f
f
f
f
f
f
f
f
i
i
i
i
i
i
i
j
k
f
f
f
f
f
f
f
f
f
f
f
f
f
f
f
f
f
f
f
f
f
f
f
f
f
f
f
f
f
f
f
f
f
f
f
f
f
f
f
f
f
f
f
f
f
f
f
f
f
f
f
f
f
f
f
f
f
f
f
f
f
f
f
f
f
f
f
f
"}
(27,1,1) = {"
f
f
f
f
f
f
f
f
f
f
f
f
f
f
f
f
f
f
f
f
f
f
l
i
i
i
i
i
j
k
f
f
f
f
f
f
f
f
f
f
f
f
f
f
f
f
f
f
f
f
f
f
f
f
f
f
f
f
f
f
f
f
f
f
f
f
f
f
f
f
f
f
f
f
f
f
f
f
f
f
f
f
f
f
f
f
f
f
f
f
f
f
f
f
f
f
f
f
f
f
"}
(28,1,1) = {"
f
f
f
f
f
f
f
f
f
f
f
f
f
f
f
f
f
f
f
f
f
f
m
i
i
i
i
j
k
f
f
f
f
f
f
f
f
f
f
f
f
f
f
f
f
f
f
f
f
b
b
b
b
b
b
b
b
b
b
b
b
f
f
f
f
f
f
f
f
f
f
f
f
f
f
f
f
f
f
f
f
f
f
f
f
f
f
f
f
f
f
f
f
f
f
f
f
f
f
f
"}
(29,1,1) = {"
f
f
f
f
f
f
f
f
f
f
f
f
f
f
f
f
f
f
f
f
f
f
f
f
f
f
f
f
f
f
f
f
f
f
f
f
f
f
f
f
f
f
f
f
b
b
b
b
b
b
c
a
c
c
c
v
c
g
g
c
b
f
f
f
f
f
f
f
f
f
f
f
f
f
f
f
f
f
f
f
f
f
f
f
f
f
f
f
f
f
f
f
f
f
f
f
f
f
f
f
"}
(30,1,1) = {"
f
f
f
f
f
f
f
f
f
f
f
f
f
f
f
f
f
f
f
f
f
f
l
i
i
j
k
f
f
f
f
f
f
f
f
f
f
f
f
f
f
b
b
b
b
c
c
c
c
h
c
c
c
c
c
c
g
g
b
b
b
f
f
f
f
f
f
f
f
f
f
f
f
f
f
f
f
f
f
f
f
f
f
f
f
f
f
f
f
f
f
f
f
f
f
f
f
f
f
f
"}
(31,1,1) = {"
f
f
f
f
f
f
f
f
f
f
f
f
f
f
f
f
f
f
f
f
f
f
i
i
i
j
i
i
j
k
f
f
f
f
f
f
f
f
f
b
b
b
c
c
h
c
c
c
c
h
g
v
c
g
c
v
c
b
b
f
f
f
f
f
f
f
f
f
f
f
f
f
f
f
f
f
f
f
f
f
f
f
f
f
f
f
f
f
f
f
f
f
f
f
f
f
f
f
f
f
"}
(32,1,1) = {"
f
f
f
f
f
f
f
f
f
f
f
f
f
f
f
f
f
f
f
f
f
f
i
j
k
f
i
i
j
k
f
f
f
f
f
f
f
b
b
b
c
c
c
c
h
c
o
c
v
b
c
c
c
c
g
b
b
b
f
f
f
f
f
f
f
f
f
f
f
f
f
f
f
f
f
f
f
f
f
f
f
f
f
f
f
f
f
f
f
f
f
f
f
f
f
f
f
f
f
f
"}
(33,1,1) = {"
f
f
f
f
f
f
f
f
f
f
f
f
f
f
f
f
f
f
f
f
f
l
i
i
u
i
r
i
i
j
k
f
f
f
f
f
b
b
y
g
c
c
c
c
h
v
w
v
c
d
c
c
c
b
b
b
f
f
f
f
f
f
f
f
f
f
f
f
f
f
f
f
f
f
f
f
f
f
f
f
f
f
f
f
f
f
f
f
f
f
f
f
f
f
f
f
f
f
f
f
"}
(34,1,1) = {"
f
f
f
f
f
f
f
f
f
f
f
f
f
f
f
f
f
f
f
f
f
n
i
i
i
u
i
i
j
t
j
k
f
f
f
b
b
b
y
c
c
c
c
c
h
g
c
c
c
b
h
h
b
b
f
f
f
f
f
f
f
f
f
f
f
f
f
f
f
f
f
f
f
f
f
f
f
f
f
f
f
f
f
f
f
f
f
f
f
f
f
f
f
f
f
f
f
f
f
f
"}
(35,1,1) = {"
f
f
f
f
f
f
f
f
f
f
f
f
f
f
f
f
f
f
f
f
f
i
i
j
k
f
f
i
j
i
i
j
k
f
b
b
c
b
A
c
c
c
g
c
h
c
c
c
c
c
g
g
b
f
f
f
f
f
f
f
f
f
f
f
f
f
f
f
f
f
f
f
f
f
f
f
f
f
f
f
f
f
f
f
f
f
f
f
f
f
f
f
f
f
f
f
f
f
f
f
"}
(36,1,1) = {"
f
f
f
f
f
f
f
f
f
f
f
f
f
f
f
f
f
f
f
f
l
j
k
i
i
i
i
j
k
i
i
i
b
b
b
q
c
b
A
c
c
c
c
c
b
c
c
c
c
c
g
b
b
f
f
f
f
f
f
f
f
f
f
f
f
f
f
f
f
f
f
f
f
f
f
f
f
f
f
f
f
f
f
f
f
f
f
f
f
f
f
f
f
f
f
f
f
f
f
f
"}
(37,1,1) = {"
f
f
f
f
f
f
f
f
f
f
f
f
f
f
f
f
f
f
f
f
i
j
i
g
i
i
i
i
i
i
b
b
b
q
o
v
g
b
b
b
b
e
b
b
b
e
b
h
h
b
b
b
f
f
f
f
f
f
f
f
f
f
f
f
f
f
f
f
f
f
f
f
l
i
i
i
i
i
i
i
i
i
i
i
i
j
k
f
f
f
f
f
f
f
f
f
f
f
f
f
"}
(38,1,1) = {"
f
f
f
f
f
f
f
f
f
f
f
f
f
f
f
f
f
f
f
f
i
i
i
i
p
g
u
s
i
b
b
c
h
w
c
c
g
b
g
c
c
c
b
c
c
c
c
c
c
y
b
f
f
f
f
f
f
f
f
f
f
f
f
f
f
f
f
f
f
f
f
f
i
i
j
i
j
i
j
i
i
i
i
i
i
j
k
f
f
f
f
f
f
f
f
f
f
f
f
f
"}
(39,1,1) = {"
f
f
f
f
f
f
f
f
f
f
f
f
f
f
f
f
f
f
f
f
i
i
j
i
i
g
g
b
b
b
c
g
b
g
c
o
c
b
g
c
c
c
b
c
g
c
c
g
c
D
b
f
f
f
f
f
f
f
f
f
f
f
f
f
f
f
f
f
f
f
f
f
i
i
i
i
i
i
i
i
i
i
i
i
i
j
k
f
f
f
f
f
f
f
f
f
f
f
f
f
"}
(40,1,1) = {"
f
f
f
f
f
f
f
f
f
f
f
f
f
f
f
f
f
f
f
f
p
u
i
b
b
g
c
c
y
b
c
c
d
c
c
v
v
b
g
c
c
a
b
c
c
c
c
c
c
b
b
f
f
f
f
f
f
f
f
f
f
f
f
f
f
f
f
f
f
f
f
f
i
i
i
i
i
i
i
i
i
i
i
i
i
j
k
f
f
f
f
f
f
f
f
f
f
f
f
f
"}
(41,1,1) = {"
f
f
f
f
f
f
f
f
f
f
f
f
f
f
f
f
f
f
f
f
i
u
b
b
g
c
c
c
c
b
g
v
b
w
w
c
c
b
c
c
c
g
b
c
c
c
c
g
g
b
f
f
f
f
f
f
f
f
f
f
f
f
f
f
f
f
f
f
f
f
f
f
i
i
i
i
i
i
i
i
i
i
i
j
i
j
k
f
f
f
f
f
f
f
f
f
f
f
f
f
"}
(42,1,1) = {"
f
f
f
f
f
f
f
f
f
f
f
f
f
f
f
f
f
f
b
b
b
b
b
b
c
c
c
c
g
b
x
q
b
q
v
c
c
b
q
c
c
g
b
c
c
c
c
c
g
b
f
f
f
f
f
f
f
f
f
f
f
f
f
f
f
f
f
f
f
f
f
f
i
i
i
i
i
i
i
i
i
i
i
j
i
j
k
f
f
f
f
f
f
f
f
f
f
f
f
f
"}
(43,1,1) = {"
f
f
f
f
f
f
f
f
f
f
f
f
f
b
b
b
b
b
b
C
c
g
g
b
h
b
e
b
h
b
b
b
b
e
b
h
b
b
b
e
b
h
b
h
h
b
e
b
b
b
f
f
f
f
f
f
f
f
f
f
f
f
f
f
f
f
f
f
f
f
f
f
i
i
i
i
i
i
i
i
i
i
i
j
i
j
k
f
f
f
f
f
f
f
f
f
f
f
f
f
"}
(44,1,1) = {"
f
f
f
f
f
f
f
f
f
f
f
f
f
b
q
g
c
c
c
c
c
c
g
d
c
c
c
c
c
d
c
c
c
c
c
g
c
d
c
c
c
c
c
c
g
c
c
c
b
f
f
f
f
f
f
f
f
f
f
f
f
f
f
f
f
f
f
f
f
f
f
f
i
i
i
i
i
i
i
i
i
i
i
j
i
j
k
f
f
f
f
f
f
f
f
f
f
f
f
f
"}
(45,1,1) = {"
f
f
f
f
f
f
f
f
f
f
f
f
f
b
g
c
g
g
g
c
c
c
c
d
c
c
c
c
c
d
c
c
c
g
c
c
c
d
c
c
c
c
c
c
c
c
g
c
b
f
f
f
f
f
f
f
f
f
f
f
f
f
f
f
f
f
f
f
f
f
f
f
i
i
i
i
i
i
i
i
i
i
i
j
i
j
k
f
f
f
f
f
f
f
f
f
f
f
f
f
"}
(46,1,1) = {"
f
f
f
f
f
f
f
f
f
f
f
f
f
b
b
b
b
b
b
y
c
c
c
b
h
b
e
b
h
b
b
b
b
e
b
h
b
b
b
e
b
h
b
h
h
b
e
b
b
b
f
f
f
f
f
f
f
f
f
f
f
f
f
f
f
f
f
f
f
f
f
f
i
i
i
i
i
i
i
i
i
i
i
i
i
j
k
f
f
f
f
f
f
f
f
f
f
f
f
f
"}
(47,1,1) = {"
f
f
f
f
f
f
f
f
f
f
f
f
f
f
f
f
f
f
b
b
b
b
b
b
c
c
c
g
c
b
c
c
b
c
c
c
c
b
c
c
c
c
b
c
c
c
c
c
c
b
f
f
f
f
f
f
f
f
f
f
f
f
f
f
f
f
f
f
f
f
f
f
i
i
i
i
i
i
i
i
i
i
i
i
i
j
k
f
f
f
f
f
f
f
f
f
f
f
f
f
"}
(48,1,1) = {"
f
f
f
f
f
f
f
f
f
f
f
f
f
f
f
f
f
f
f
f
i
i
b
b
g
c
c
c
g
b
c
c
b
c
c
c
c
b
c
c
c
c
b
c
g
c
c
c
c
b
f
f
f
f
f
f
f
f
f
f
f
f
f
f
f
f
f
f
f
f
f
f
i
i
j
i
j
i
j
i
i
i
i
i
i
j
k
f
f
f
f
f
f
f
f
f
f
f
f
f
"}
(49,1,1) = {"
f
f
f
f
f
f
f
f
f
f
f
f
f
f
f
f
f
f
f
f
i
i
i
b
b
b
a
g
c
b
c
c
d
c
g
c
v
b
c
c
c
c
b
g
c
c
c
c
g
b
b
f
f
f
f
f
f
f
f
f
f
f
f
f
f
f
f
f
f
f
f
f
m
i
i
i
i
i
i
i
i
i
i
i
i
j
k
f
f
f
f
f
f
f
f
f
f
f
f
f
"}
(50,1,1) = {"
f
f
f
f
f
f
f
f
f
f
f
f
f
f
f
f
f
f
f
f
m
i
i
i
i
b
b
b
b
b
c
c
b
c
g
v
v
b
c
c
c
c
b
g
c
c
c
g
c
y
b
f
f
f
f
f
f
f
f
f
f
f
f
f
f
f
f
f
f
f
f
f
f
f
f
f
f
f
f
f
f
f
f
f
f
f
f
f
f
f
f
f
f
f
f
f
f
f
f
f
"}
(51,1,1) = {"
f
f
f
f
f
f
f
f
f
f
f
f
f
f
f
f
f
f
f
f
f
i
i
i
i
i
i
u
i
b
b
c
h
c
c
c
o
b
c
c
c
c
b
c
c
q
c
c
c
y
b
f
f
f
f
f
f
f
f
f
f
f
f
f
f
f
f
f
f
f
f
f
f
f
f
f
f
f
f
f
f
f
f
f
f
f
f
f
f
f
f
f
f
f
f
f
f
f
f
f
"}
(52,1,1) = {"
f
f
f
f
f
f
f
f
f
f
f
f
f
f
f
f
f
f
f
f
f
m
i
i
j
i
p
u
i
p
b
b
b
g
c
g
c
b
b
b
b
e
b
b
b
e
b
h
h
b
b
b
f
f
f
f
f
f
f
f
f
f
f
f
f
f
f
f
f
f
f
f
f
f
f
f
f
f
f
f
f
f
f
f
f
f
f
f
f
f
f
f
f
f
f
f
f
f
f
f
"}
(53,1,1) = {"
f
f
f
f
f
f
f
f
f
f
f
f
f
f
f
f
f
f
f
f
f
f
m
j
k
i
i
i
j
k
i
i
b
b
b
c
c
b
z
c
c
c
c
c
b
c
c
c
c
c
q
b
b
f
f
f
f
f
f
f
f
f
f
f
f
f
f
f
f
f
f
f
f
f
f
f
f
f
f
f
f
f
f
f
f
f
f
f
f
f
f
f
f
f
f
f
f
f
f
f
"}
(54,1,1) = {"
f
f
f
f
f
f
f
f
f
f
f
f
f
f
f
f
f
f
f
f
f
f
f
f
i
i
i
i
i
j
k
i
j
k
b
b
c
b
z
v
c
c
c
c
h
c
g
c
c
c
c
c
b
f
f
f
f
f
f
f
f
f
f
f
f
f
f
f
f
f
f
f
f
f
f
f
f
f
f
f
f
f
f
f
f
f
f
f
f
f
f
f
f
f
f
f
f
f
f
f
"}
(55,1,1) = {"
f
f
f
f
f
f
f
f
f
f
f
f
f
f
f
f
f
f
f
f
f
f
f
l
i
i
i
i
i
i
j
k
f
f
f
b
b
b
B
c
c
c
c
c
h
g
g
c
c
b
h
h
b
b
f
f
f
f
f
f
f
f
f
f
f
f
f
f
f
f
f
f
f
f
f
f
f
f
f
f
f
f
f
f
f
f
f
f
f
f
f
f
f
f
f
f
f
f
f
f
"}
(56,1,1) = {"
f
f
f
f
f
f
f
f
f
f
f
f
f
f
f
f
f
f
f
f
f
f
f
m
i
i
i
i
j
i
i
i
i
j
k
f
b
b
y
c
c
c
c
c
h
c
c
c
c
d
c
c
c
b
b
b
f
f
f
f
f
f
f
f
f
f
f
f
f
f
f
f
f
f
f
f
f
f
f
f
f
f
f
f
f
f
f
f
f
f
f
f
f
f
f
f
f
f
f
f
"}
(57,1,1) = {"
f
f
f
f
f
f
f
f
f
f
f
f
f
f
f
f
f
f
f
f
f
f
f
f
f
f
i
i
j
k
i
u
i
j
k
f
f
b
b
b
c
c
c
c
h
c
c
v
c
b
c
g
g
c
o
b
b
b
f
f
f
f
f
f
f
f
f
f
f
f
f
f
f
f
f
f
f
f
f
f
f
f
f
f
f
f
f
f
f
f
f
f
f
f
f
f
f
f
f
f
"}
(58,1,1) = {"
f
f
f
f
f
f
f
f
f
f
f
f
f
f
f
f
f
f
f
f
f
f
f
f
f
f
i
i
i
j
i
u
i
j
k
f
f
f
f
b
b
b
c
c
h
v
v
c
c
h
c
c
c
c
g
c
c
b
b
f
f
f
f
f
f
f
f
f
f
f
f
f
f
f
f
f
f
f
f
f
f
f
f
f
f
f
f
f
f
f
f
f
f
f
f
f
f
f
f
f
"}
(59,1,1) = {"
f
f
f
f
f
f
f
f
f
f
f
f
f
f
f
f
f
f
f
f
f
f
f
f
f
f
i
i
i
j
u
u
i
i
j
k
f
f
f
f
f
b
b
b
b
v
o
c
v
h
c
c
c
c
c
g
g
g
b
b
b
f
f
f
f
f
f
f
f
f
f
f
f
f
f
f
f
f
f
f
f
f
f
f
f
f
f
f
f
f
f
f
f
f
f
f
f
f
f
f
"}
(60,1,1) = {"
f
f
f
f
f
f
f
f
f
f
f
f
f
f
f
f
f
f
f
f
f
f
f
f
f
f
m
i
i
i
n
i
i
j
k
f
f
f
f
f
f
f
f
f
b
b
b
b
b
b
o
c
c
g
g
g
g
g
c
c
b
f
f
f
f
f
f
f
f
f
f
f
f
f
f
f
f
f
f
f
f
f
f
f
f
f
f
f
f
f
f
f
f
f
f
f
f
f
f
f
"}
(61,1,1) = {"
f
f
f
f
f
f
f
f
f
f
f
f
f
f
f
f
f
f
f
f
f
f
f
f
f
f
f
m
i
i
i
i
i
i
i
j
k
f
f
f
f
f
f
f
f
f
f
f
f
b
b
b
b
b
b
b
b
b
b
b
b
f
f
f
f
f
f
f
f
f
f
f
f
f
f
f
f
f
f
f
f
f
f
f
f
f
f
f
f
f
f
f
f
f
f
f
f
f
f
f
"}
(62,1,1) = {"
f
f
f
f
f
f
f
f
f
f
f
f
f
f
f
f
f
f
f
f
f
f
f
f
f
f
f
f
m
i
i
i
i
i
i
j
k
f
f
f
f
f
f
f
f
f
f
f
f
f
f
f
f
f
f
f
f
f
f
f
f
f
f
f
f
f
f
f
f
f
f
f
f
f
f
f
f
f
f
f
f
f
f
f
f
f
f
f
f
f
f
f
f
f
f
f
f
f
f
f
"}
(63,1,1) = {"
f
f
f
f
f
f
f
f
f
f
f
f
f
f
f
f
f
f
f
f
f
f
f
f
f
f
f
f
f
m
i
i
i
i
i
j
k
f
f
f
f
f
f
f
f
f
f
f
f
f
f
f
f
f
f
f
f
f
f
f
f
f
f
f
f
f
f
f
f
f
f
f
f
f
f
f
f
f
f
f
f
f
f
f
f
f
f
f
f
f
f
f
f
f
f
f
f
f
f
f
"}
(64,1,1) = {"
f
f
f
f
f
f
f
f
f
f
f
f
f
f
f
f
f
f
f
f
f
f
f
f
f
f
f
f
f
f
f
m
i
i
i
j
k
f
f
f
f
f
f
f
f
f
f
f
f
f
f
f
f
f
f
f
f
f
f
f
f
f
f
f
f
f
f
f
f
f
f
f
f
f
f
f
f
f
f
f
f
f
f
f
f
f
f
f
f
f
f
f
f
f
f
f
f
f
f
f
"}
(65,1,1) = {"
f
f
f
f
f
f
f
f
f
f
f
f
f
f
f
f
f
f
f
f
f
f
f
f
f
f
f
f
f
f
f
f
m
i
i
j
k
f
f
f
f
f
f
f
f
f
f
f
f
f
f
f
f
f
f
f
f
f
f
f
f
f
f
f
f
f
f
f
f
f
f
f
f
f
f
f
f
f
f
f
f
f
f
f
f
f
f
f
f
f
f
f
f
f
f
f
f
f
f
f
"}
(66,1,1) = {"
f
f
f
f
f
f
f
f
f
f
f
f
f
f
f
f
f
f
f
f
f
f
f
f
f
f
f
f
f
f
f
f
f
f
f
f
f
f
f
f
f
f
f
f
f
f
f
f
f
f
f
f
f
f
f
f
f
f
f
f
f
f
f
f
f
f
f
f
f
f
f
f
f
f
f
f
f
f
f
f
f
f
f
f
f
f
f
f
f
f
f
f
f
f
f
f
f
f
f
f
"}
(67,1,1) = {"
f
f
f
f
f
f
f
f
f
f
f
f
f
f
f
f
f
f
f
f
f
f
f
f
f
f
f
f
f
f
f
f
f
f
f
f
f
f
f
f
f
f
f
f
f
f
f
f
f
f
f
f
f
f
f
f
f
f
f
f
f
f
f
f
f
f
f
f
f
f
f
f
f
f
f
f
f
f
f
f
f
f
f
f
f
f
f
f
f
f
f
f
f
f
f
f
f
f
f
f
"}
(68,1,1) = {"
f
f
f
f
f
f
f
f
f
f
f
f
f
f
f
f
f
f
f
f
f
f
f
f
f
f
f
f
f
f
f
f
f
f
f
f
f
f
f
f
f
f
f
f
f
f
f
f
f
f
f
f
f
f
f
f
f
f
f
f
f
f
f
f
f
f
f
f
f
f
f
f
f
f
f
f
f
f
f
f
f
f
f
f
f
f
f
f
f
f
f
f
f
f
f
f
f
f
f
f
"}
(69,1,1) = {"
f
f
f
f
f
f
f
f
f
f
f
f
f
f
f
f
f
f
f
f
f
f
f
f
f
f
f
f
f
f
f
f
f
f
f
f
f
f
f
f
f
f
f
f
f
f
f
f
f
f
f
f
f
f
f
f
f
f
f
f
f
f
f
f
f
f
f
f
f
f
f
f
f
f
f
f
f
f
f
f
f
f
f
f
f
f
f
f
f
f
f
f
f
f
f
f
f
f
f
f
"}
(70,1,1) = {"
f
f
f
f
f
f
f
f
f
f
f
f
f
f
f
f
f
f
f
f
f
f
f
f
f
f
f
f
f
f
f
f
f
f
f
f
f
f
f
f
f
f
f
f
f
f
f
f
f
f
f
f
f
f
f
f
f
f
f
f
f
f
f
f
f
f
f
f
f
f
f
f
f
f
f
f
f
f
f
f
f
f
f
f
f
f
f
f
f
f
f
f
f
f
f
f
f
f
f
f
"}
(71,1,1) = {"
f
f
f
f
f
f
f
f
f
f
f
f
f
f
f
f
f
f
f
f
f
f
f
f
f
f
f
f
f
f
f
f
f
f
f
f
f
f
f
f
f
f
f
f
f
f
f
f
f
f
f
f
f
f
f
f
f
f
f
f
f
f
f
f
f
f
f
f
f
f
f
f
f
f
f
f
f
f
f
f
f
f
f
f
f
f
f
f
f
f
f
f
f
f
f
f
f
f
f
f
"}
(72,1,1) = {"
f
f
f
f
f
f
f
f
f
f
f
f
f
f
f
f
f
f
f
f
f
f
f
f
f
f
f
f
f
f
f
f
f
f
f
f
f
f
f
f
f
f
f
f
f
f
f
f
f
f
f
f
f
f
f
f
f
f
f
f
f
f
f
f
f
f
f
f
f
f
f
f
f
f
f
f
f
f
f
f
f
f
f
f
f
f
f
f
f
f
f
f
f
f
f
f
f
f
f
f
"}
(73,1,1) = {"
f
f
f
f
f
f
f
f
f
f
f
f
f
f
f
f
f
f
f
f
f
f
f
f
f
f
f
f
f
f
f
f
f
f
f
f
f
f
f
f
f
f
f
f
f
f
f
f
f
f
f
f
f
f
f
f
f
f
f
f
f
f
f
f
f
f
f
f
f
f
f
f
f
f
f
f
f
f
f
f
f
f
f
f
f
f
f
f
f
f
f
f
f
f
f
f
f
f
f
f
"}
(74,1,1) = {"
f
f
f
f
f
f
f
f
f
f
f
f
f
f
f
f
f
f
f
f
f
f
f
f
f
f
f
f
f
f
f
f
f
f
f
f
f
f
f
f
f
f
f
f
f
f
f
f
f
f
f
f
f
f
f
f
f
f
f
f
f
f
f
f
f
f
f
f
f
f
f
f
f
f
f
f
f
f
f
f
f
f
f
f
f
f
f
f
f
f
f
f
f
f
f
f
f
f
f
f
"}
(75,1,1) = {"
f
f
f
f
f
f
f
f
f
f
f
f
f
f
f
f
f
f
f
f
f
f
f
f
f
f
f
f
f
f
f
f
f
f
f
f
f
f
f
f
f
f
f
f
f
f
f
f
f
f
f
f
f
f
f
f
f
f
f
f
f
f
f
f
f
f
f
f
f
f
f
f
f
f
f
f
f
f
f
f
f
f
f
f
f
f
f
f
f
f
f
f
f
f
f
f
f
f
f
f
"}
(76,1,1) = {"
f
f
f
f
f
f
f
f
f
f
f
f
f
f
f
f
f
f
f
f
f
f
f
f
f
f
f
f
f
f
f
f
f
f
f
f
f
f
f
f
f
f
f
f
f
f
f
f
f
f
f
f
f
f
f
f
f
f
f
f
f
f
f
f
f
f
f
f
f
f
f
f
f
f
f
f
f
f
f
f
f
f
f
f
f
f
f
f
f
f
f
f
f
f
f
f
f
f
f
f
"}
(77,1,1) = {"
f
f
f
f
f
f
f
f
f
f
f
f
f
f
f
f
f
f
f
f
f
f
f
f
f
f
f
f
f
f
f
f
f
f
f
f
f
f
f
f
f
f
f
f
f
f
f
f
f
f
f
f
f
f
f
f
f
f
f
f
f
f
f
f
f
f
f
f
f
f
f
f
f
f
f
f
f
f
f
f
f
f
f
f
f
f
f
f
f
f
f
f
f
f
f
f
f
f
f
f
"}
(78,1,1) = {"
f
f
f
f
f
f
f
f
f
f
f
f
f
f
f
f
f
f
f
f
f
f
f
f
f
f
f
f
f
f
f
f
f
f
f
f
f
f
f
f
f
f
f
f
f
f
f
f
f
f
f
f
f
f
f
f
f
f
f
f
f
f
f
f
f
f
f
f
f
f
f
f
f
f
f
f
f
f
f
f
f
f
f
f
f
f
f
f
f
f
f
f
f
f
f
f
f
f
f
f
"}
(79,1,1) = {"
f
f
f
f
f
f
f
f
f
f
f
f
f
f
f
f
f
f
f
f
f
f
f
f
f
f
f
f
f
f
f
f
f
f
f
f
f
f
f
f
f
f
f
f
f
f
f
f
f
f
f
f
f
f
f
f
f
f
f
f
f
f
f
f
f
f
f
f
f
f
f
f
f
f
f
f
f
f
f
f
f
f
f
f
f
f
f
f
f
f
f
f
f
f
f
f
f
f
f
f
"}
(80,1,1) = {"
f
f
f
f
f
f
f
f
f
f
f
f
f
f
f
f
f
f
f
f
f
f
f
f
f
f
f
f
f
f
f
f
f
f
f
f
f
f
f
f
f
f
f
f
f
f
f
f
f
f
f
f
f
f
f
f
f
f
f
f
f
f
f
f
f
f
f
f
f
f
f
f
f
f
f
f
f
f
f
f
f
f
f
f
f
f
f
f
f
f
f
f
f
f
f
f
f
f
f
f
"}
(81,1,1) = {"
f
f
f
f
f
f
f
f
f
f
f
f
f
f
f
f
f
f
f
f
f
f
f
f
f
f
f
f
f
f
f
f
f
f
f
f
f
f
f
f
f
f
f
f
f
f
f
f
f
f
f
f
f
f
f
f
f
f
f
f
f
f
f
f
f
f
f
f
f
f
f
f
f
f
f
f
f
f
f
f
f
f
f
f
f
f
f
f
f
f
f
f
f
f
f
f
f
f
f
f
"}
(82,1,1) = {"
f
f
f
f
f
f
f
f
f
f
f
f
f
f
f
f
f
f
f
f
f
f
f
f
f
f
f
f
f
f
f
f
f
f
f
f
f
f
f
f
f
f
f
f
f
f
f
f
f
f
f
f
f
f
f
f
f
f
f
f
f
f
f
f
f
f
f
f
f
f
f
f
f
f
f
f
f
f
f
f
f
f
f
f
f
f
f
f
f
f
f
f
f
f
f
f
f
f
f
f
"}
(83,1,1) = {"
f
f
f
f
f
f
f
f
f
f
f
f
f
f
f
f
f
f
f
f
f
f
f
f
f
f
f
f
f
f
f
f
f
f
f
f
f
f
f
f
f
f
f
f
f
f
f
f
f
f
f
f
f
f
f
f
f
f
f
f
f
f
f
f
f
f
f
f
f
f
f
f
f
f
f
f
f
f
f
f
f
f
f
f
f
f
f
f
f
f
f
f
f
f
f
f
f
f
f
f
"}
(84,1,1) = {"
f
f
f
f
f
f
f
f
f
f
f
f
f
f
f
f
f
f
f
f
f
f
f
f
f
f
f
f
f
f
f
f
f
f
f
f
f
f
f
f
f
f
f
f
f
f
f
f
f
f
f
f
f
f
f
f
f
f
f
f
f
f
f
f
f
f
f
f
f
f
f
f
f
f
f
f
f
f
f
f
f
f
f
f
f
f
f
f
f
f
f
f
f
f
f
f
f
f
f
f
"}
(85,1,1) = {"
f
f
f
f
f
f
f
f
f
f
f
f
f
f
f
f
f
f
f
f
f
f
f
f
f
f
f
f
f
f
f
f
f
f
f
f
f
f
f
f
f
f
f
f
f
f
f
f
f
f
f
f
f
f
f
f
f
f
f
f
f
f
f
f
f
f
f
f
f
f
f
f
f
f
f
f
f
f
f
f
f
f
f
f
f
f
f
f
f
f
f
f
f
f
f
f
f
f
f
f
"}
(86,1,1) = {"
f
f
f
f
f
f
f
f
f
f
f
f
f
f
f
f
f
f
f
f
f
f
f
f
f
f
f
f
f
f
f
f
f
f
f
f
f
f
f
f
f
f
f
f
f
f
f
f
f
f
f
f
f
f
f
f
f
f
f
f
f
f
f
f
f
f
f
f
f
f
f
f
f
f
f
f
f
f
f
f
f
f
f
f
f
f
f
f
f
f
f
f
f
f
f
f
f
f
f
f
"}
(87,1,1) = {"
f
f
f
f
f
f
f
f
f
f
f
f
f
f
f
f
f
f
f
f
f
f
f
f
f
f
f
f
f
f
f
f
f
f
f
f
f
f
f
f
f
f
f
f
f
f
f
f
f
f
f
f
f
f
f
f
f
f
f
f
f
f
f
f
f
f
f
f
f
f
f
f
f
f
f
f
f
f
f
f
f
f
f
f
f
f
f
f
f
f
f
f
f
f
f
f
f
f
f
f
"}
(88,1,1) = {"
f
f
f
f
f
f
f
f
f
f
f
f
f
f
f
f
f
f
f
f
f
f
f
f
f
f
f
f
f
f
f
f
f
f
f
f
f
f
f
f
f
f
f
f
f
f
f
f
f
f
f
f
f
f
f
f
f
f
f
f
f
f
f
f
f
f
f
f
f
f
f
f
f
f
f
f
f
f
f
f
f
f
f
f
f
f
f
f
f
f
f
f
f
f
f
f
f
f
f
f
"}
(89,1,1) = {"
f
f
f
f
f
f
f
f
f
f
f
f
f
f
f
f
f
f
f
f
f
f
f
f
f
f
f
f
f
f
f
f
f
f
f
f
f
f
f
f
f
f
f
f
f
f
f
f
f
f
f
f
f
f
f
f
f
f
f
f
f
f
f
f
f
f
f
f
f
f
f
f
f
f
f
f
f
f
f
f
f
f
f
f
f
f
f
f
f
f
f
f
f
f
f
f
f
f
f
f
"}
(90,1,1) = {"
f
f
f
f
f
f
f
f
f
f
f
f
f
f
f
f
f
f
f
f
f
f
f
f
f
f
f
f
f
f
f
f
f
f
f
f
f
f
f
f
f
f
f
f
f
f
f
f
f
f
f
f
f
f
f
f
f
f
f
f
f
f
f
f
f
f
f
f
f
f
f
f
f
f
f
f
f
f
f
f
f
f
f
f
f
f
f
f
f
f
f
f
f
f
f
f
f
f
f
f
"}
(91,1,1) = {"
f
f
f
f
f
f
f
f
f
f
f
f
f
f
f
f
f
f
f
f
f
f
f
f
f
f
f
f
f
f
f
f
f
f
f
f
f
f
f
f
f
f
f
f
f
f
f
f
f
f
f
f
f
f
f
f
f
f
f
f
f
f
f
f
f
f
f
f
f
f
f
f
f
f
f
f
f
f
f
f
f
f
f
f
f
f
f
f
f
f
f
f
f
f
f
f
f
f
f
f
"}
(92,1,1) = {"
f
f
f
f
f
f
f
f
f
f
f
f
f
f
f
f
f
f
f
f
f
f
f
f
f
f
f
f
f
f
f
f
f
f
f
f
f
f
f
f
f
f
f
f
f
f
f
f
f
f
f
f
f
f
f
f
f
f
f
f
f
f
f
f
f
f
f
f
f
f
f
f
f
f
f
f
f
f
f
f
f
f
f
f
f
f
f
f
f
f
f
f
f
f
f
f
f
f
f
f
"}
(93,1,1) = {"
f
f
f
f
f
f
f
f
f
f
f
f
f
f
f
f
f
f
f
f
f
f
f
f
f
f
f
f
f
f
f
f
f
f
f
f
f
f
f
f
f
f
f
f
f
f
f
f
f
f
f
f
f
f
f
f
f
f
f
f
f
f
f
f
f
f
f
f
f
f
f
f
f
f
f
f
f
f
f
f
f
f
f
f
f
f
f
f
f
f
f
f
f
f
f
f
f
f
f
f
"}
(94,1,1) = {"
f
f
f
f
f
f
f
f
f
f
f
f
f
f
f
f
f
f
f
f
f
f
f
f
f
f
f
f
f
f
f
f
f
f
f
f
f
f
f
f
f
f
f
f
f
f
f
f
f
f
f
f
f
f
f
f
f
f
f
f
f
f
f
f
f
f
f
f
f
f
f
f
f
f
f
f
f
f
f
f
f
f
f
f
f
f
f
f
f
f
f
f
f
f
f
f
f
f
f
f
"}
(95,1,1) = {"
f
f
f
f
f
f
f
f
f
f
f
f
f
f
f
f
f
f
f
f
f
f
f
f
f
f
f
f
f
f
f
f
f
f
f
f
f
f
f
f
f
f
f
f
f
f
f
f
f
f
f
f
f
f
f
f
f
f
f
f
f
f
f
f
f
f
f
f
f
f
f
f
f
f
f
f
f
f
f
f
f
f
f
f
f
f
f
f
f
f
f
f
f
f
f
f
f
f
f
f
"}
(96,1,1) = {"
f
f
f
f
f
f
f
f
f
f
f
f
f
f
f
f
f
f
f
f
f
f
f
f
f
f
f
f
f
f
f
f
f
f
f
f
f
f
f
f
f
f
f
f
f
f
f
f
f
f
f
f
f
f
f
f
f
f
f
f
f
f
f
f
f
f
f
f
f
f
f
f
f
f
f
f
f
f
f
f
f
f
f
f
f
f
f
f
f
f
f
f
f
f
f
f
f
f
f
f
"}
(97,1,1) = {"
f
f
f
f
f
f
f
f
f
f
f
f
f
f
f
f
f
f
f
f
f
f
f
f
f
f
f
f
f
f
f
f
f
f
f
f
f
f
f
f
f
f
f
f
f
f
f
f
f
f
f
f
f
f
f
f
f
f
f
f
f
f
f
f
f
f
f
f
f
f
f
f
f
f
f
f
f
f
f
f
f
f
f
f
f
f
f
f
f
f
f
f
f
f
f
f
f
f
f
f
"}
(98,1,1) = {"
f
f
f
f
f
f
f
f
f
f
f
f
f
f
f
f
f
f
f
f
f
f
f
f
f
f
f
f
f
f
f
f
f
f
f
f
f
f
f
f
f
f
f
f
f
f
f
f
f
f
f
f
f
f
f
f
f
f
f
f
f
f
f
f
f
f
f
f
f
f
f
f
f
f
f
f
f
f
f
f
f
f
f
f
f
f
f
f
f
f
f
f
f
f
f
f
f
f
f
f
"}
(99,1,1) = {"
f
f
f
f
f
f
f
f
f
f
f
f
f
f
f
f
f
f
f
f
f
f
f
f
f
f
f
f
f
f
f
f
f
f
f
f
f
f
f
f
f
f
f
f
f
f
f
f
f
f
f
f
f
f
f
f
f
f
f
f
f
f
f
f
f
f
f
f
f
f
f
f
f
f
f
f
f
f
f
f
f
f
f
f
f
f
f
f
f
f
f
f
f
f
f
f
f
f
f
f
"}
(100,1,1) = {"
f
f
f
f
f
f
f
f
f
f
f
f
f
f
f
f
f
f
f
f
f
f
f
f
f
f
f
f
f
f
f
f
f
f
f
f
f
f
f
f
f
f
f
f
f
f
f
f
f
f
f
f
f
f
f
f
f
f
f
f
f
f
f
f
f
f
f
f
f
f
f
f
f
f
f
f
f
f
f
f
f
f
f
f
f
f
f
f
f
f
f
f
f
f
f
f
f
f
f
f
"}
