//MAP CONVERTED BY dmm2tgm.py THIS HEADER COMMENT PREVENTS RECONVERSION, DO NOT REMOVE
"a" = (
/turf/space,
/area)
"b" = (
/turf/unsimulated/wall/cave,
/area)
"c" = (
/obj/decal/cleanable/cobweb,
/turf/unsimulated/floor/cave,
/area)
"d" = (
/obj/decal/cleanable/cobweb{
	icon_state = "cobweb2"
	},
/turf/unsimulated/floor/cave,
/area)
"e" = (
/obj/decal/cleanable/cobweb,
/obj/decal/cleanable/cobweb{
	icon_state = "cobweb2"
	},
/turf/unsimulated/floor/cave,
/area)
"f" = (
/obj/decal/lightshaft,
/turf/unsimulated/floor/cave,
/area)
"g" = (
/turf/unsimulated/floor/cave,
/area)
"h" = (
/obj/decal/mushrooms/type4,
/turf/unsimulated/floor/cave,
/area)
"i" = (
/obj/decal/cleanable/cobweb{
	icon_state = "cobweb2"
	},
/turf/unsimulated/wall/cave,
/area)
"j" = (
/obj/decal/cleanable/cobweb,
/turf/unsimulated/wall/cave,
/area)
"k" = (
/obj/decal/mushrooms/type3,
/turf/unsimulated/floor/cave,
/area)
"l" = (
/obj/table/reinforced/bar,
/obj/candle_light,
/turf/unsimulated/floor/cave,
/area)
"m" = (
/obj/decal/mushrooms/type1,
/obj/decal/cleanable/cobweb,
/turf/unsimulated/floor/cave,
/area)
"n" = (
/obj/table/reinforced/bar,
/turf/unsimulated/floor/cave,
/area)
"o" = (
/obj/table/reinforced/bar,
/obj/decal/cleanable/cobweb,
/obj/candle_light,
/turf/unsimulated/floor/cave,
/area)
"p" = (
/obj/decal/mushrooms/type1,
/turf/unsimulated/floor/cave,
/area)
"q" = (
/obj/decal/cleanable/cobweb,
/obj/decal/cleanable/cobweb{
	icon_state = "cobweb2"
	},
/turf/unsimulated/wall/cave,
/area)

(1,1,1) = {"
a
a
a
a
a
a
a
a
a
a
a
a
a
a
a
a
a
a
a
a
"}
(2,1,1) = {"
a
a
a
a
a
a
a
a
a
a
a
a
a
a
a
a
a
a
a
a
"}
(3,1,1) = {"
a
a
a
a
a
a
a
a
a
a
a
a
a
a
b
b
b
a
a
a
"}
(4,1,1) = {"
a
a
a
a
b
b
b
b
b
a
a
a
b
b
b
c
b
a
a
a
"}
(5,1,1) = {"
a
a
a
a
b
c
g
g
b
a
a
a
b
c
b
d
b
a
a
a
"}
(6,1,1) = {"
a
a
a
a
b
d
g
g
b
a
a
b
b
g
i
c
b
a
a
a
"}
(7,1,1) = {"
a
a
a
b
b
c
g
g
i
b
b
b
o
g
k
g
i
b
a
a
"}
(8,1,1) = {"
a
a
a
b
e
g
g
g
g
i
b
g
n
g
g
p
g
i
b
a
"}
(9,1,1) = {"
a
a
a
b
b
d
g
g
g
g
g
f
n
g
g
g
g
g
b
a
"}
(10,1,1) = {"
a
a
a
a
b
b
b
b
b
g
g
g
n
h
g
g
g
g
i
b
"}
(11,1,1) = {"
a
a
a
a
a
a
a
a
b
b
l
n
n
g
g
g
g
g
g
b
"}
(12,1,1) = {"
a
a
b
b
b
b
a
a
a
b
d
g
g
g
g
g
g
q
b
b
"}
(13,1,1) = {"
a
a
b
c
f
b
b
a
b
b
m
g
g
g
g
g
g
g
g
b
"}
(14,1,1) = {"
a
a
b
d
g
h
b
b
b
c
g
g
g
g
g
p
j
b
b
b
"}
(15,1,1) = {"
a
a
b
b
d
g
g
g
g
g
g
g
j
b
g
j
b
a
a
a
"}
(16,1,1) = {"
a
a
a
b
b
d
g
g
g
k
j
b
b
b
d
b
a
a
a
a
"}
(17,1,1) = {"
a
a
a
a
b
b
b
d
j
b
b
a
a
b
b
b
a
a
a
a
"}
(18,1,1) = {"
a
a
a
a
a
a
b
b
b
a
a
a
a
a
a
a
a
a
a
a
"}
(19,1,1) = {"
a
a
a
a
a
a
a
a
a
a
a
a
a
a
a
a
a
a
a
a
"}
(20,1,1) = {"
a
a
a
a
a
a
a
a
a
a
a
a
a
a
a
a
a
a
a
a
"}
