"a" = (/obj/decal/cleanable/dirt/dirt3,/obj/machinery/light/runway_light/delay2,/turf/simulated/floor/shuttlebay,/area/space)
"b" = (/obj/machinery/light{dir = 1; pixel_y = 4},/turf/space,/area/space)
"d" = (/obj/cable/auto/purple/node,/obj/machinery/vending/snack,/obj/machinery/light/small/floor/cool/very,/obj/decal/cleanable/cobweb,/obj/decal/cleanable/dirt/dirt3,/obj/decal/cleanable/dirt,/obj/window/bulletproof/east,/obj/random_item_spawner/snacks/one,/turf/simulated/floor/plating/airless,/area/space)
"f" = (/obj/decal/tile_edge/floorguide/arrow_e{pixel_x = 7},/turf/simulated/floor/airless/caution/west,/area/space)
"g" = (/turf/simulated/wall/auto/supernorn,/area/space)
"h" = (/obj/decal/cleanable/rust,/turf/simulated/wall/auto/supernorn,/area/space)
"i" = (/obj/machinery/light{dir = 3; event_handler_flags = s},/obj/machinery/light/runway_light/delay2,/turf/simulated/floor/shuttlebay,/area/space)
"k" = (/obj/cable/purple,/obj/cable/auto/purple/node,/obj/machinery/vending/coffee,/obj/machinery/light/small/floor/cool/very,/obj/decal/cleanable/dirt,/obj/machinery/power/apc/autoname_north/nopoweralert,/turf/simulated/floor/plating/airless,/area/space)
"l" = (/obj/lattice/auto/turf_attaching,/obj/machinery/light/runway_light/delay3,/turf/space,/area/space)
"m" = (/obj/decal/cleanable/generic,/turf/simulated/floor/shuttlebay,/area/space)
"n" = (/turf/space,/area/space)
"q" = (/obj/lattice/auto/turf_attaching,/obj/lattice/auto/turf_attaching,/turf/space,/area/space)
"s" = (/obj/decal/cleanable/dirt/dirt2,/obj/machinery/light{dir = 3; event_handler_flags = s},/turf/simulated/floor/shuttlebay,/area/space)
"t" = (/obj/machinery/light/runway_light/delay5,/obj/lattice/auto/turf_attaching,/turf/space,/area/space)
"u" = (/obj/decal/tile_edge/floorguide/arrow_e{pixel_x = 10},/turf/simulated/floor/airless/caution/east,/area/space)
"z" = (/obj/decal/poster/wallsign/stencil/right/s{pixel_y = 10; pixel_x = 12},/obj/decal/poster/wallsign/poster_nt{pixel_x = -5; pixel_y = -2},/turf/simulated/wall/auto/supernorn,/area/space)
"A" = (/obj/machinery/light/runway_light/delay4,/obj/lattice/auto/turf_attaching,/turf/space,/area/space)
"C" = (/obj/cable/auto/purple/node,/obj/machinery/vending/alcohol/with_ammo,/obj/machinery/light/small/floor/cool/very,/obj/decal/cleanable/cobweb2,/obj/decal/cleanable/dirt/dirt2,/obj/decal/cleanable/dirt,/turf/simulated/floor/plating/airless,/area/space)
"F" = (/obj/cable/auto/purple/node,/obj/machinery/vending/air_vendor,/obj/machinery/light/small/floor/cool/very,/obj/decal/cleanable/dirt,/obj/window/bulletproof/west,/turf/simulated/floor/plating/airless,/area/space)
"J" = (/obj/decal/poster/wallsign/stencil/right/o{pixel_x = 12; pixel_y = 10},/obj/decal/poster/wallsign/poster_human,/turf/simulated/wall/auto/supernorn,/area/space)
"K" = (/turf/simulated/floor/shuttlebay,/area/space)
"M" = (/obj/item/casing/derringer{pixel_y = 5; pixel_x = 2},/obj/item/casing/derringer{pixel_y = null; pixel_x = -4},/turf/simulated/floor/shuttlebay,/area/space)
"N" = (/obj/decal/cleanable/oil,/turf/simulated/floor/shuttlebay,/area/space)
"T" = (/obj/decal/poster/wallsign/stencil/right/p{pixel_x = 12; pixel_y = 10},/obj/decal/poster/wallsign/poster_discount{pixel_y = 1; pixel_x = -5},/turf/simulated/wall/auto/supernorn,/area/space)
"U" = (/obj/decal/poster/wallsign/stencil/right/h{pixel_x = 12; pixel_y = 10},/obj/decal/poster/wallsign/poster_octocluwne{pixel_x = -5; pixel_y = 1},/turf/simulated/wall/auto/supernorn,/area/space)
"V" = (/obj/machinery/light/runway_light/delay4,/obj/lattice/auto/turf_attaching,/obj/lattice/auto/turf_attaching,/turf/space,/area/space)
"X" = (/obj/decal/tile_edge/floorguide/arrow_e{pixel_x = 7},/obj/decal/cleanable/machine_debris,/turf/simulated/floor/airless/caution/west,/area/space)
"Y" = (/obj/lattice/auto/turf_attaching,/turf/space,/area/space)

(1,1,1) = {"
nnngghgn
nnXFCkdu
tAlaKMmY
YYqKNKKY
tVliKKsq
nnfzUJTu
nnnbnnbn
"}
