//MAP CONVERTED BY dmm2tgm.py THIS HEADER COMMENT PREVENTS RECONVERSION, DO NOT REMOVE
"aa" = (
/obj/cable/orange,
/obj/machinery/atmospherics/binary/reactor_turbine,
/turf/simulated/floor/engine,
/area/station/engine/inner)
"ab" = (
/obj/cable/orange{
	d1 = 1;
	d2 = 2;
	icon_state = "1-2"
	},
/obj/cable/orange{
	d1 = 1;
	d2 = 4;
	icon_state = "1-4"
	},
/turf/simulated/floor/engine,
/area/station/engine/inner)
"ac" = (
/obj/cable/orange{
	d1 = 1;
	d2 = 2;
	icon_state = "1-2"
	},
/obj/machinery/atmospherics/pipe/simple/insulated/cold{
	can_rupture = 0;
	dir = 10
	},
/turf/simulated/floor/engine/caution/south,
/area/station/engine/inner)
"ad" = (
/obj/cable/orange{
	d1 = 1;
	d2 = 2;
	icon_state = "1-2"
	},
/turf/simulated/floor/engine,
/area/station/engine/inner)
"ae" = (
/obj/cable/orange{
	d1 = 1;
	d2 = 8;
	icon_state = "1-8"
	},
/obj/cable/orange,
/obj/machinery/atmospherics/binary/nuclear_reactor/prefilled/normal,
/turf/simulated/floor/engine,
/area/station/engine/inner)
"af" = (
/obj/cable/orange{
	d1 = 2;
	d2 = 4;
	icon_state = "2-4"
	},
/turf/simulated/floor/engine,
/area/station/engine/inner)
"ag" = (
/obj/cable/orange{
	d1 = 2;
	d2 = 8;
	icon_state = "2-8"
	},
/turf/simulated/floor/engine,
/area/station/engine/inner)
"ah" = (
/obj/cable{
	d1 = 0;
	d2 = 2;
	icon_state = "0-2"
	},
/turf/simulated/floor/engine/caution/south,
/area/station/engine/inner)
"ai" = (
/obj/decal/poster/wallsign/accident_sign{
	transform = list(-1,0,0,0,1,0)
	},
/turf/simulated/wall/auto/reinforced/supernorn,
/area/station/engine/inner)
"aj" = (
/obj/machinery/atmospherics/binary/passive_gate{
	dir = 4;
	pixel_y = 1;
	target_pressure = 1e+031
	},
/turf/simulated/floor/engine/caution/east,
/area/station/engine/inner)
"ak" = (
/obj/machinery/atmospherics/binary/passive_gate{
	dir = 8;
	pixel_y = 1;
	target_pressure = 1e+031
	},
/turf/simulated/floor/engine/caution/west,
/area/station/engine/inner)
"al" = (
/obj/machinery/atmospherics/binary/valve{
	dir = 8;
	name = "burn chamber bypass valve"
	},
/turf/simulated/floor/engine,
/area/station/engine/inner)
"am" = (
/obj/machinery/atmospherics/binary/valve{
	dir = 8;
	name = "cold loop inlet valve"
	},
/turf/simulated/floor/engine/caution/west,
/area/station/engine/inner)
"an" = (
/obj/machinery/atmospherics/binary/valve{
	dir = 8;
	name = "hot loop inlet valve"
	},
/turf/simulated/floor/engine/caution/east,
/area/station/engine/inner)
"ao" = (
/obj/machinery/atmospherics/binary/valve{
	dir = 8;
	name = "purge valve"
	},
/turf/simulated/floor/engine/caution/south,
/area/station/engine/inner)
"ap" = (
/obj/machinery/atmospherics/binary/valve{
	name = "cold loop bypass valve"
	},
/turf/simulated/floor/engine,
/area/station/engine/inner)
"aq" = (
/obj/machinery/atmospherics/pipe/manifold/overfloor{
	dir = 4
	},
/turf/simulated/floor/engine,
/area/station/engine/inner)
"ar" = (
/obj/machinery/atmospherics/pipe/manifold/overfloor{
	dir = 8
	},
/turf/simulated/floor/engine,
/area/station/engine/inner)
"as" = (
/obj/machinery/atmospherics/pipe/simple/insulated,
/obj/machinery/light/small/floor/warm,
/turf/simulated/floor/engine,
/area/station/engine/inner)
"at" = (
/obj/machinery/atmospherics/pipe/simple/insulated,
/turf/simulated/floor/engine,
/area/station/engine/inner)
"au" = (
/obj/machinery/atmospherics/pipe/simple/insulated/cold,
/turf/simulated/floor/engine,
/area/station/engine/inner)
"av" = (
/obj/machinery/atmospherics/pipe/simple/insulated/cold{
	can_rupture = 0;
	dir = 5
	},
/turf/simulated/floor/engine/caution/south,
/area/station/engine/inner)
"aw" = (
/obj/machinery/atmospherics/pipe/simple/insulated/cold{
	can_rupture = 0;
	dir = 8
	},
/obj/machinery/meter,
/turf/simulated/floor/engine,
/area/station/engine/inner)
"ax" = (
/obj/machinery/atmospherics/pipe/simple/insulated/cold{
	can_rupture = 0;
	dir = 8
	},
/obj/machinery/meter,
/turf/simulated/floor/engine/caution/south,
/area/station/engine/inner)
"ay" = (
/obj/machinery/atmospherics/pipe/simple/insulated/cold{
	can_rupture = 0;
	dir = 8
	},
/turf/simulated/floor/engine,
/area/station/engine/inner)
"az" = (
/obj/machinery/atmospherics/pipe/simple/insulated/cold{
	can_rupture = 0;
	dir = 8
	},
/turf/simulated/floor/engine/caution/north,
/area/station/engine/inner)
"aA" = (
/obj/machinery/atmospherics/pipe/simple/insulated/cold{
	can_rupture = 0;
	dir = 9
	},
/obj/machinery/meter,
/turf/simulated/floor/engine,
/area/station/engine/inner)
"aB" = (
/obj/machinery/atmospherics/pipe/simple/insulated/cold{
	dir = 6
	},
/turf/simulated/wall/auto/reinforced/supernorn,
/area/station/engine/inner)
"aC" = (
/obj/machinery/atmospherics/pipe/simple/insulated{
	can_rupture = 0;
	dir = 6
	},
/obj/machinery/meter,
/turf/simulated/floor/engine,
/area/station/engine/inner)
"aD" = (
/obj/machinery/atmospherics/pipe/simple/insulated{
	can_rupture = 0;
	dir = 6
	},
/turf/simulated/floor/engine,
/area/station/engine/inner)
"aE" = (
/obj/machinery/atmospherics/pipe/simple/insulated{
	can_rupture = 0;
	dir = 6
	},
/turf/simulated/floor/engine/caution/south,
/area/station/engine/inner)
"aF" = (
/obj/machinery/atmospherics/pipe/simple/insulated{
	can_rupture = 0;
	dir = 9
	},
/turf/simulated/floor/engine/caution/south,
/area/station/engine/inner)
"aG" = (
/obj/machinery/atmospherics/pipe/simple/insulated{
	can_rupture = 0
	},
/obj/machinery/atmospherics/pipe/simple/insulated{
	dir = 4
	},
/obj/machinery/light/small/floor/warm,
/turf/simulated/floor/engine,
/area/station/engine/inner)
"aH" = (
/obj/machinery/atmospherics/pipe/simple/insulated{
	dir = 10
	},
/turf/simulated/floor/engine,
/area/station/engine/inner)
"aI" = (
/obj/machinery/atmospherics/pipe/simple/insulated{
	dir = 4
	},
/obj/cable/orange{
	d1 = 1;
	d2 = 2;
	icon_state = "1-2"
	},
/turf/simulated/floor/engine,
/area/station/engine/inner)
"aJ" = (
/obj/machinery/atmospherics/pipe/simple/insulated{
	dir = 4
	},
/turf/simulated/floor/engine,
/area/station/engine/inner)
"aK" = (
/obj/machinery/atmospherics/pipe/simple/insulated{
	dir = 8
	},
/obj/machinery/meter,
/turf/simulated/floor/engine/caution/south,
/area/station/engine/inner)
"aL" = (
/obj/machinery/atmospherics/pipe/simple/insulated{
	dir = 9
	},
/turf/simulated/floor/engine,
/area/station/engine/inner)
"aM" = (
/obj/machinery/centrifuge_nuclear,
/turf/simulated/floor/engine/caution/east,
/area/station/engine/inner)
"aN" = (
/obj/machinery/light/incandescent{
	dir = 4
	},
/obj/machinery/atmospherics/pipe/simple/insulated/cold{
	can_rupture = 0;
	dir = 10
	},
/turf/simulated/floor/engine/caution/north,
/area/station/engine/inner)
"aO" = (
/obj/machinery/light/incandescent{
	dir = 8
	},
/obj/machinery/atmospherics/pipe/simple/insulated/cold{
	can_rupture = 0;
	dir = 8
	},
/turf/simulated/floor/engine/caution/north,
/area/station/engine/inner)
"aP" = (
/obj/machinery/light/small/floor/warm,
/obj/machinery/atmospherics/pipe/manifold/overfloor{
	dir = 8
	},
/turf/simulated/floor/engine,
/area/station/engine/inner)
"aQ" = (
/obj/machinery/light/small/floor/warm,
/obj/machinery/atmospherics/pipe/simple/insulated/cold{
	can_rupture = 0;
	dir = 8
	},
/obj/cable/orange{
	d1 = 1;
	d2 = 2;
	icon_state = "1-2"
	},
/turf/simulated/floor/engine/caution/north,
/area/station/engine/inner)
"aR" = (
/obj/machinery/light/small/floor/warm,
/obj/machinery/atmospherics/pipe/simple/insulated{
	dir = 5
	},
/turf/simulated/floor/engine,
/area/station/engine/inner)
"aS" = (
/obj/machinery/meter,
/obj/machinery/atmospherics/pipe/simple/insulated{
	dir = 9
	},
/turf/simulated/floor/engine,
/area/station/engine/inner)
"aT" = (
/obj/machinery/nanofab/nuclear,
/turf/simulated/floor/engine/caution/west,
/area/station/engine/inner)
"aU" = (
/obj/storage/closet/radiation,
/turf/simulated/floor/engine/caution/corner{
	dir = 1
	},
/area/station/engine/inner)
"aV" = (
/obj/storage/closet/radiation,
/turf/simulated/floor/engine/caution/corner{
	dir = 2
	},
/area/station/engine/inner)
"aW" = (
/obj/storage/closet/radiation,
/turf/simulated/floor/engine/caution/corner{
	dir = 4
	},
/area/station/engine/inner)
"aX" = (
/obj/storage/closet/radiation,
/turf/simulated/floor/engine/caution/corner{
	dir = 8
	},
/area/station/engine/inner)
"aY" = (
/obj/storage/secure/crate/eng,
/obj/item/raw_material/cerenkite,
/obj/item/raw_material/cerenkite,
/obj/item/raw_material/cerenkite,
/obj/item/raw_material/cerenkite,
/obj/item/raw_material/cerenkite,
/obj/item/raw_material/cerenkite,
/turf/simulated/floor/engine/caution/west,
/area/station/engine/inner)
"aZ" = (
/turf/simulated/floor/engine,
/area/station/engine/inner)
"ba" = (
/turf/simulated/floor/engine/caution/west,
/area/station/engine/inner)
"bb" = (
/turf/simulated/floor/engine/caution/east,
/area/station/engine/inner)

(1,1,1) = {"
aU
ba
am
ba
ba
ba
ba
ak
aY
aT
aW
"}
(2,1,1) = {"
aB
au
aq
au
au
ap
au
aq
au
aP
av
"}
(3,1,1) = {"
aO
aC
at
at
at
aR
aZ
aZ
aZ
ay
ao
"}
(4,1,1) = {"
az
aZ
aZ
aZ
aZ
aJ
aZ
aZ
aZ
aw
ax
"}
(5,1,1) = {"
az
aZ
af
ad
ad
aI
ad
ad
ab
ad
ac
"}
(6,1,1) = {"
aQ
ad
ae
aZ
aZ
aJ
aZ
aZ
ag
aa
ah
"}
(7,1,1) = {"
az
aZ
aZ
aZ
aZ
aJ
aZ
aZ
aZ
aZ
aE
"}
(8,1,1) = {"
az
aZ
aZ
aZ
aZ
aJ
aD
at
ar
aS
aK
"}
(9,1,1) = {"
aN
au
au
aA
aD
aG
aL
aZ
al
aZ
ao
"}
(10,1,1) = {"
ai
aZ
aD
at
aL
aH
at
ar
aq
as
aF
"}
(11,1,1) = {"
aV
bb
an
bb
bb
bb
bb
aj
bb
aM
aX
"}
