"aa" = (/turf/space,/area)
"ab" = (/turf/unsimulated/wall/adaptive/wizard{icon_state = "wizard_wall_6"},/area)
"ac" = (/turf/unsimulated/wall/adaptive/wizard{icon_state = "wizard_wall_12"},/area)
"ad" = (/turf/unsimulated/wall/adaptive/wizard{icon_state = "wizard_wall_10"},/area)
"ae" = (/turf/unsimulated/wall/adaptive/wizard{icon_state = "wizard_wall_3"},/area)
"af" = (/turf/unsimulated/floor/wizard/plating,/area)
"ag" = (/obj/overlay{anchored = 1; density = 1; icon = 'icons/turf/adventure.dmi'; icon_state = "door_runes_closed"; name = "runes of containment"},/turf/unsimulated/floor/wizard,/area)
"ah" = (/turf/unsimulated/floor/wizard,/area)
"ai" = (/turf/unsimulated/wall/adaptive/wizard{icon_state = "wizard_wall_14"},/area)
"aj" = (/turf/unsimulated/wall/adaptive/wizard{icon_state = "wizard_wall_11"},/area)
"ak" = (/obj/bookcase/directional/full{dir = 10; icon_state = "bookcase_full_wall"; pixel_y = 28; tag = "icon-bookcase_full_wall (SOUTHWEST)"},/turf/unsimulated/floor/wizard,/area)
"al" = (/obj/bookcase/directional/full{pixel_y = 28},/turf/unsimulated/floor/wizard,/area)
"am" = (/obj/bookcase/directional/full{dir = 6; icon_state = "bookcase_full_wall"; pixel_y = 28; tag = "icon-bookcase_full_wall (SOUTHEAST)"},/turf/unsimulated/floor/wizard,/area)
"an" = (/turf/unsimulated/wall/adaptive/wizard{icon_state = "wizard_wall_5"},/area)
"ao" = (/turf/unsimulated/wall/adaptive/wizard{icon_state = "wizard_wall_9"},/area)
"ap" = (/turf/unsimulated/floor/wizard/carpet/edge{tag = "icon-carpet_edge (NORTHWEST)"; icon_state = "carpet_edge"; dir = 9},/area)
"aq" = (/turf/unsimulated/floor/wizard/carpet/edge{tag = "icon-carpet_edge (NORTH)"; icon_state = "carpet_edge"; dir = 1},/area)
"ar" = (/turf/unsimulated/floor/wizard/carpet/edge{tag = "icon-carpet_edge (NORTHEAST)"; icon_state = "carpet_edge"; dir = 5},/area)
"as" = (/turf/unsimulated/wall/adaptive/wizard_window,/area)
"at" = (/turf/unsimulated/wall/adaptive/wizard{base_name = "wizard_wall_"; icon_state = "wizard_wall_4"},/area)
"au" = (/turf/unsimulated/wall/adaptive/wizard{icon_state = "wizard_wall_8"},/area)
"av" = (/turf/unsimulated/wall/adaptive/wizard{icon_state = "wizard_wall_7"},/area)
"aw" = (/turf/unsimulated/floor/wizard/carpet/edge{tag = "icon-carpet_edge (WEST)"; icon_state = "carpet_edge"; dir = 8},/area)
"ax" = (/turf/unsimulated/floor/wizard/carpet,/area)
"ay" = (/turf/unsimulated/floor/wizard/carpet/edge{tag = "icon-carpet_edge (EAST)"; icon_state = "carpet_edge"; dir = 4},/area)
"az" = (/turf/unsimulated/wall/adaptive/wizard_fake{tag = "icon-wizard_false_wall (EAST)"; icon_state = "wizard_false_wall"; dir = 4},/area)
"aA" = (/obj/bookcase/full{icon_state = "bookcase_full_alone_0"; pixel_y = 28},/turf/unsimulated/floor/wizard,/area)
"aB" = (/turf/unsimulated/floor/wizard/carpet/narrow{tag = "icon-carpet_narrow (NORTHEAST)"; icon_state = "carpet_narrow"; dir = 5},/area)
"aC" = (/turf/unsimulated/wall/adaptive/wizard{icon_state = "wizard_wall_4"},/area)
"aD" = (/turf/unsimulated/wall/adaptive/wizard{icon_state = "wizard_wall_1"},/area)
"aE" = (/turf/unsimulated/floor/wizard/stairs{icon_state = "wizard_stairs_left"},/area)
"aF" = (/turf/unsimulated/floor/wizard/stairs{tag = "icon-wizard_stairs_middle"; icon_state = "wizard_stairs_middle"},/area)
"aG" = (/turf/unsimulated/floor/wizard/stairs{tag = "icon-wizard_stairs_right"; icon_state = "wizard_stairs_right"},/area)
"aH" = (/turf/unsimulated/floor/setpieces/bloodfloor/stomach,/area)
"aI" = (/turf/unsimulated/floor/wizard/carpet/narrow,/area)
"aJ" = (/turf/unsimulated/floor/arctic/snow/ice,/area)
"aK" = (/turf/unsimulated/floor/wizard/carpet/inner_corner_onetwo{tag = "icon-carpet_inner_corner_1_2 (NORTHEAST)"; icon_state = "carpet_inner_corner_1_2"; dir = 5},/area)
"aL" = (/obj/bookcase/button{pixel_y = 28},/turf/unsimulated/floor/wizard,/area)
"aM" = (/turf/unsimulated/wall/adaptive/wizard_window{tag = "icon-wizard_window (WEST)"; icon_state = "wizard_window"; dir = 8},/area)
"aN" = (/turf/unsimulated/wall/adaptive/wizard_window{tag = "icon-wizard_window (SOUTHEAST)"; icon_state = "wizard_window"; dir = 6},/area)
"aO" = (/turf/unsimulated/floor/lava,/area)
"aP" = (/turf/unsimulated/floor/void,/area)
"aQ" = (/turf/unsimulated/floor/wizard/stairs{tag = "icon-wizard_stairs_right (NORTH)"; icon_state = "wizard_stairs_right"; dir = 1},/area)
"aR" = (/turf/unsimulated/floor/wizard/stairs{tag = "icon-wizard_stairs_left (NORTH)"; icon_state = "wizard_stairs_left"; dir = 1},/area)
"aS" = (/turf/unsimulated/floor/wizard/carpet/narrow{tag = "icon-carpet_narrow (NORTHWEST)"; icon_state = "carpet_narrow"; dir = 9},/area)
"aT" = (/turf/unsimulated/floor/wizard/carpet/edge{tag = "icon-carpet_edge (SOUTHWEST)"; icon_state = "carpet_edge"; dir = 10},/area)
"aU" = (/turf/unsimulated/floor/wizard/carpet/edge,/area)
"aV" = (/turf/unsimulated/floor/wizard/carpet/edge{tag = "icon-carpet_edge (SOUTHEAST)"; icon_state = "carpet_edge"; dir = 6},/area)
"aW" = (/turf/unsimulated/wall/adaptive/wizard{icon_state = "wizard_wall_2"},/area)
"aX" = (/turf/unsimulated/floor/pool,/area)
"aY" = (/turf/unsimulated/wall/adaptive/wizard{icon_state = "wizard_wall_13"},/area)
"aZ" = (/turf/unsimulated/wall/adaptive/wizard_fake,/area)
"ba" = (/turf/unsimulated/floor/wizard/carpet/narrow{tag = "icon-carpet_narrow (NORTH)"; icon_state = "carpet_narrow"; dir = 1},/area)
"bb" = (/obj/overlay{anchored = 1; density = 1; icon = 'icons/turf/adventure.dmi'; icon_state = "column"; name = "column"},/turf/unsimulated/floor/wizard,/area)
"bc" = (/turf/unsimulated/floor/wizard/carpet/narrow{tag = "icon-carpet_narrow (SOUTHWEST)"; icon_state = "carpet_narrow"; dir = 10},/area)
"bd" = (/turf/unsimulated/floor/wizard/carpet/narrow/crossing{tag = "icon-carpet_narrow_crossing (NORTHEAST)"; icon_state = "carpet_narrow_crossing"; dir = 5},/area)
"be" = (/turf/unsimulated/floor/wizard/carpet/narrow{tag = "icon-carpet_narrow (SOUTHEAST)"; icon_state = "carpet_narrow"; dir = 6},/area)
"bf" = (/turf/unsimulated/floor/wizard/carpet/inner_corner_onetwo{tag = "icon-carpet_inner_corner_1_2 (NORTHWEST)"; icon_state = "carpet_inner_corner_1_2"; dir = 9},/area)
"bg" = (/turf/unsimulated/floor/wizard/showcase,/area)
"bh" = (/turf/unsimulated/floor/wizard/carpet/cross,/area)
"bi" = (/turf/unsimulated/floor/wizard/carpet/inner_corner_onetwo{tag = "icon-carpet_inner_corner_1_2 (SOUTHWEST)"; icon_state = "carpet_inner_corner_1_2"; dir = 10},/area)
"bj" = (/turf/unsimulated/floor/wizard/carpet/inner_corner_onetwo{tag = "icon-carpet_inner_corner_1_2 (SOUTHEAST)"; icon_state = "carpet_inner_corner_1_2"; dir = 6},/area)
"bk" = (/turf/unsimulated/wall/adaptive/wizard_window{tag = "icon-wizard_window (NORTHWEST)"; icon_state = "wizard_window"; dir = 9},/area)
"bl" = (/turf/unsimulated/floor/wizard/stairs{tag = "icon-wizard_stairs (EAST)"; icon_state = "wizard_stairs"; dir = 4},/area)
"bm" = (/turf/unsimulated/wall/adaptive/wizard_window{tag = "icon-wizard_window (SOUTHWEST)"; icon_state = "wizard_window"; dir = 10},/area)
"bn" = (/turf/unsimulated/floor/wizard/stairs{tag = "icon-wizard_stairs_left (WEST)"; icon_state = "wizard_stairs_left"; dir = 8},/area)
"bo" = (/turf/unsimulated/floor/wizard/stairs{tag = "icon-wizard_stairs_right (WEST)"; icon_state = "wizard_stairs_right"; dir = 8},/area)

(1,1,1) = {"
aaaaaaaaaaaaaaaaaaaaaaaaaaaaaaaaaaaaaaaaaaaaaaaaaaaaaaaaaaaaaaaaaaaaaaaaaaaaaaaaaaaaaaaaaa
aaabacacacacacacacacacadaaaaaaaaaaaaaaaaaaaaaaaaaaaaaaaaaaaaaaaaaaaaabacacacacacacacacadaa
aaaeafafagahahahahahahaeaaaaaaaaaaaaaaaaaaaaaaaaabacacacacacaiacacacajakalalalalalalamaeaa
aaaeafafagahahahahahahanacacacacacacacacacacacacaoapaqaqaqarasahahahaeahatauahahatauahaeaa
aaavacacauahahahahahahahahahahahahahahahahahahahahawaxaxaxayasahahahazahaAaAahahaAaAahaeaa
aaaeafafagahahahahahahahahahahahahahahahahahahahahawaxaxaxayasahahahaeahatauahahatauahaeaa
aaaeafafagahahahahahahabacacaiacauahaBahaCacaiacadawaxaxaxayaDaEaFaGaeahaAaAahahaAaAahaeaa
aaavacacauahahahatacacajahahaeaHagahaIahagaJaeaaaeawaxaxaxaKaqaqaqaraeahatauahahatauahaeaa
aaaeafafagahahahagafafasahahaeaHagahaIahagaJaeaaaeawaxaxaxaxaxaxaxayaeahaLaAahahaAaAahaeaa
aaaeafafagahahahagafafasahahavacauahaIahaCacajaaaeawaxaxaxaxaxaxaxayavacacadahahabacacaoaa
aaavacacauaEaFaGataMaMaNahahaeaOagahaIahagaPaeaaaeawaxaxaxaxaxaxaxayaeaaaaaeaQaRaeaaaaaaaa
aaaeahahahahahahahahahahahahaeaOagahaSahagaPaeaaaeaTaUaUaUaUaUaUaUaVaeaaaaaeaQaRaeaaaaaaaa
aaaeahahahahahahahahahahahahavacadaEaFaGaCacajaaanacacacacacacacacacaoaaaaaeaQaRaeaaaaaaaa
aaaeahahahahaWahahahahahahahaeaaaeahahahagaXaeaaaaaaaaaaaaaaaaaaaaaaaaaaaaaeaQaRaeaaaaaaaa
aaaeahahahahaeahahahahatacacaYacaoahahahagaXaeaaabacacacacacacacacacacacacaoahahanacacadaa
aaaeahahahahaeahahahahahahahahahahahahahabacaoaaaeahahahahahahahahahahahahahahahahahahaeaa
aaaeahahahahaeahahahahahahahahahahahahahaeaaaaaaaeahahahahahahahahahahahahahahahahahahaeaa
aaaeahahahahaeahahahahabacacacacacacaYacaYaiacacaYaZaZacacacaiacaiacacacacacacacauahaCajaa
aaaeahahahahaeahahahahaeahahahahahahahahahaeaBahahahahahahaBaeaaaeahahahahahahahahahahaeaa
aaaeahahatacaYacacacacaoahahaBahahahaBahahaebabbapaqaqarbbbaaeaaaeahbbapaqarbbahahahahaeaa
aaaeahahahahahahahahahahahbcbdbeahbcbdbeahaeaIahawaxaxayahbaaeaaaeahapbfaxaKarahabacacaoaa
aaaeahahahahahahahahahahahahaSahahahaSahahaeaIbgawaxaxaybgbaaeaaaeahawaxbhaxayahaeaaaaaaaa
abaYacacacacacacacacacadahahahahahahahahahaeaIahawaxaxayahbaaeaaaeahaTbiaxbjaVahaeaaaaaaaa
aeaPaPaPaPaPaPaPaPaPaPaeahahaBahahahaBahahaeaIbbawaxaxaybbbaaeaaaeahbbaTaUaVbbahaeaaaaaaaa
aeaPaPaPbkaMaMaMaMaMaMaoahbcbdbeahbcbdbeahaeaIahawaxaxayahbaaeaaaeahahahahahahahaeaaaaaaaa
aeaPaPaPasahahahahahahahahahaSahahahaSahahaeaIbgawaxaxaybgbaavacaYacacaiacacacacajaaaaaaaa
aeaPaPaPasahahahahahahahahahahahahahahahahaeaIahawaxaxayahbaaeafafafafaeahahahahaeaaaaaaaa
aeaPaPaPasahahbkaMaMaMadahahaBahahahaBahahaeaIbbawaxaxaybbbaaeafafafafaDahahahahaeaaaaaaaa
aeaPaPaPasahahasaPaPaPaeahbcbdbeahbcbdbeahaeaIahawaxaxayahbaaeafafafafblahahahahaeaaaaaaaa
aeaPaPaPasahahasaPaPaPaeahahaSahahahaSahahaeaIbgawaxaxaybgbaaeafafafafaWahahahahaeaaaaaaaa
aeaPaPaPasahahasaPaPaPaeahahahahahahahahahaeaIahawaxaxayahbaavacacacacaoahahahahaeaaaaaaaa
aeaPaPaPasahahasaPaPaPavacacacacacacacacacajaIbbaTaUaUaVbbbaaeahahahahahahahahahaeaaaaaaaa
aeaPaPaPasahahasaPaPaPaeaaaaaaaaaaaaaaaaaaaeaSahahahahahahaSaeahahahahahahahahahaeaaaaaaaa
avacacacaoahahanacacacaYacacacacacacacadaaanacacaiaZaZaiacacaoahahahahahahahahahaeaaaaaaaa
aeahahahahahahahahahahahahahahahahahahaeaaaaaaaaaeaQaRasahahahahahahahahahahahahaeaaaaaaaa
aeahahahahahahahahahahahahahahahahahahaeaaaaaaaaaeaQaRbmaMaMaMauahahahahahahahahaeaaaaaaaa
aeahahahahahahahahahahahahahahahahahahaeaaaaaaaaaeahahbnbnbnbnahahahahahahahahahaeaaaaaaaa
aeahahahahahahahahahahahahahahahahahahaeaaaaaaaaaeahahboboboboahahahahahahahahahaeaaaaaaaa
aeahahahahahahahahahahahahahahahahahahaeaaaaaaaaanacacacacacacacacacacacacacacacaoaaaaaaaa
aeahahahahahahahahahahahahahahahahahahaeaaaaaaaaaaaaaaaaaaaaaaaaaaaaaaaaaaaaaaaaaaaaaaaaaa
aeahahahahahahahahahahahahahahahahahahaeaaaaaaaaaaaaaaaaaaaaaaaaaaaaaaaaaaaaaaaaaaaaaaaaaa
aeahahahahahahahahahahahahahahahahahahaeaaaaaaaaaaaaaaaaaaaaaaaaaaaaaaaaaaaaaaaaaaaaaaaaaa
aeahahahahahahahahahahahahahahahahahahaeaaaaaaaaaaaaaaaaaaaaaaaaaaaaaaaaaaaaaaaaaaaaaaaaaa
aeahahahahahahahahahahahahahahahahahahaeaaaaaaaaaaaaaaaaaaaaaaaaaaaaaaaaaaaaaaaaaaaaaaaaaa
anacacacacacacacacacacacacacacacacacacaoaaaaaaaaaaaaaaaaaaaaaaaaaaaaaaaaaaaaaaaaaaaaaaaaaa
"}
