//MAP CONVERTED BY dmm2tgm.py THIS HEADER COMMENT PREVENTS RECONVERSION, DO NOT REMOVE
"cp" = (
/obj/wingrille_spawn/auto/crystal/reinforced,
/turf/simulated/floor/engine/caution/north,
/area/station/engine/inner)
"dV" = (
/obj/machinery/atmospherics/pipe/simple/insulated{
	can_rupture = 0;
	dir = 4
	},
/obj/cable{
	d1 = 1;
	d2 = 2;
	icon_state = "1-4"
	},
/turf/simulated/floor/plating/jen,
/area/station/engine/inner)
"ed" = (
/obj/machinery/power/data_terminal,
/obj/cable{
	d1 = 1;
	d2 = 2;
	icon_state = "2-4"
	},
/obj/cable{
	d1 = 1;
	d2 = 2;
	icon_state = "0-2"
	},
/turf/simulated/floor/engine,
/area/station/engine/inner)
"eR" = (
/obj/cable/brown{
	icon_state = "1-4"
	},
/obj/wingrille_spawn/auto/crystal/reinforced,
/turf/simulated/floor/engine/caution/south,
/area/station/engine/inner)
"fc" = (
/obj/storage/closet/radiation,
/turf/simulated/floor/plating/jen,
/area/station/engine/inner)
"fi" = (
/obj/machinery/atmospherics/pipe/manifold{
	dir = 8
	},
/obj/cable/brown{
	icon_state = "1-2"
	},
/obj/wingrille_spawn/auto/crystal/reinforced,
/turf/simulated/floor/engine/caution/east,
/area/station/engine/inner)
"gR" = (
/obj/machinery/atmospherics/pipe/simple/insulated{
	can_rupture = 0;
	dir = 10
	},
/obj/cable{
	d1 = 1;
	d2 = 2;
	icon_state = "4-8"
	},
/turf/simulated/floor/plating/jen,
/area/station/engine/inner)
"hc" = (
/obj/machinery/atmospherics/binary/valve{
	name = "outlet purge valve"
	},
/obj/cable/brown{
	icon_state = "1-2"
	},
/turf/simulated/floor/plating/jen,
/area/station/engine/inner)
"hS" = (
/obj/machinery/atmospherics/binary/valve{
	name = "outlet purge valve"
	},
/turf/simulated/floor/plating/jen,
/area/station/engine/inner)
"hV" = (
/obj/cable/brown{
	icon_state = "2-8"
	},
/obj/cable/brown{
	icon_state = "4-8"
	},
/obj/wingrille_spawn/auto/crystal/reinforced,
/turf/simulated/floor/engine/caution/north,
/area/station/engine/inner)
"ix" = (
/obj/cable/brown{
	icon_state = "1-2"
	},
/obj/wingrille_spawn/auto/crystal/reinforced,
/turf/simulated/floor/engine/caution/east,
/area/station/engine/inner)
"iL" = (
/obj/machinery/field_generator,
/obj/machinery/power/data_terminal,
/obj/cable{
	d1 = 1;
	d2 = 2;
	icon_state = "4-8"
	},
/obj/cable{
	d1 = 1;
	d2 = 2;
	icon_state = "2-4"
	},
/turf/simulated/floor/engine,
/area/station/engine/inner)
"jr" = (
/obj/machinery/atmospherics/pipe/simple/insulated/cold,
/obj/cable/brown{
	icon_state = "1-2"
	},
/obj/wingrille_spawn/auto/crystal/reinforced,
/turf/simulated/floor/engine/caution/east,
/area/station/engine/inner)
"ko" = (
/obj/machinery/atmospherics/pipe/simple/insulated,
/obj/wingrille_spawn/auto/crystal/reinforced,
/turf/simulated/floor/engine/caution/corner,
/area/station/engine/inner)
"lh" = (
/obj/cable{
	d1 = 1;
	d2 = 2;
	icon_state = "1-2"
	},
/turf/simulated/floor/plating/jen,
/area/station/engine/inner)
"ln" = (
/obj/machinery/atmospherics/binary/valve{
	dir = 4;
	name = "hot loop inlet valve"
	},
/turf/simulated/floor/plating/jen,
/area/station/engine/inner)
"lU" = (
/obj/cable/brown,
/obj/cable/brown{
	icon_state = "4-8"
	},
/obj/wingrille_spawn/auto/crystal/reinforced,
/turf/simulated/floor/engine/caution/south,
/area/station/engine/inner)
"mc" = (
/obj/cable/brown{
	icon_state = "2-8"
	},
/obj/wingrille_spawn/auto/crystal/reinforced,
/turf/simulated/floor/engine/caution/corner{
	dir = 4
	},
/area/station/engine/inner)
"nk" = (
/obj/machinery/light/small/floor,
/turf/simulated/floor/plating/jen,
/area/station/engine/inner)
"nx" = (
/obj/machinery/atmospherics/binary/passive_gate{
	dir = 8;
	on = 1;
	pixel_y = 1;
	target_pressure = 1e+031
	},
/turf/simulated/floor/plating/jen,
/area/station/engine/inner)
"ok" = (
/obj/cable/brown{
	icon_state = "4-8"
	},
/obj/wingrille_spawn/auto/crystal/reinforced,
/turf/simulated/floor/engine/caution/south,
/area/station/engine/inner)
"oy" = (
/obj/cable/brown{
	icon_state = "1-4"
	},
/obj/cable/brown{
	icon_state = "4-8"
	},
/obj/wingrille_spawn/auto/crystal/reinforced,
/turf/simulated/floor/engine/caution/south,
/area/station/engine/inner)
"oE" = (
/obj/machinery/atmospherics/pipe/simple/insulated{
	can_rupture = 0;
	dir = 4
	},
/obj/cable{
	d1 = 1;
	d2 = 2;
	icon_state = "4-8"
	},
/turf/simulated/floor/plating/jen,
/area/station/engine/inner)
"oJ" = (
/obj/cable{
	icon_state = "4-8"
	},
/obj/machinery/door/airlock/pyro/engineering{
	dir = 4;
	name = "Singularity Room";
	req_access = null
	},
/obj/access_spawn/engineering_engine,
/obj/firedoor_spawn,
/obj/decal/stripe_delivery,
/turf/simulated/floor/plating/jen,
/area/station/engine/inner)
"pl" = (
/obj/machinery/atmospherics/pipe/simple/insulated/cold{
	can_rupture = 0;
	dir = 6
	},
/obj/cable/brown{
	icon_state = "1-2"
	},
/turf/simulated/floor/plating/jen,
/area/station/engine/inner)
"pp" = (
/obj/machinery/emitter,
/obj/machinery/light/small/floor/warm,
/turf/simulated/floor/engine,
/area/station/engine/inner)
"pO" = (
/obj/machinery/atmospherics/binary/valve{
	dir = 4;
	name = "cold loop inlet valve"
	},
/turf/simulated/floor/plating/jen,
/area/station/engine/inner)
"qy" = (
/obj/machinery/power/data_terminal,
/obj/cable{
	d1 = 1;
	d2 = 2;
	icon_state = "0-8"
	},
/turf/simulated/floor/engine,
/area/station/engine/inner)
"qO" = (
/obj/machinery/atmospherics/pipe/simple/insulated/cold{
	can_rupture = 0
	},
/obj/cable/brown{
	icon_state = "1-8"
	},
/obj/wingrille_spawn/auto/crystal/reinforced,
/turf/simulated/floor/engine/caution/corner{
	dir = 1
	},
/area/station/engine/inner)
"rz" = (
/obj/machinery/power/data_terminal,
/obj/cable{
	d1 = 1;
	d2 = 2;
	icon_state = "0-4"
	},
/turf/simulated/floor/engine,
/area/station/engine/inner)
"sP" = (
/obj/cable/brown{
	icon_state = "4-8"
	},
/obj/wingrille_spawn/auto/crystal/reinforced,
/turf/simulated/floor/engine/caution/north,
/area/station/engine/inner)
"tn" = (
/obj/cable{
	d1 = 1;
	d2 = 2;
	icon_state = "2-8"
	},
/obj/machinery/dispenser,
/turf/simulated/floor/plating/jen,
/area/station/engine/inner)
"tB" = (
/obj/wingrille_spawn/auto/crystal/reinforced,
/turf/simulated/floor/engine/caution/west,
/area/station/engine/inner)
"up" = (
/obj/cable/brown{
	icon_state = "1-2"
	},
/obj/cable/brown{
	icon_state = "1-8"
	},
/obj/cable/brown{
	icon_state = "1-4"
	},
/obj/wingrille_spawn/auto/crystal/reinforced,
/turf/simulated/floor/engine/caution/north,
/area/station/engine/inner)
"xq" = (
/obj/machinery/atmospherics/pipe/simple/insulated{
	can_rupture = 0;
	dir = 10
	},
/obj/wingrille_spawn/auto/crystal/reinforced,
/turf/simulated/floor/engine/caution/west,
/area/station/engine/inner)
"xV" = (
/obj/machinery/light/emergency{
	dir = 8
	},
/turf/simulated/floor/plating/jen,
/area/station/engine/inner)
"AI" = (
/obj/machinery/field_generator,
/obj/machinery/power/data_terminal,
/obj/cable{
	d1 = 1;
	d2 = 2;
	icon_state = "4-8"
	},
/turf/simulated/floor/engine,
/area/station/engine/inner)
"AQ" = (
/obj/machinery/atmospherics/pipe/manifold{
	dir = 4
	},
/obj/wingrille_spawn/auto/crystal/reinforced,
/turf/simulated/floor/engine/caution/west,
/area/station/engine/inner)
"Bk" = (
/obj/machinery/light/small/floor,
/obj/storage/closet/radiation,
/turf/simulated/floor/plating/jen,
/area/station/engine/inner)
"CR" = (
/obj/machinery/emitter{
	dir = 8
	},
/obj/machinery/light/small/floor/warm,
/obj/cable{
	d1 = 1;
	d2 = 2;
	icon_state = "1-2"
	},
/turf/simulated/floor/engine,
/area/station/engine/inner)
"CY" = (
/obj/machinery/power/collector_array,
/obj/machinery/power/data_terminal,
/obj/cable/brown,
/turf/simulated/floor/engine,
/area/station/engine/inner)
"De" = (
/obj/cable{
	icon_state = "4-8"
	},
/obj/access_spawn/engineering_engine,
/obj/firedoor_spawn,
/obj/decal/stripe_delivery,
/obj/machinery/door/airlock/pyro/engineering{
	dir = 4;
	name = "Singularity Room";
	req_access = null
	},
/turf/simulated/floor/plating/jen,
/area/station/engine/inner)
"Gn" = (
/obj/machinery/field_generator,
/obj/machinery/power/data_terminal,
/obj/cable{
	d1 = 1;
	d2 = 2;
	icon_state = "4-8"
	},
/obj/cable{
	d1 = 1;
	d2 = 2;
	icon_state = "1-8"
	},
/turf/simulated/floor/engine,
/area/station/engine/inner)
"Gu" = (
/obj/cable{
	d1 = 1;
	d2 = 2;
	icon_state = "1-2"
	},
/turf/simulated/floor/engine,
/area/station/engine/inner)
"GB" = (
/obj/machinery/emitter{
	dir = 4
	},
/obj/machinery/light/small/floor/warm,
/turf/simulated/floor/engine,
/area/station/engine/inner)
"GR" = (
/obj/wingrille_spawn/auto/crystal/reinforced,
/obj/cable{
	d1 = 1;
	d2 = 2;
	icon_state = "1-2"
	},
/turf/simulated/floor/engine/caution/south,
/area/station/engine/inner)
"Ig" = (
/turf/simulated/floor/plating/jen,
/area/station/engine/inner)
"JY" = (
/obj/machinery/power/collector_control,
/obj/machinery/power/data_terminal,
/obj/cable/brown{
	icon_state = "0-2"
	},
/obj/machinery/light,
/turf/simulated/floor/engine,
/area/station/engine/inner)
"Lj" = (
/obj/cable/brown{
	icon_state = "2-4"
	},
/obj/cable/brown{
	icon_state = "4-8"
	},
/obj/wingrille_spawn/auto/crystal/reinforced,
/turf/simulated/floor/engine/caution/north,
/area/station/engine/inner)
"Ma" = (
/obj/machinery/atmospherics/pipe/simple/insulated{
	can_rupture = 0;
	dir = 5
	},
/turf/simulated/floor/plating/jen,
/area/station/engine/inner)
"Mf" = (
/obj/machinery/atmospherics/pipe/simple/insulated,
/obj/wingrille_spawn/auto/crystal/reinforced,
/turf/simulated/floor/engine/caution/west,
/area/station/engine/inner)
"Mp" = (
/turf/simulated/floor/engine,
/area/station/engine/inner)
"On" = (
/obj/machinery/light/emergency{
	dir = 4
	},
/turf/simulated/floor/plating/jen,
/area/station/engine/inner)
"OJ" = (
/obj/cable/brown{
	icon_state = "2-4"
	},
/obj/wingrille_spawn/auto/crystal/reinforced,
/turf/simulated/floor/engine/caution/north,
/area/station/engine/inner)
"PX" = (
/obj/machinery/atmospherics/binary/passive_gate{
	dir = 4;
	on = 1;
	pixel_y = 1;
	target_pressure = 1e+031
	},
/turf/simulated/floor/plating/jen,
/area/station/engine/inner)
"Rp" = (
/obj/machinery/power/collector_array,
/obj/machinery/power/data_terminal,
/obj/cable/brown{
	icon_state = "0-2"
	},
/turf/simulated/floor/engine,
/area/station/engine/inner)
"SK" = (
/obj/machinery/the_singularitygen,
/obj/machinery/power/data_terminal,
/turf/simulated/floor/engine,
/area/station/engine/inner)
"Tn" = (
/obj/machinery/atmospherics/pipe/simple/insulated/cold{
	can_rupture = 0;
	dir = 9
	},
/turf/simulated/floor/plating/jen,
/area/station/engine/inner)
"TM" = (
/obj/cable/brown{
	icon_state = "1-8"
	},
/obj/cable/brown{
	icon_state = "4-8"
	},
/obj/cable/brown{
	icon_state = "2-4"
	},
/obj/wingrille_spawn/auto/crystal/reinforced,
/turf/simulated/floor/engine/caution/south,
/area/station/engine/inner)
"Vp" = (
/obj/machinery/atmospherics/pipe/simple/insulated/cold{
	dir = 4
	},
/turf/simulated/floor/plating/jen,
/area/station/engine/inner)
"WQ" = (
/obj/wingrille_spawn/auto/crystal/reinforced,
/turf/simulated/floor/engine/caution/corner{
	dir = 8
	},
/area/station/engine/inner)
"Xg" = (
/obj/machinery/atmospherics/pipe/simple/insulated/cold{
	can_rupture = 0;
	dir = 6
	},
/obj/cable/brown{
	icon_state = "1-2"
	},
/obj/wingrille_spawn/auto/crystal/reinforced,
/turf/simulated/floor/engine/caution/east,
/area/station/engine/inner)
"YC" = (
/obj/machinery/power/collector_control,
/obj/machinery/power/data_terminal,
/obj/cable/brown,
/obj/machinery/light{
	dir = 1
	},
/turf/simulated/floor/engine,
/area/station/engine/inner)
"YG" = (
/obj/cable{
	d1 = 1;
	d2 = 2;
	icon_state = "4-8"
	},
/turf/simulated/floor/engine,
/area/station/engine/inner)
"ZF" = (
/obj/cable/brown{
	icon_state = "1-8"
	},
/obj/cable/brown{
	icon_state = "4-8"
	},
/obj/wingrille_spawn/auto/crystal/reinforced,
/turf/simulated/floor/engine/caution/south,
/area/station/engine/inner)

(1,1,1) = {"
nk
Ig
ln
On
Ig
On
Ig
nx
Ig
Ig
Bk
"}
(2,1,1) = {"
WQ
tB
xq
Mf
oJ
Mf
Mf
AQ
ko
Ma
fc
"}
(3,1,1) = {"
cp
pp
rz
Mp
Mp
Mp
ed
CR
GR
dV
Ig
"}
(4,1,1) = {"
OJ
CY
AI
Mp
Mp
Mp
AI
Rp
eR
oE
Ig
"}
(5,1,1) = {"
Lj
CY
YG
Mp
Mp
Mp
YG
Rp
oy
gR
hS
"}
(6,1,1) = {"
up
YC
YG
Mp
SK
Mp
YG
JY
lU
tn
lh
"}
(7,1,1) = {"
hV
CY
YG
Mp
Mp
Mp
YG
Rp
TM
pl
hc
"}
(8,1,1) = {"
hV
CY
iL
Gu
Gu
Gu
Gn
Rp
ZF
Vp
Ig
"}
(9,1,1) = {"
sP
pp
qy
Mp
Mp
Mp
qy
GB
ok
Vp
Ig
"}
(10,1,1) = {"
mc
ix
Xg
jr
De
jr
jr
fi
qO
Tn
fc
"}
(11,1,1) = {"
nk
Ig
pO
xV
Ig
xV
Ig
PX
Ig
Ig
Bk
"}
