//MAP CONVERTED BY dmm2tgm.py THIS HEADER COMMENT PREVENTS RECONVERSION, DO NOT REMOVE
"Gq" = (
/turf/unsimulated/wall/auto/lead/blue,
/area/centcom)
"HA" = (
/turf/unsimulated/wall{
	dir = 4;
	icon = 'icons/misc/worlds.dmi';
	icon_state = "leadwindow_1";
	name = "window";
	opacity = 0
	},
/area/centcom)
"HC" = (
/obj/machinery/door/airlock/pyro/external{
	dir = 4
	},
/obj/decal/tile_edge/stripe/extra_big{
	icon_state = "delivery2"
	},
/turf/unsimulated/floor{
	icon_state = "floor"
	},
/area/centcom)
"Pb" = (
/turf/unsimulated/floor/shuttlebay,
/area/centcom/outside)
"Rs" = (
/turf/unsimulated/wall{
	icon = 'icons/misc/worlds.dmi';
	icon_state = "leadwindow_1";
	name = "window";
	opacity = 0
	},
/area/centcom)
"Vg" = (
/obj/machinery/light/small/floor,
/turf/unsimulated/floor/shuttlebay,
/area/centcom/outside)

(1,1,1) = {"
Gq
Gq
Gq
Gq
Rs
Gq
Gq
Rs
Gq
Gq
HC
Gq
Gq
HC
Gq
Gq
Rs
Gq
Gq
Rs
Gq
Gq
Rs
Gq
Gq
Gq
"}
(2,1,1) = {"
Gq
Pb
Pb
Pb
Pb
Pb
Pb
Pb
Pb
Pb
Pb
Pb
Pb
Pb
Pb
Pb
Pb
Pb
Pb
Pb
Pb
Pb
Pb
Pb
Pb
Gq
"}
(3,1,1) = {"
Gq
Pb
Pb
Pb
Pb
Pb
Pb
Pb
Pb
Pb
Pb
Pb
Pb
Pb
Pb
Pb
Pb
Pb
Pb
Pb
Pb
Pb
Pb
Pb
Pb
Gq
"}
(4,1,1) = {"
HA
Pb
Pb
Pb
Vg
Pb
Pb
Vg
Pb
Pb
Vg
Pb
Pb
Vg
Pb
Pb
Vg
Pb
Pb
Vg
Pb
Pb
Vg
Pb
Pb
HA
"}
(5,1,1) = {"
Gq
Pb
Pb
Pb
Pb
Pb
Pb
Pb
Pb
Pb
Pb
Pb
Pb
Pb
Pb
Pb
Pb
Pb
Pb
Pb
Pb
Pb
Pb
Pb
Pb
Gq
"}
(6,1,1) = {"
Gq
Pb
Pb
Pb
Pb
Pb
Pb
Pb
Pb
Pb
Pb
Pb
Pb
Pb
Pb
Pb
Pb
Pb
Pb
Pb
Pb
Pb
Pb
Pb
Pb
Gq
"}
(7,1,1) = {"
Gq
Pb
Pb
Pb
Pb
Pb
Pb
Pb
Pb
Pb
Pb
Pb
Pb
Pb
Pb
Pb
Pb
Pb
Pb
Pb
Pb
Pb
Pb
Pb
Pb
Gq
"}
(8,1,1) = {"
HA
Pb
Pb
Pb
Vg
Pb
Pb
Vg
Pb
Pb
Vg
Pb
Pb
Vg
Pb
Pb
Vg
Pb
Pb
Vg
Pb
Pb
Vg
Pb
Pb
HA
"}
(9,1,1) = {"
Gq
Pb
Pb
Pb
Pb
Pb
Pb
Pb
Pb
Pb
Pb
Pb
Pb
Pb
Pb
Pb
Pb
Pb
Pb
Pb
Pb
Pb
Pb
Pb
Pb
Gq
"}
(10,1,1) = {"
Gq
Pb
Pb
Pb
Pb
Pb
Pb
Pb
Pb
Pb
Pb
Pb
Pb
Pb
Pb
Pb
Pb
Pb
Pb
Pb
Pb
Pb
Pb
Pb
Pb
Gq
"}
(11,1,1) = {"
HA
Pb
Pb
Pb
Vg
Pb
Pb
Vg
Pb
Pb
Vg
Pb
Pb
Vg
Pb
Pb
Vg
Pb
Pb
Vg
Pb
Pb
Vg
Pb
Pb
HA
"}
(12,1,1) = {"
Gq
Pb
Pb
Pb
Pb
Pb
Pb
Pb
Pb
Pb
Pb
Pb
Pb
Pb
Pb
Pb
Pb
Pb
Pb
Pb
Pb
Pb
Pb
Pb
Pb
Gq
"}
(13,1,1) = {"
Gq
Pb
Pb
Pb
Pb
Pb
Pb
Pb
Pb
Pb
Pb
Pb
Pb
Pb
Pb
Pb
Pb
Pb
Pb
Pb
Pb
Pb
Pb
Pb
Pb
Gq
"}
(14,1,1) = {"
HA
Pb
Pb
Pb
Vg
Pb
Pb
Vg
Pb
Pb
Vg
Pb
Pb
Vg
Pb
Pb
Vg
Pb
Pb
Vg
Pb
Pb
Vg
Pb
Pb
HA
"}
(15,1,1) = {"
Gq
Pb
Pb
Pb
Pb
Pb
Pb
Pb
Pb
Pb
Pb
Pb
Pb
Pb
Pb
Pb
Pb
Pb
Pb
Pb
Pb
Pb
Pb
Pb
Pb
Gq
"}
(16,1,1) = {"
Gq
Pb
Pb
Pb
Pb
Pb
Pb
Pb
Pb
Pb
Pb
Pb
Pb
Pb
Pb
Pb
Pb
Pb
Pb
Pb
Pb
Pb
Pb
Pb
Pb
Gq
"}
(17,1,1) = {"
HA
Pb
Pb
Pb
Vg
Pb
Pb
Vg
Pb
Pb
Vg
Pb
Pb
Vg
Pb
Pb
Vg
Pb
Pb
Vg
Pb
Pb
Vg
Pb
Pb
HA
"}
(18,1,1) = {"
Gq
Pb
Pb
Pb
Pb
Pb
Pb
Pb
Pb
Pb
Pb
Pb
Pb
Pb
Pb
Pb
Pb
Pb
Pb
Pb
Pb
Pb
Pb
Pb
Pb
Gq
"}
(19,1,1) = {"
Gq
Pb
Pb
Pb
Pb
Pb
Pb
Pb
Pb
Pb
Pb
Pb
Pb
Pb
Pb
Pb
Pb
Pb
Pb
Pb
Pb
Pb
Pb
Pb
Pb
Gq
"}
(20,1,1) = {"
HA
Pb
Pb
Pb
Vg
Pb
Pb
Vg
Pb
Pb
Vg
Pb
Pb
Vg
Pb
Pb
Vg
Pb
Pb
Vg
Pb
Pb
Vg
Pb
Pb
HA
"}
(21,1,1) = {"
Gq
Pb
Pb
Pb
Pb
Pb
Pb
Pb
Pb
Pb
Pb
Pb
Pb
Pb
Pb
Pb
Pb
Pb
Pb
Pb
Pb
Pb
Pb
Pb
Pb
Gq
"}
(22,1,1) = {"
Gq
Pb
Pb
Pb
Pb
Pb
Pb
Pb
Pb
Pb
Pb
Pb
Pb
Pb
Pb
Pb
Pb
Pb
Pb
Pb
Pb
Pb
Pb
Pb
Pb
Gq
"}
(23,1,1) = {"
HA
Pb
Pb
Pb
Vg
Pb
Pb
Vg
Pb
Pb
Vg
Pb
Pb
Vg
Pb
Pb
Vg
Pb
Pb
Vg
Pb
Pb
Vg
Pb
Pb
HA
"}
(24,1,1) = {"
Gq
Pb
Pb
Pb
Pb
Pb
Pb
Pb
Pb
Pb
Pb
Pb
Pb
Pb
Pb
Pb
Pb
Pb
Pb
Pb
Pb
Pb
Pb
Pb
Pb
Gq
"}
(25,1,1) = {"
Gq
Pb
Pb
Pb
Pb
Pb
Pb
Pb
Pb
Pb
Pb
Pb
Pb
Pb
Pb
Pb
Pb
Pb
Pb
Pb
Pb
Pb
Pb
Pb
Pb
Gq
"}
(26,1,1) = {"
Gq
Gq
Gq
Gq
Rs
Gq
Gq
Rs
Gq
Gq
HC
Gq
Gq
HC
Gq
Gq
Rs
Gq
Gq
Rs
Gq
Gq
Rs
Gq
Gq
Gq
"}
