//MAP CONVERTED BY dmm2tgm.py THIS HEADER COMMENT PREVENTS RECONVERSION, DO NOT REMOVE
"a" = (
/turf/unsimulated/wall/auto/lead/blue,
/area/centcom)
"b" = (
/turf/unsimulated/wall{
	icon = 'icons/misc/worlds.dmi';
	icon_state = "leadwindow_1";
	name = "window";
	opacity = 0
	},
/area/centcom)
"c" = (
/obj/decal/tile_edge/stripe/extra_big{
	bound_height = 64;
	bound_width = 64;
	bound_x = 0;
	bound_y = 0;
	icon_state = "delivery2";
	merge_with_turf = 0;
	pixel_x = 0;
	pixel_y = 0;
	transform = list(2,0,16,0,2,16)
	},
/obj/machinery/door/airlock/pyro/external{
	bound_height = 64;
	bound_width = 64;
	bound_x = 0;
	bound_y = 0;
	dir = 4;
	pixel_x = 0;
	pixel_y = 0;
	transform = list(2,0,16,0,2,16)
	},
/turf/unsimulated/floor{
	icon_state = "floor"
	},
/area/centcom)
"d" = (
/turf/unsimulated/floor{
	icon_state = "floor"
	},
/area/centcom)
"e" = (
/turf/unsimulated/floor/shuttlebay,
/area/centcom/outside)
"f" = (
/turf/unsimulated/wall{
	dir = 4;
	icon = 'icons/misc/worlds.dmi';
	icon_state = "leadwindow_1";
	name = "window";
	opacity = 0
	},
/area/centcom)
"g" = (
/obj/machinery/light/small/floor,
/turf/unsimulated/floor/shuttlebay,
/area/centcom/outside)

(1,1,1) = {"
a
a
a
a
a
a
a
a
b
b
a
a
a
a
b
b
a
a
a
a
d
c
a
a
a
a
d
c
a
a
a
a
b
b
a
a
a
a
b
b
a
a
a
a
b
b
a
a
a
a
a
a
"}
(2,1,1) = {"
a
a
a
a
a
a
a
a
b
b
a
a
a
a
b
b
a
a
a
a
d
d
a
a
a
a
d
d
a
a
a
a
b
b
a
a
a
a
b
b
a
a
a
a
b
b
a
a
a
a
a
a
"}
(3,1,1) = {"
a
a
e
e
e
e
e
e
e
e
e
e
e
e
e
e
e
e
e
e
e
e
e
e
e
e
e
e
e
e
e
e
e
e
e
e
e
e
e
e
e
e
e
e
e
e
e
e
e
e
a
a
"}
(4,1,1) = {"
a
a
e
e
e
e
e
e
e
e
e
e
e
e
e
e
e
e
e
e
e
e
e
e
e
e
e
e
e
e
e
e
e
e
e
e
e
e
e
e
e
e
e
e
e
e
e
e
e
e
a
a
"}
(5,1,1) = {"
a
a
e
e
e
e
e
e
e
e
e
e
e
e
e
e
e
e
e
e
e
e
e
e
e
e
e
e
e
e
e
e
e
e
e
e
e
e
e
e
e
e
e
e
e
e
e
e
e
e
a
a
"}
(6,1,1) = {"
a
a
e
e
e
e
e
e
e
e
e
e
e
e
e
e
e
e
e
e
e
e
e
e
e
e
e
e
e
e
e
e
e
e
e
e
e
e
e
e
e
e
e
e
e
e
e
e
e
e
a
a
"}
(7,1,1) = {"
f
f
e
e
e
e
e
e
g
g
e
e
e
e
g
g
e
e
e
e
g
g
e
e
e
e
g
g
e
e
e
e
g
g
e
e
e
e
g
g
e
e
e
e
g
g
e
e
e
e
f
f
"}
(8,1,1) = {"
f
f
e
e
e
e
e
e
g
g
e
e
e
e
g
g
e
e
e
e
g
g
e
e
e
e
g
g
e
e
e
e
g
g
e
e
e
e
g
g
e
e
e
e
g
g
e
e
e
e
f
f
"}
(9,1,1) = {"
a
a
e
e
e
e
e
e
e
e
e
e
e
e
e
e
e
e
e
e
e
e
e
e
e
e
e
e
e
e
e
e
e
e
e
e
e
e
e
e
e
e
e
e
e
e
e
e
e
e
a
a
"}
(10,1,1) = {"
a
a
e
e
e
e
e
e
e
e
e
e
e
e
e
e
e
e
e
e
e
e
e
e
e
e
e
e
e
e
e
e
e
e
e
e
e
e
e
e
e
e
e
e
e
e
e
e
e
e
a
a
"}
(11,1,1) = {"
a
a
e
e
e
e
e
e
e
e
e
e
e
e
e
e
e
e
e
e
e
e
e
e
e
e
e
e
e
e
e
e
e
e
e
e
e
e
e
e
e
e
e
e
e
e
e
e
e
e
a
a
"}
(12,1,1) = {"
a
a
e
e
e
e
e
e
e
e
e
e
e
e
e
e
e
e
e
e
e
e
e
e
e
e
e
e
e
e
e
e
e
e
e
e
e
e
e
e
e
e
e
e
e
e
e
e
e
e
a
a
"}
(13,1,1) = {"
a
a
e
e
e
e
e
e
e
e
e
e
e
e
e
e
e
e
e
e
e
e
e
e
e
e
e
e
e
e
e
e
e
e
e
e
e
e
e
e
e
e
e
e
e
e
e
e
e
e
a
a
"}
(14,1,1) = {"
a
a
e
e
e
e
e
e
e
e
e
e
e
e
e
e
e
e
e
e
e
e
e
e
e
e
e
e
e
e
e
e
e
e
e
e
e
e
e
e
e
e
e
e
e
e
e
e
e
e
a
a
"}
(15,1,1) = {"
f
f
e
e
e
e
e
e
g
g
e
e
e
e
g
g
e
e
e
e
g
g
e
e
e
e
g
g
e
e
e
e
g
g
e
e
e
e
g
g
e
e
e
e
g
g
e
e
e
e
f
f
"}
(16,1,1) = {"
f
f
e
e
e
e
e
e
g
g
e
e
e
e
g
g
e
e
e
e
g
g
e
e
e
e
g
g
e
e
e
e
g
g
e
e
e
e
g
g
e
e
e
e
g
g
e
e
e
e
f
f
"}
(17,1,1) = {"
a
a
e
e
e
e
e
e
e
e
e
e
e
e
e
e
e
e
e
e
e
e
e
e
e
e
e
e
e
e
e
e
e
e
e
e
e
e
e
e
e
e
e
e
e
e
e
e
e
e
a
a
"}
(18,1,1) = {"
a
a
e
e
e
e
e
e
e
e
e
e
e
e
e
e
e
e
e
e
e
e
e
e
e
e
e
e
e
e
e
e
e
e
e
e
e
e
e
e
e
e
e
e
e
e
e
e
e
e
a
a
"}
(19,1,1) = {"
a
a
e
e
e
e
e
e
e
e
e
e
e
e
e
e
e
e
e
e
e
e
e
e
e
e
e
e
e
e
e
e
e
e
e
e
e
e
e
e
e
e
e
e
e
e
e
e
e
e
a
a
"}
(20,1,1) = {"
a
a
e
e
e
e
e
e
e
e
e
e
e
e
e
e
e
e
e
e
e
e
e
e
e
e
e
e
e
e
e
e
e
e
e
e
e
e
e
e
e
e
e
e
e
e
e
e
e
e
a
a
"}
(21,1,1) = {"
f
f
e
e
e
e
e
e
g
g
e
e
e
e
g
g
e
e
e
e
g
g
e
e
e
e
g
g
e
e
e
e
g
g
e
e
e
e
g
g
e
e
e
e
g
g
e
e
e
e
f
f
"}
(22,1,1) = {"
f
f
e
e
e
e
e
e
g
g
e
e
e
e
g
g
e
e
e
e
g
g
e
e
e
e
g
g
e
e
e
e
g
g
e
e
e
e
g
g
e
e
e
e
g
g
e
e
e
e
f
f
"}
(23,1,1) = {"
a
a
e
e
e
e
e
e
e
e
e
e
e
e
e
e
e
e
e
e
e
e
e
e
e
e
e
e
e
e
e
e
e
e
e
e
e
e
e
e
e
e
e
e
e
e
e
e
e
e
a
a
"}
(24,1,1) = {"
a
a
e
e
e
e
e
e
e
e
e
e
e
e
e
e
e
e
e
e
e
e
e
e
e
e
e
e
e
e
e
e
e
e
e
e
e
e
e
e
e
e
e
e
e
e
e
e
e
e
a
a
"}
(25,1,1) = {"
a
a
e
e
e
e
e
e
e
e
e
e
e
e
e
e
e
e
e
e
e
e
e
e
e
e
e
e
e
e
e
e
e
e
e
e
e
e
e
e
e
e
e
e
e
e
e
e
e
e
a
a
"}
(26,1,1) = {"
a
a
e
e
e
e
e
e
e
e
e
e
e
e
e
e
e
e
e
e
e
e
e
e
e
e
e
e
e
e
e
e
e
e
e
e
e
e
e
e
e
e
e
e
e
e
e
e
e
e
a
a
"}
(27,1,1) = {"
f
f
e
e
e
e
e
e
g
g
e
e
e
e
g
g
e
e
e
e
g
g
e
e
e
e
g
g
e
e
e
e
g
g
e
e
e
e
g
g
e
e
e
e
g
g
e
e
e
e
f
f
"}
(28,1,1) = {"
f
f
e
e
e
e
e
e
g
g
e
e
e
e
g
g
e
e
e
e
g
g
e
e
e
e
g
g
e
e
e
e
g
g
e
e
e
e
g
g
e
e
e
e
g
g
e
e
e
e
f
f
"}
(29,1,1) = {"
a
a
e
e
e
e
e
e
e
e
e
e
e
e
e
e
e
e
e
e
e
e
e
e
e
e
e
e
e
e
e
e
e
e
e
e
e
e
e
e
e
e
e
e
e
e
e
e
e
e
a
a
"}
(30,1,1) = {"
a
a
e
e
e
e
e
e
e
e
e
e
e
e
e
e
e
e
e
e
e
e
e
e
e
e
e
e
e
e
e
e
e
e
e
e
e
e
e
e
e
e
e
e
e
e
e
e
e
e
a
a
"}
(31,1,1) = {"
a
a
e
e
e
e
e
e
e
e
e
e
e
e
e
e
e
e
e
e
e
e
e
e
e
e
e
e
e
e
e
e
e
e
e
e
e
e
e
e
e
e
e
e
e
e
e
e
e
e
a
a
"}
(32,1,1) = {"
a
a
e
e
e
e
e
e
e
e
e
e
e
e
e
e
e
e
e
e
e
e
e
e
e
e
e
e
e
e
e
e
e
e
e
e
e
e
e
e
e
e
e
e
e
e
e
e
e
e
a
a
"}
(33,1,1) = {"
f
f
e
e
e
e
e
e
g
g
e
e
e
e
g
g
e
e
e
e
g
g
e
e
e
e
g
g
e
e
e
e
g
g
e
e
e
e
g
g
e
e
e
e
g
g
e
e
e
e
f
f
"}
(34,1,1) = {"
f
f
e
e
e
e
e
e
g
g
e
e
e
e
g
g
e
e
e
e
g
g
e
e
e
e
g
g
e
e
e
e
g
g
e
e
e
e
g
g
e
e
e
e
g
g
e
e
e
e
f
f
"}
(35,1,1) = {"
a
a
e
e
e
e
e
e
e
e
e
e
e
e
e
e
e
e
e
e
e
e
e
e
e
e
e
e
e
e
e
e
e
e
e
e
e
e
e
e
e
e
e
e
e
e
e
e
e
e
a
a
"}
(36,1,1) = {"
a
a
e
e
e
e
e
e
e
e
e
e
e
e
e
e
e
e
e
e
e
e
e
e
e
e
e
e
e
e
e
e
e
e
e
e
e
e
e
e
e
e
e
e
e
e
e
e
e
e
a
a
"}
(37,1,1) = {"
a
a
e
e
e
e
e
e
e
e
e
e
e
e
e
e
e
e
e
e
e
e
e
e
e
e
e
e
e
e
e
e
e
e
e
e
e
e
e
e
e
e
e
e
e
e
e
e
e
e
a
a
"}
(38,1,1) = {"
a
a
e
e
e
e
e
e
e
e
e
e
e
e
e
e
e
e
e
e
e
e
e
e
e
e
e
e
e
e
e
e
e
e
e
e
e
e
e
e
e
e
e
e
e
e
e
e
e
e
a
a
"}
(39,1,1) = {"
f
f
e
e
e
e
e
e
g
g
e
e
e
e
g
g
e
e
e
e
g
g
e
e
e
e
g
g
e
e
e
e
g
g
e
e
e
e
g
g
e
e
e
e
g
g
e
e
e
e
f
f
"}
(40,1,1) = {"
f
f
e
e
e
e
e
e
g
g
e
e
e
e
g
g
e
e
e
e
g
g
e
e
e
e
g
g
e
e
e
e
g
g
e
e
e
e
g
g
e
e
e
e
g
g
e
e
e
e
f
f
"}
(41,1,1) = {"
a
a
e
e
e
e
e
e
e
e
e
e
e
e
e
e
e
e
e
e
e
e
e
e
e
e
e
e
e
e
e
e
e
e
e
e
e
e
e
e
e
e
e
e
e
e
e
e
e
e
a
a
"}
(42,1,1) = {"
a
a
e
e
e
e
e
e
e
e
e
e
e
e
e
e
e
e
e
e
e
e
e
e
e
e
e
e
e
e
e
e
e
e
e
e
e
e
e
e
e
e
e
e
e
e
e
e
e
e
a
a
"}
(43,1,1) = {"
a
a
e
e
e
e
e
e
e
e
e
e
e
e
e
e
e
e
e
e
e
e
e
e
e
e
e
e
e
e
e
e
e
e
e
e
e
e
e
e
e
e
e
e
e
e
e
e
e
e
a
a
"}
(44,1,1) = {"
a
a
e
e
e
e
e
e
e
e
e
e
e
e
e
e
e
e
e
e
e
e
e
e
e
e
e
e
e
e
e
e
e
e
e
e
e
e
e
e
e
e
e
e
e
e
e
e
e
e
a
a
"}
(45,1,1) = {"
f
f
e
e
e
e
e
e
g
g
e
e
e
e
g
g
e
e
e
e
g
g
e
e
e
e
g
g
e
e
e
e
g
g
e
e
e
e
g
g
e
e
e
e
g
g
e
e
e
e
f
f
"}
(46,1,1) = {"
f
f
e
e
e
e
e
e
g
g
e
e
e
e
g
g
e
e
e
e
g
g
e
e
e
e
g
g
e
e
e
e
g
g
e
e
e
e
g
g
e
e
e
e
g
g
e
e
e
e
f
f
"}
(47,1,1) = {"
a
a
e
e
e
e
e
e
e
e
e
e
e
e
e
e
e
e
e
e
e
e
e
e
e
e
e
e
e
e
e
e
e
e
e
e
e
e
e
e
e
e
e
e
e
e
e
e
e
e
a
a
"}
(48,1,1) = {"
a
a
e
e
e
e
e
e
e
e
e
e
e
e
e
e
e
e
e
e
e
e
e
e
e
e
e
e
e
e
e
e
e
e
e
e
e
e
e
e
e
e
e
e
e
e
e
e
e
e
a
a
"}
(49,1,1) = {"
a
a
e
e
e
e
e
e
e
e
e
e
e
e
e
e
e
e
e
e
e
e
e
e
e
e
e
e
e
e
e
e
e
e
e
e
e
e
e
e
e
e
e
e
e
e
e
e
e
e
a
a
"}
(50,1,1) = {"
a
a
e
e
e
e
e
e
e
e
e
e
e
e
e
e
e
e
e
e
e
e
e
e
e
e
e
e
e
e
e
e
e
e
e
e
e
e
e
e
e
e
e
e
e
e
e
e
e
e
a
a
"}
(51,1,1) = {"
a
a
a
a
a
a
a
a
b
b
a
a
a
a
b
b
a
a
a
a
d
c
a
a
a
a
d
c
a
a
a
a
b
b
a
a
a
a
b
b
a
a
a
a
b
b
a
a
a
a
a
a
"}
(52,1,1) = {"
a
a
a
a
a
a
a
a
b
b
a
a
a
a
b
b
a
a
a
a
d
d
a
a
a
a
d
d
a
a
a
a
b
b
a
a
a
a
b
b
a
a
a
a
b
b
a
a
a
a
a
a
"}
