//MAP CONVERTED BY dmm2tgm.py THIS HEADER COMMENT PREVENTS RECONVERSION, DO NOT REMOVE
"aR" = (
/obj/table/regal/auto,
/obj/machinery/light/small/floor/netural,
/obj/item/reagent_containers/food/drinks/bottle/champagne{
	pixel_x = -7;
	pixel_y = 14;
	rand_pos = 0
	},
/obj/item/reagent_containers/food/drinks/drinkingglass/flute{
	pixel_x = -7;
	rand_pos = 0
	},
/obj/item/reagent_containers/food/drinks/drinkingglass/flute{
	pixel_x = -2;
	pixel_y = 8;
	rand_pos = 0
	},
/obj/item/reagent_containers/food/snacks/plant/apple{
	pixel_x = 6;
	pixel_y = -9;
	rand_pos = 0
	},
/obj/item/reagent_containers/food/snacks/plant/grape/green{
	pixel_x = 10;
	pixel_y = 14;
	rand_pos = 0
	},
/obj/item/reagent_containers/food/snacks/plant/grape{
	pixel_x = 8;
	pixel_y = 7;
	rand_pos = 0
	},
/turf/unsimulated/floor/marble/black,
/area/shuttle/escape/centcom/manta)
"df" = (
/obj/machinery/shuttle/engine/heater/seaheater_middle,
/turf/space/fluid,
/area/shuttle/escape/centcom/manta)
"dx" = (
/obj/item/storage/wall/medical{
	dir = 4
	},
/turf/simulated/wall/auto/shuttle{
	icon_state = "3"
	},
/area/shuttle/escape/centcom/manta)
"et" = (
/turf/simulated/wall/auto/shuttle{
	icon_state = "3"
	},
/area/shuttle/escape/centcom/manta)
"eA" = (
/obj/stool/chair/wooden/regal{
	anchored = 1;
	dir = 4
	},
/turf/unsimulated/floor/marble/border_bw{
	dir = 10
	},
/area/shuttle/escape/centcom/manta)
"fn" = (
/obj/table/regal/auto,
/obj/item/reagent_containers/food/drinks/drinkingglass/wine{
	pixel_x = 2;
	pixel_y = 6;
	rand_pos = 0
	},
/obj/item/reagent_containers/food/drinks/drinkingglass/wine{
	pixel_x = -2;
	pixel_y = 17;
	rand_pos = 0
	},
/obj/item/reagent_containers/food/drinks/bottle/wine{
	pixel_x = 7;
	pixel_y = 19;
	rand_pos = 0
	},
/obj/machinery/light/small/floor/netural,
/turf/unsimulated/floor/carpet/regalcarpet/border,
/area/shuttle/escape/centcom/manta)
"fu" = (
/turf/unsimulated/wall{
	dir = 4;
	icon = 'icons/misc/worlds.dmi';
	icon_state = "leadwindow_1";
	name = "window";
	opacity = 0
	},
/area/centcom)
"fJ" = (
/obj/stool/chair/wooden/regal{
	anchored = 1;
	dir = 1
	},
/turf/unsimulated/floor/marble/border_wb{
	dir = 1
	},
/area/shuttle/escape/centcom/manta)
"gx" = (
/obj/decoration/regallamp{
	anchored = 1;
	lit = 1
	},
/obj/machinery/light/incandescent/netural{
	dir = 8;
	pixel_x = -10
	},
/turf/unsimulated/floor/marble/black,
/area/shuttle/escape/centcom/manta)
"gM" = (
/obj/table/regal/auto,
/obj/item/storage/toolbox/emergency{
	pixel_y = 8
	},
/obj/item/reagent_containers/food/drinks/bottle/mead{
	pixel_x = -8;
	pixel_y = 6;
	rand_pos = 0
	},
/obj/item/reagent_containers/food/drinks/bottle/mead{
	pixel_x = -4;
	pixel_y = 4;
	rand_pos = 0
	},
/obj/item/reagent_containers/food/drinks/bottle/champagne{
	pixel_x = 7;
	pixel_y = 9;
	rand_pos = 0
	},
/turf/unsimulated/floor/marble/border_bw{
	dir = 1
	},
/area/shuttle/escape/centcom/manta)
"gS" = (
/obj/decal/lightshaft,
/obj/shrub{
	dir = 10
	},
/obj/machinery/light/incandescent/netural{
	dir = 8;
	pixel_x = -10
	},
/turf/unsimulated/floor/marble/border_bw{
	dir = 6
	},
/area/shuttle/escape/centcom/manta)
"hE" = (
/obj/decoration/regallamp{
	anchored = 1;
	lit = 1
	},
/obj/machinery/light/incandescent/netural{
	dir = 4;
	pixel_x = 10
	},
/turf/unsimulated/floor/marble/black,
/area/shuttle/escape/centcom/manta)
"hM" = (
/turf/unsimulated/floor/marble/border_bw{
	dir = 5
	},
/area/shuttle/escape/centcom/manta)
"hW" = (
/turf/unsimulated/floor/marble/border_bw{
	dir = 10
	},
/area/shuttle/escape/centcom/manta)
"jj" = (
/obj/machinery/shuttle/engine/heater{
	icon_state = "alt_heater-L"
	},
/obj/wingrille_spawn/auto,
/turf/unsimulated/floor/plating,
/area/shuttle/escape/centcom/manta)
"jz" = (
/obj/indestructible/shuttle_corner{
	dir = 8
	},
/turf/space/fluid,
/area/shuttle/escape/centcom/manta)
"jM" = (
/obj/indestructible/shuttle_corner{
	dir = 1
	},
/turf/space/fluid,
/area/shuttle/escape/centcom/manta)
"kT" = (
/obj/stool/chair/wooden/regal{
	anchored = 1
	},
/turf/unsimulated/floor/marble/border_wb,
/area/shuttle/escape/centcom/manta)
"lg" = (
/obj/table/regal/auto,
/obj/decoration/floralarrangement,
/turf/unsimulated/floor/marble/black,
/area/shuttle/escape/centcom/manta)
"lp" = (
/obj/shrub{
	dir = 6
	},
/turf/unsimulated/floor/marble/border_bw{
	dir = 9
	},
/area/shuttle/escape/centcom/manta)
"lK" = (
/obj/decal/lightshaft,
/obj/shrub{
	dir = 8
	},
/turf/unsimulated/floor/marble/border_bw{
	dir = 9
	},
/area/shuttle/escape/centcom/manta)
"mf" = (
/turf/unsimulated/floor/marble/border_bw{
	dir = 6
	},
/area/shuttle/escape/centcom/manta)
"nD" = (
/turf/unsimulated/floor/carpet/regalcarpet/border{
	dir = 4
	},
/area/shuttle/escape/centcom/manta)
"oY" = (
/turf/simulated/wall/auto/shuttle{
	icon_state = "11"
	},
/area/shuttle/escape/centcom/manta)
"pn" = (
/obj/stool/chair/comfy/throne_gold{
	anchored = 1
	},
/turf/unsimulated/floor/carpet/regalcarpet/innercorner{
	dir = 5
	},
/area/shuttle/escape/centcom/manta)
"qC" = (
/obj/stool/chair/wooden/regal{
	anchored = 1;
	dir = 8
	},
/turf/unsimulated/floor/marble/border_bw{
	dir = 4
	},
/area/shuttle/escape/centcom/manta)
"sb" = (
/turf/unsimulated/wall/setpieces/leadwall{
	dir = 5
	},
/area/centcom)
"sL" = (
/obj/machinery/shuttle/engine/heater{
	icon_state = "alt_heater-R"
	},
/obj/wingrille_spawn/auto,
/turf/unsimulated/floor/plating,
/area/shuttle/escape/centcom/manta)
"tw" = (
/obj/item/storage/wall/emergency{
	dir = 8
	},
/turf/simulated/wall/auto/shuttle{
	icon_state = "3"
	},
/area/shuttle/escape/centcom/manta)
"tO" = (
/obj/shrub{
	dir = 1
	},
/turf/unsimulated/floor/marble/border_bw{
	dir = 5
	},
/area/shuttle/escape/centcom/manta)
"uE" = (
/turf/space/fluid,
/area/centcom)
"vP" = (
/obj/decal/lightshaft,
/obj/shrub{
	dir = 1
	},
/turf/unsimulated/floor/marble/black,
/area/shuttle/escape/centcom/manta)
"wv" = (
/turf/unsimulated/floor/marble/border_wb{
	dir = 6
	},
/area/shuttle/escape/centcom/manta)
"wC" = (
/obj/indestructible/shuttle_corner{
	dir = 4
	},
/turf/unsimulated/floor/marble/black,
/area/shuttle/escape/centcom/manta)
"xx" = (
/turf/unsimulated/floor/marble/border_wb{
	dir = 1
	},
/area/shuttle/escape/centcom/manta)
"yg" = (
/obj/shrub{
	dir = 8
	},
/turf/unsimulated/floor/marble/black,
/area/shuttle/escape/centcom/manta)
"yl" = (
/obj/stool/chair/comfy/throne_gold{
	anchored = 1
	},
/obj/item/clothing/head/crown,
/turf/unsimulated/floor/carpet/regalcarpet/border{
	dir = 1
	},
/area/shuttle/escape/centcom/manta)
"yn" = (
/turf/unsimulated/floor/marble/border_bw{
	dir = 9
	},
/area/shuttle/escape/centcom/manta)
"yu" = (
/obj/table/regal/auto,
/obj/decoration/floralarrangement{
	pixel_x = 16
	},
/obj/random_item_spawner/med_kit/two,
/obj/item/storage/toolbox/emergency,
/turf/unsimulated/floor/carpet/regalcarpet/border{
	dir = 10
	},
/area/shuttle/escape/centcom/manta)
"yN" = (
/obj/shrub{
	dir = 4
	},
/obj/machinery/light/incandescent/netural{
	dir = 4;
	pixel_x = 10
	},
/obj/item/clothing/head/crown,
/turf/unsimulated/floor/marble/border_bw{
	dir = 10
	},
/area/shuttle/escape/centcom/manta)
"AF" = (
/turf/unsimulated/floor/marble,
/area/shuttle/escape/centcom/manta)
"AL" = (
/turf/space/fluid,
/area/shuttle/escape/centcom/manta)
"Bn" = (
/obj/indestructible/shuttle_corner,
/turf/unsimulated/floor/marble/black,
/area/shuttle/escape/centcom/manta)
"Cd" = (
/obj/machinery/door/airlock/pyro/external{
	dir = 4
	},
/turf/unsimulated/floor/shuttle,
/area/shuttle/escape/centcom/manta)
"CC" = (
/obj/stool/chair/wooden/regal{
	anchored = 1;
	dir = 4
	},
/turf/unsimulated/floor/marble/border_bw{
	dir = 8
	},
/area/shuttle/escape/centcom/manta)
"Dt" = (
/obj/table/regal/auto,
/obj/machinery/light/small/floor/netural,
/obj/item/reagent_containers/food/snacks/croissant{
	pixel_x = 10;
	pixel_y = 11;
	rand_pos = 0
	},
/obj/item/reagent_containers/food/snacks/croissant{
	pixel_x = 10;
	pixel_y = -3;
	rand_pos = 0
	},
/obj/item/reagent_containers/food/drinks/bottle/wine{
	pixel_x = -6;
	pixel_y = 9;
	rand_pos = 0
	},
/obj/item/reagent_containers/food/drinks/drinkingglass/wine{
	pixel_x = -3;
	pixel_y = 3;
	rand_pos = 0
	},
/turf/unsimulated/floor/marble/black,
/area/shuttle/escape/centcom/manta)
"Dx" = (
/obj/indestructible/shuttle_corner{
	dir = 4
	},
/turf/space/fluid,
/area/shuttle/escape/centcom/manta)
"Dy" = (
/obj/table/regal/auto,
/obj/machinery/light/small/floor/netural,
/obj/item/reagent_containers/food/snacks/croissant{
	pixel_x = -10;
	pixel_y = -3;
	rand_pos = 0
	},
/obj/item/reagent_containers/food/snacks/croissant{
	pixel_x = -10;
	pixel_y = 11;
	rand_pos = 0
	},
/obj/item/reagent_containers/food/snacks/garlicbread{
	rand_pos = 0
	},
/obj/item/reagent_containers/food/snacks/garlicbread_ch{
	pixel_y = 12;
	rand_pos = 0
	},
/turf/unsimulated/floor/marble/black,
/area/shuttle/escape/centcom/manta)
"DQ" = (
/obj/stool/chair/wooden/regal{
	anchored = 1
	},
/turf/unsimulated/floor/marble/black,
/area/shuttle/escape/centcom/manta)
"DW" = (
/turf/unsimulated/floor/marble/border_wb{
	dir = 9
	},
/area/shuttle/escape/centcom/manta)
"Fg" = (
/obj/stool/chair/wooden/regal{
	anchored = 1;
	dir = 8
	},
/turf/unsimulated/floor/marble/border_bw{
	dir = 5
	},
/area/shuttle/escape/centcom/manta)
"Gs" = (
/obj/table/regal/auto,
/obj/random_item_spawner/med_kit/two,
/obj/item/storage/toolbox/emergency,
/turf/unsimulated/floor/carpet/regalcarpet/border{
	dir = 6
	},
/area/shuttle/escape/centcom/manta)
"Gx" = (
/obj/table/regal/auto,
/obj/item/reagent_containers/food/snacks/croissant{
	pixel_x = 10;
	pixel_y = -3;
	rand_pos = 0
	},
/obj/item/reagent_containers/food/snacks/croissant{
	pixel_x = 10;
	pixel_y = 11;
	rand_pos = 0
	},
/obj/item/reagent_containers/food/snacks/plant/pear{
	pixel_x = -6;
	pixel_y = 22;
	rand_pos = 0
	},
/obj/item/reagent_containers/food/snacks/plant/strawberry{
	pixel_x = -8;
	pixel_y = 9;
	rand_pos = 0
	},
/obj/item/reagent_containers/food/snacks/plant/grape/green{
	pixel_x = 2;
	pixel_y = 9;
	rand_pos = 0
	},
/obj/item/reagent_containers/food/snacks/plant/grape{
	pixel_x = -8;
	rand_pos = 0
	},
/obj/item/reagent_containers/food/snacks/plant/cherry{
	pixel_y = -8;
	rand_pos = 0
	},
/turf/unsimulated/floor/marble/black,
/area/shuttle/escape/centcom/manta)
"HT" = (
/turf/unsimulated/floor/marble/black,
/area/shuttle/escape/centcom/manta)
"HY" = (
/turf/unsimulated/floor/carpet/regalcarpet/border,
/area/shuttle/escape/centcom/manta)
"Il" = (
/obj/machinery/shuttle/engine/heater{
	icon_state = "alt_heater-M"
	},
/obj/wingrille_spawn/auto,
/turf/unsimulated/floor/plating,
/area/shuttle/escape/centcom/manta)
"IJ" = (
/obj/machinery/computer/shuttle,
/turf/unsimulated/floor/marble/black,
/area/shuttle/escape/centcom/manta)
"Jj" = (
/obj/machinery/shuttle/engine/propulsion/sea_propulsion,
/turf/space/fluid,
/area/shuttle/escape/centcom/manta)
"JA" = (
/obj/indestructible/shuttle_corner{
	dir = 1
	},
/turf/unsimulated/floor/marble/black,
/area/shuttle/escape/centcom/manta)
"JJ" = (
/obj/decoration/regallamp{
	anchored = 1;
	lit = 1
	},
/turf/unsimulated/floor/marble/border_bw{
	dir = 9
	},
/area/shuttle/escape/centcom/manta)
"JM" = (
/obj/decoration/regallamp{
	anchored = 1;
	lit = 1
	},
/turf/unsimulated/floor/marble/border_bw{
	dir = 8
	},
/area/shuttle/escape/centcom/manta)
"JU" = (
/turf/unsimulated/floor/marble/border_wb{
	dir = 10
	},
/area/shuttle/escape/centcom/manta)
"KM" = (
/turf/unsimulated/wall/setpieces/leadwall{
	dir = 6
	},
/area/centcom)
"LO" = (
/obj/decoration/regallamp{
	anchored = 1;
	lit = 1
	},
/turf/unsimulated/floor/marble/border_bw{
	dir = 4
	},
/area/shuttle/escape/centcom/manta)
"LV" = (
/obj/stool/chair/comfy/throne_gold{
	anchored = 1
	},
/turf/unsimulated/floor/carpet/regalcarpet/border{
	dir = 9
	},
/area/shuttle/escape/centcom/manta)
"Mw" = (
/obj/stool/chair/wooden/regal{
	anchored = 1;
	dir = 8
	},
/turf/unsimulated/floor/marble/border_bw{
	dir = 6
	},
/area/shuttle/escape/centcom/manta)
"MK" = (
/obj/machinery/shuttle/engine/propulsion{
	icon_state = "alt_propulsion"
	},
/turf/space/fluid,
/area/shuttle/escape/centcom/manta)
"Nb" = (
/obj/table/regal/auto,
/obj/machinery/light/small/floor/netural,
/obj/item/reagent_containers/food/snacks/croissant{
	pixel_x = -10;
	pixel_y = 11;
	rand_pos = 0
	},
/obj/item/reagent_containers/food/snacks/croissant{
	pixel_x = -10;
	pixel_y = -3;
	rand_pos = 0
	},
/obj/item/reagent_containers/food/drinks/bottle/wine{
	pixel_x = 9;
	pixel_y = 20;
	rand_pos = 0
	},
/obj/item/reagent_containers/food/drinks/drinkingglass/wine{
	pixel_x = 2;
	pixel_y = 16;
	rand_pos = 0
	},
/obj/item/reagent_containers/food/drinks/drinkingglass/wine{
	pixel_x = 5;
	pixel_y = 10;
	rand_pos = 0
	},
/obj/item/reagent_containers/food/snacks/plant/apple{
	pixel_x = 5;
	pixel_y = -5;
	rand_pos = 0
	},
/turf/unsimulated/floor/marble/black,
/area/shuttle/escape/centcom/manta)
"Nu" = (
/obj/indestructible/shuttle_corner{
	dir = 8
	},
/turf/unsimulated/floor/marble/black,
/area/shuttle/escape/centcom/manta)
"Ob" = (
/turf/unsimulated/floor/carpet/regalcarpet/border{
	dir = 8
	},
/area/shuttle/escape/centcom/manta)
"OL" = (
/obj/table/regal/auto,
/obj/decoration/floralarrangement{
	pixel_x = 16
	},
/obj/item/reagent_containers/food/drinks/drinkingglass/wine{
	pixel_x = 4;
	pixel_y = 17;
	rand_pos = 0
	},
/obj/item/reagent_containers/food/drinks/drinkingglass/wine{
	pixel_y = 7;
	rand_pos = 0
	},
/obj/item/reagent_containers/food/drinks/bottle/wine{
	pixel_x = -8;
	pixel_y = 8;
	rand_pos = 0
	},
/obj/machinery/light/small/floor/netural,
/turf/unsimulated/floor/carpet/regalcarpet/border,
/area/shuttle/escape/centcom/manta)
"Pb" = (
/obj/decoration/regallamp{
	anchored = 1;
	lit = 1
	},
/turf/unsimulated/floor/marble/black,
/area/shuttle/escape/centcom/manta)
"Pd" = (
/obj/wingrille_spawn/auto/crystal,
/turf/unsimulated/floor/marble/black,
/area/shuttle/escape/centcom/manta)
"Pn" = (
/obj/decal/lightshaft,
/obj/shrub{
	dir = 6
	},
/turf/unsimulated/floor/marble/black,
/area/shuttle/escape/centcom/manta)
"PC" = (
/obj/shrub{
	dir = 4
	},
/obj/item/clothing/head/crown,
/turf/unsimulated/floor/marble/border_bw{
	dir = 5
	},
/area/shuttle/escape/centcom/manta)
"PZ" = (
/turf/unsimulated/wall/setpieces/leadwall{
	dir = 9
	},
/area/centcom)
"QE" = (
/obj/indestructible/shuttle_corner,
/turf/space/fluid,
/area/shuttle/escape/centcom/manta)
"RB" = (
/obj/table/regal/auto,
/obj/machinery/light/small/floor/netural,
/obj/item/reagent_containers/food/snacks/croissant{
	pixel_x = 10;
	pixel_y = -3;
	rand_pos = 0
	},
/obj/item/reagent_containers/food/snacks/croissant{
	pixel_x = 10;
	pixel_y = 11;
	rand_pos = 0
	},
/obj/item/reagent_containers/food/snacks/breadloaf/corn/sweet{
	pixel_x = -2;
	pixel_y = 10;
	rand_pos = 0
	},
/obj/item/reagent_containers/food/snacks/breadloaf/banana{
	pixel_x = -2;
	pixel_y = 1;
	rand_pos = 0
	},
/turf/unsimulated/floor/marble/black,
/area/shuttle/escape/centcom/manta)
"RD" = (
/turf/unsimulated/wall{
	icon = 'icons/misc/worlds.dmi';
	icon_state = "leadwall"
	},
/area/centcom)
"RQ" = (
/turf/unsimulated/floor/carpet/regalcarpet,
/area/shuttle/escape/centcom/manta)
"Se" = (
/obj/decoration/regallamp{
	anchored = 1;
	lit = 1
	},
/turf/unsimulated/floor/carpet/regalcarpet/border{
	dir = 5
	},
/area/shuttle/escape/centcom/manta)
"SL" = (
/obj/stool/chair/wooden/regal{
	anchored = 1;
	dir = 1
	},
/turf/unsimulated/floor/marble/black,
/area/shuttle/escape/centcom/manta)
"SW" = (
/obj/stool/chair/comfy/throne_gold{
	anchored = 1
	},
/turf/unsimulated/floor/carpet/regalcarpet/border{
	dir = 5
	},
/area/shuttle/escape/centcom/manta)
"SZ" = (
/obj/table/regal/auto,
/obj/machinery/light/small/floor/netural,
/obj/item/reagent_containers/food/drinks/bottle/champagne{
	pixel_x = 10;
	pixel_y = 20;
	rand_pos = 0
	},
/obj/item/reagent_containers/food/drinks/drinkingglass/flute{
	pixel_x = -7;
	pixel_y = 15;
	rand_pos = 0
	},
/obj/item/reagent_containers/food/drinks/drinkingglass/flute{
	pixel_x = -2;
	pixel_y = 7;
	rand_pos = 0
	},
/obj/item/reagent_containers/food/snacks/plant/grape{
	pixel_x = 8;
	pixel_y = 5;
	rand_pos = 0
	},
/turf/unsimulated/floor/marble/black,
/area/shuttle/escape/centcom/manta)
"Tj" = (
/obj/stool/chair/wooden/regal{
	anchored = 1;
	dir = 4
	},
/turf/unsimulated/floor/marble/border_bw{
	dir = 9
	},
/area/shuttle/escape/centcom/manta)
"VK" = (
/turf/unsimulated/floor/marble/border_wb{
	dir = 5
	},
/area/shuttle/escape/centcom/manta)
"Wu" = (
/obj/stool/chair/comfy/throne_gold{
	anchored = 1
	},
/turf/unsimulated/floor/carpet/regalcarpet/innercorner{
	dir = 1
	},
/area/shuttle/escape/centcom/manta)
"Ww" = (
/turf/simulated/wall/auto/shuttle{
	icon_state = "7"
	},
/area/shuttle/escape/centcom/manta)
"XK" = (
/obj/decoration/regallamp{
	anchored = 1;
	lit = 1
	},
/turf/unsimulated/floor/marble/border_bw{
	dir = 5
	},
/area/shuttle/escape/centcom/manta)
"XR" = (
/obj/decoration/regallamp{
	anchored = 1;
	lit = 1
	},
/turf/unsimulated/floor/carpet/regalcarpet/border{
	dir = 9
	},
/area/shuttle/escape/centcom/manta)
"XY" = (
/turf/unsimulated/wall/setpieces/leadwall{
	dir = 10
	},
/area/centcom)
"Yx" = (
/obj/table/regal/auto,
/obj/item/reagent_containers/food/snacks/croissant{
	pixel_x = -10;
	pixel_y = -3;
	rand_pos = 0
	},
/obj/item/reagent_containers/food/snacks/croissant{
	pixel_x = -10;
	pixel_y = 11;
	rand_pos = 0
	},
/obj/item/reagent_containers/food/snacks/danish_apple{
	pixel_x = 5;
	pixel_y = 13;
	rand_pos = 0
	},
/obj/item/reagent_containers/food/snacks/danish_blueb{
	pixel_x = 6;
	pixel_y = 7;
	rand_pos = 0
	},
/obj/item/reagent_containers/food/snacks/danish_blueb{
	pixel_x = 6;
	pixel_y = 3;
	rand_pos = 0
	},
/obj/item/reagent_containers/food/snacks/danish_weed{
	pixel_x = 6;
	pixel_y = -3;
	rand_pos = 0
	},
/obj/item/reagent_containers/food/snacks/danish_cherry{
	pixel_x = 6;
	pixel_y = -12;
	rand_pos = 0
	},
/turf/unsimulated/floor/marble/black,
/area/shuttle/escape/centcom/manta)
"Zh" = (
/obj/shrub{
	dir = 10
	},
/turf/unsimulated/floor/marble/black,
/area/shuttle/escape/centcom/manta)

(1,1,1) = {"
uE
uE
uE
uE
uE
QE
Pd
Pd
Pd
Cd
Pd
Pd
Dx
sb
RD
RD
XY
"}
(2,1,1) = {"
AL
QE
Ww
et
dx
oY
Nu
gS
LO
HT
Pb
tO
JA
Dx
uE
uE
fu
"}
(3,1,1) = {"
AL
Pd
Nu
gx
yg
Pb
mf
hM
AF
hW
yn
AF
XK
JA
df
Jj
sb
"}
(4,1,1) = {"
AL
Pd
Zh
LV
Ob
yu
DW
hW
wv
eA
Tj
CC
mf
PC
JA
Dx
AL
"}
(5,1,1) = {"
Pd
Pd
XR
Wu
RQ
fn
DW
AF
DQ
RB
Gx
Dt
SL
AF
XK
jj
MK
"}
(6,1,1) = {"
Pd
IJ
yl
RQ
RQ
HY
xx
kT
aR
lg
lg
lg
SZ
fJ
gM
Il
MK
"}
(7,1,1) = {"
Pd
Pd
Se
pn
RQ
OL
VK
AF
DQ
Nb
Yx
Dy
SL
AF
JJ
sL
MK
"}
(8,1,1) = {"
AL
Pd
vP
SW
nD
Gs
VK
mf
JU
Mw
Fg
qC
hW
lp
Bn
jz
AL
"}
(9,1,1) = {"
AL
Pd
wC
hE
Pn
Pb
hW
yn
AF
mf
hM
AF
JJ
Bn
df
Jj
PZ
"}
(10,1,1) = {"
AL
jM
oY
et
tw
Ww
wC
yN
JM
HT
Pb
lK
Bn
jz
uE
uE
fu
"}
(11,1,1) = {"
uE
uE
uE
uE
uE
jM
Pd
Pd
Pd
Cd
Pd
Pd
jz
PZ
RD
RD
KM
"}
