//MAP CONVERTED BY dmm2tgm.py THIS HEADER COMMENT PREVENTS RECONVERSION, DO NOT REMOVE
"c" = (
/obj/art_fissure_objs/door,
/turf/unsimulated/floor/void,
/area/artifact_fissure)
"e" = (
/turf/unsimulated/floor/void,
/area/artifact_fissure)
"g" = (
/obj/art_fissure_objs/door/unopenable{
	dir = 8
	},
/turf/unsimulated/floor/void,
/area/artifact_fissure)
"v" = (
/obj/art_fissure_objs/door{
	dir = 4
	},
/turf/unsimulated/floor/void,
/area/artifact_fissure)
"w" = (
/obj/art_fissure_objs/door/unopenable{
	dir = 4
	},
/turf/unsimulated/floor/void,
/area/artifact_fissure)
"y" = (
/obj/art_fissure_objs/door{
	dir = 1
	},
/turf/unsimulated/floor/void,
/area/artifact_fissure)
"H" = (
/obj/machinery/light/small/floor,
/turf/unsimulated/floor/marble/black,
/area/artifact_fissure)
"L" = (
/turf/unsimulated/wall/auto/adventure/ancient/artifact_fissure,
/area/artifact_fissure)
"S" = (
/obj/art_fissure_objs/door{
	dir = 8
	},
/turf/unsimulated/floor/void,
/area/artifact_fissure)
"V" = (
/turf/unsimulated/floor/marble,
/area/artifact_fissure)
"Z" = (
/turf/unsimulated/floor/void,
/area/artifact_fissure/visual_mirror)

(1,1,1) = {"
Z
Z
Z
Z
Z
Z
Z
Z
Z
Z
Z
Z
Z
Z
Z
Z
Z
Z
Z
Z
Z
Z
Z
Z
Z
Z
Z
Z
Z
Z
Z
Z
Z
Z
Z
"}
(2,1,1) = {"
Z
Z
Z
Z
Z
Z
Z
Z
Z
Z
Z
Z
Z
Z
Z
Z
Z
Z
Z
Z
Z
Z
Z
Z
Z
Z
Z
Z
Z
Z
Z
Z
Z
Z
Z
"}
(3,1,1) = {"
Z
Z
Z
Z
Z
Z
Z
Z
Z
Z
Z
Z
Z
Z
Z
Z
Z
Z
Z
Z
Z
Z
Z
Z
Z
Z
Z
Z
Z
Z
Z
Z
Z
Z
Z
"}
(4,1,1) = {"
Z
Z
Z
Z
Z
Z
Z
Z
Z
Z
Z
Z
Z
Z
Z
Z
Z
Z
Z
Z
Z
Z
Z
Z
Z
Z
Z
Z
Z
Z
Z
Z
Z
Z
Z
"}
(5,1,1) = {"
Z
Z
Z
Z
Z
Z
Z
Z
Z
Z
Z
Z
Z
Z
Z
Z
Z
Z
Z
Z
Z
Z
Z
Z
Z
Z
Z
Z
Z
Z
Z
Z
Z
Z
Z
"}
(6,1,1) = {"
Z
Z
Z
Z
Z
Z
Z
Z
Z
Z
Z
Z
Z
Z
Z
Z
Z
Z
Z
Z
Z
Z
Z
Z
Z
Z
Z
Z
Z
Z
Z
Z
Z
Z
Z
"}
(7,1,1) = {"
Z
Z
Z
Z
Z
Z
Z
Z
Z
Z
Z
Z
Z
Z
Z
Z
Z
Z
Z
Z
Z
Z
Z
Z
Z
Z
Z
Z
Z
Z
Z
Z
Z
Z
Z
"}
(8,1,1) = {"
Z
Z
Z
Z
Z
Z
Z
Z
Z
Z
Z
Z
Z
Z
Z
Z
Z
Z
Z
Z
Z
Z
Z
Z
Z
Z
Z
Z
Z
Z
Z
Z
Z
Z
Z
"}
(9,1,1) = {"
Z
Z
Z
Z
Z
Z
Z
Z
Z
Z
Z
Z
Z
Z
Z
Z
Z
Z
Z
Z
Z
Z
Z
Z
Z
Z
Z
Z
Z
Z
Z
Z
Z
Z
Z
"}
(10,1,1) = {"
Z
Z
Z
Z
Z
Z
Z
Z
Z
Z
Z
Z
Z
Z
Z
Z
Z
Z
Z
Z
Z
Z
Z
Z
Z
Z
Z
Z
Z
Z
Z
Z
Z
Z
Z
"}
(11,1,1) = {"
Z
Z
Z
Z
Z
Z
Z
Z
Z
Z
Z
Z
Z
Z
Z
Z
Z
Z
Z
Z
Z
Z
Z
Z
Z
Z
Z
Z
Z
Z
Z
Z
Z
Z
Z
"}
(12,1,1) = {"
Z
Z
Z
Z
Z
Z
Z
Z
Z
Z
Z
Z
Z
Z
Z
Z
Z
Z
Z
Z
Z
Z
Z
Z
Z
Z
Z
Z
Z
Z
Z
Z
Z
Z
Z
"}
(13,1,1) = {"
Z
Z
Z
Z
Z
Z
Z
Z
Z
Z
Z
L
L
w
L
L
v
L
L
w
L
L
Z
Z
Z
Z
Z
Z
Z
Z
Z
Z
Z
Z
Z
"}
(14,1,1) = {"
Z
Z
Z
Z
Z
Z
Z
Z
Z
Z
Z
L
V
V
e
V
V
V
V
V
e
L
Z
Z
Z
Z
Z
Z
Z
Z
Z
Z
Z
Z
Z
"}
(15,1,1) = {"
Z
Z
Z
Z
Z
Z
Z
Z
Z
Z
Z
c
V
H
V
H
e
H
V
H
V
y
Z
Z
Z
Z
Z
Z
Z
Z
Z
Z
Z
Z
Z
"}
(16,1,1) = {"
Z
Z
Z
Z
Z
Z
Z
Z
Z
Z
Z
L
e
V
V
V
V
V
e
e
V
L
Z
Z
Z
Z
Z
Z
Z
Z
Z
Z
Z
Z
Z
"}
(17,1,1) = {"
Z
Z
Z
Z
Z
Z
Z
Z
Z
Z
Z
L
L
g
L
L
S
L
L
g
L
L
Z
Z
Z
Z
Z
Z
Z
Z
Z
Z
Z
Z
Z
"}
(18,1,1) = {"
Z
Z
Z
Z
Z
Z
Z
Z
Z
Z
Z
Z
Z
Z
Z
Z
Z
Z
Z
Z
Z
Z
Z
Z
Z
Z
Z
Z
Z
Z
Z
Z
Z
Z
Z
"}
(19,1,1) = {"
Z
Z
Z
Z
Z
Z
Z
Z
Z
Z
Z
Z
Z
Z
Z
Z
Z
Z
Z
Z
Z
Z
Z
Z
Z
Z
Z
Z
Z
Z
Z
Z
Z
Z
Z
"}
(20,1,1) = {"
Z
Z
Z
Z
Z
Z
Z
Z
Z
Z
Z
Z
Z
Z
Z
Z
Z
Z
Z
Z
Z
Z
Z
Z
Z
Z
Z
Z
Z
Z
Z
Z
Z
Z
Z
"}
(21,1,1) = {"
Z
Z
Z
Z
Z
Z
Z
Z
Z
Z
Z
Z
Z
Z
Z
Z
Z
Z
Z
Z
Z
Z
Z
Z
Z
Z
Z
Z
Z
Z
Z
Z
Z
Z
Z
"}
(22,1,1) = {"
Z
Z
Z
Z
Z
Z
Z
Z
Z
Z
Z
Z
Z
Z
Z
Z
Z
Z
Z
Z
Z
Z
Z
Z
Z
Z
Z
Z
Z
Z
Z
Z
Z
Z
Z
"}
(23,1,1) = {"
Z
Z
Z
Z
Z
Z
Z
Z
Z
Z
Z
Z
Z
Z
Z
Z
Z
Z
Z
Z
Z
Z
Z
Z
Z
Z
Z
Z
Z
Z
Z
Z
Z
Z
Z
"}
(24,1,1) = {"
Z
Z
Z
Z
Z
Z
Z
Z
Z
Z
Z
Z
Z
Z
Z
Z
Z
Z
Z
Z
Z
Z
Z
Z
Z
Z
Z
Z
Z
Z
Z
Z
Z
Z
Z
"}
(25,1,1) = {"
Z
Z
Z
Z
Z
Z
Z
Z
Z
Z
Z
Z
Z
Z
Z
Z
Z
Z
Z
Z
Z
Z
Z
Z
Z
Z
Z
Z
Z
Z
Z
Z
Z
Z
Z
"}
(26,1,1) = {"
Z
Z
Z
Z
Z
Z
Z
Z
Z
Z
Z
Z
Z
Z
Z
Z
Z
Z
Z
Z
Z
Z
Z
Z
Z
Z
Z
Z
Z
Z
Z
Z
Z
Z
Z
"}
(27,1,1) = {"
Z
Z
Z
Z
Z
Z
Z
Z
Z
Z
Z
Z
Z
Z
Z
Z
Z
Z
Z
Z
Z
Z
Z
Z
Z
Z
Z
Z
Z
Z
Z
Z
Z
Z
Z
"}
(28,1,1) = {"
Z
Z
Z
Z
Z
Z
Z
Z
Z
Z
Z
Z
Z
Z
Z
Z
Z
Z
Z
Z
Z
Z
Z
Z
Z
Z
Z
Z
Z
Z
Z
Z
Z
Z
Z
"}
(29,1,1) = {"
Z
Z
Z
Z
Z
Z
Z
Z
Z
Z
Z
Z
Z
Z
Z
Z
Z
Z
Z
Z
Z
Z
Z
Z
Z
Z
Z
Z
Z
Z
Z
Z
Z
Z
Z
"}
