//MAP CONVERTED BY dmm2tgm.py THIS HEADER COMMENT PREVENTS RECONVERSION, DO NOT REMOVE
"a" = (
/turf/space,
/area/space)
"e" = (
/obj/machinery/vending/computer3,
/turf/simulated/floor,
/area/space)
"f" = (
/obj/machinery/light/small/floor,
/turf/simulated/floor,
/area/space)
"g" = (
/obj/landmark/tutorial_start,
/turf/simulated/floor,
/area/space)
"h" = (
/obj/machinery/light{
	dir = 4
	},
/turf/simulated/floor,
/area/space)
"j" = (
/obj/machinery/door/airlock/pyro/command,
/obj/access_spawn/heads,
/turf/simulated/floor,
/area/space)
"k" = (
/obj/stool/chair/office/blue{
	dir = 4
	},
/turf/simulated/floor,
/area/space)
"l" = (
/turf/simulated/wall/auto/supernorn,
/area/space)
"n" = (
/obj/machinery/vending/book{
	dir = 8;
	pixel_x = 9
	},
/turf/simulated/floor,
/area/space)
"q" = (
/obj/rack,
/obj/item/crowbar{
	pixel_x = -5;
	pixel_y = 5
	},
/obj/item/tank/air{
	pixel_x = -2;
	pixel_y = -1
	},
/obj/item/clothing/mask/gas/emergency{
	pixel_x = 5;
	pixel_y = -6
	},
/obj/machinery/junk_spawner,
/turf/simulated/floor,
/area/space)
"C" = (
/turf/simulated/floor,
/area/space)
"D" = (
/obj/wingrille_spawn/auto/crystal,
/turf/simulated/floor,
/area/space)
"H" = (
/obj/machinery/vending/coffee{
	dir = 4;
	pixel_x = -9
	},
/turf/simulated/floor,
/area/space)
"L" = (
/obj/machinery/vending/floppy,
/turf/simulated/floor,
/area/space)
"O" = (
/obj/landmark/tutorial/flock_conversion,
/turf/simulated/floor,
/area/space)
"P" = (
/obj/machinery/light{
	dir = 8
	},
/turf/simulated/floor,
/area/space)
"Q" = (
/obj/stool/chair/office/blue{
	dir = 8
	},
/turf/simulated/floor,
/area/space)
"R" = (
/turf/cordon,
/area/space)
"S" = (
/obj/machinery/light,
/turf/simulated/floor,
/area/space)
"T" = (
/obj/table/reinforced/industrial/auto,
/turf/simulated/floor,
/area/space)
"V" = (
/obj/machinery/light{
	dir = 1
	},
/turf/simulated/floor,
/area/space)
"X" = (
/obj/machinery/vending/cola/blue{
	credit = 12;
	dir = 4;
	pixel_x = -9
	},
/turf/simulated/floor,
/area/space)
"Z" = (
/obj/machinery/vending/pizza{
	anchored = 1;
	dir = 8;
	pixel_x = 9
	},
/turf/simulated/floor,
/area/space)

(1,1,1) = {"
R
R
R
R
R
R
R
R
R
R
R
R
R
R
R
R
R
R
R
R
R
R
R
R
R
R
R
R
R
R
R
"}
(2,1,1) = {"
R
a
a
a
a
a
a
a
a
a
a
a
a
a
a
a
a
a
a
a
a
a
a
a
a
a
a
a
a
a
R
"}
(3,1,1) = {"
R
a
a
a
a
a
a
a
a
a
a
a
a
a
a
a
a
a
a
a
a
a
a
a
a
a
a
a
a
a
R
"}
(4,1,1) = {"
R
a
a
a
a
a
a
a
a
a
a
a
a
a
a
a
a
a
a
a
a
a
a
a
a
a
a
a
a
a
R
"}
(5,1,1) = {"
R
a
a
a
a
a
a
a
a
a
a
a
a
a
a
a
a
a
a
a
a
a
a
a
a
a
a
a
a
a
R
"}
(6,1,1) = {"
R
a
a
a
a
a
a
a
a
a
a
a
a
a
a
a
a
a
a
a
a
a
a
a
a
a
a
a
a
a
R
"}
(7,1,1) = {"
R
a
a
a
a
a
a
a
a
a
a
a
a
a
a
a
a
a
a
a
a
a
a
a
a
a
a
a
a
a
R
"}
(8,1,1) = {"
R
a
a
a
a
a
a
a
a
a
a
a
a
a
a
a
a
a
a
a
a
a
a
a
a
a
a
a
a
a
R
"}
(9,1,1) = {"
R
a
a
a
a
a
a
a
a
l
l
l
l
l
l
l
l
l
a
a
a
a
a
a
a
a
a
a
a
a
R
"}
(10,1,1) = {"
R
a
a
a
a
a
a
a
l
l
P
H
C
C
C
X
P
l
l
a
a
a
a
a
a
a
a
a
a
a
R
"}
(11,1,1) = {"
R
a
a
a
a
a
a
l
l
C
C
C
C
C
C
C
C
C
l
l
a
a
a
a
a
a
a
a
a
a
R
"}
(12,1,1) = {"
R
a
a
a
a
a
l
l
C
C
C
C
C
f
C
C
C
C
C
l
R
R
R
R
R
R
R
R
R
R
R
"}
(13,1,1) = {"
R
a
a
a
a
a
l
V
C
C
T
T
C
C
C
T
T
C
C
S
l
l
l
l
l
l
l
l
l
l
R
"}
(14,1,1) = {"
R
a
a
a
a
a
l
e
C
C
T
Q
C
C
C
Q
T
C
C
C
l
C
C
C
C
l
C
C
C
l
R
"}
(15,1,1) = {"
R
a
a
a
a
a
l
C
C
C
C
C
C
C
C
C
C
C
C
C
D
C
C
C
C
l
V
C
C
l
R
"}
(16,1,1) = {"
R
a
a
a
a
a
l
C
C
f
C
C
C
O
C
C
C
f
C
C
D
C
q
f
C
j
C
C
g
l
R
"}
(17,1,1) = {"
R
a
a
a
a
a
l
C
C
C
C
C
C
C
C
C
C
C
C
C
D
C
C
C
C
l
V
C
C
l
R
"}
(18,1,1) = {"
R
a
a
a
a
a
l
L
C
C
T
k
C
C
C
k
T
C
C
C
l
C
C
C
C
l
C
C
C
l
R
"}
(19,1,1) = {"
R
a
a
a
a
a
l
V
C
C
T
T
C
C
C
T
T
C
C
S
l
l
l
l
l
l
l
l
l
l
R
"}
(20,1,1) = {"
R
a
a
a
a
a
l
l
C
C
C
C
C
f
C
C
C
C
C
l
R
R
R
R
R
R
R
R
R
R
R
"}
(21,1,1) = {"
R
a
a
a
a
a
a
l
l
C
C
C
C
C
C
C
C
C
l
l
a
a
a
a
a
a
a
a
a
a
R
"}
(22,1,1) = {"
R
a
a
a
a
a
a
a
l
l
h
n
C
C
C
Z
h
l
l
a
a
a
a
a
a
a
a
a
a
a
R
"}
(23,1,1) = {"
R
a
a
a
a
a
a
a
a
l
l
l
l
l
l
l
l
l
a
a
a
a
a
a
a
a
a
a
a
a
R
"}
(24,1,1) = {"
R
a
a
a
a
a
a
a
a
a
a
a
a
a
a
a
a
a
a
a
a
a
a
a
a
a
a
a
a
a
R
"}
(25,1,1) = {"
R
a
a
a
a
a
a
a
a
a
a
a
a
a
a
a
a
a
a
a
a
a
a
a
a
a
a
a
a
a
R
"}
(26,1,1) = {"
R
a
a
a
a
a
a
a
a
a
a
a
a
a
a
a
a
a
a
a
a
a
a
a
a
a
a
a
a
a
R
"}
(27,1,1) = {"
R
a
a
a
a
a
a
a
a
a
a
a
a
a
a
a
a
a
a
a
a
a
a
a
a
a
a
a
a
a
R
"}
(28,1,1) = {"
R
a
a
a
a
a
a
a
a
a
a
a
a
a
a
a
a
a
a
a
a
a
a
a
a
a
a
a
a
a
R
"}
(29,1,1) = {"
R
a
a
a
a
a
a
a
a
a
a
a
a
a
a
a
a
a
a
a
a
a
a
a
a
a
a
a
a
a
R
"}
(30,1,1) = {"
R
a
a
a
a
a
a
a
a
a
a
a
a
a
a
a
a
a
a
a
a
a
a
a
a
a
a
a
a
a
R
"}
(31,1,1) = {"
R
R
R
R
R
R
R
R
R
R
R
R
R
R
R
R
R
R
R
R
R
R
R
R
R
R
R
R
R
R
R
"}
