//MAP CONVERTED BY dmm2tgm.py THIS HEADER COMMENT PREVENTS RECONVERSION, DO NOT REMOVE
"a" = (
/turf/unsimulated/floor/void,
/area/veil_border)
"f" = (
/obj/map/light/purple,
/turf/simulated/floor,
/area/veil_border)
"j" = (
/turf/simulated/wall/auto,
/area/veil_border)
"A" = (
/turf/simulated/floor,
/area/veil_border)
"H" = (
/turf/unsimulated/wall/void,
/area/veil_border)
"I" = (
/obj/decal/floatingtiles/random,
/turf/unsimulated/floor/void,
/area/veil_border)
"L" = (
/obj/decal/floatingtiles/random,
/obj/map/light/purple,
/turf/unsimulated/floor/void,
/area/veil_border)

(1,1,1) = {"
a
a
a
a
a
a
a
a
a
a
a
a
a
a
a
a
a
a
a
a
a
"}
(2,1,1) = {"
a
a
a
a
a
a
a
a
a
H
H
H
a
a
a
a
a
a
a
a
a
"}
(3,1,1) = {"
a
a
a
a
a
a
a
H
H
H
A
H
H
H
a
a
a
a
a
a
a
"}
(4,1,1) = {"
a
a
a
a
a
a
H
H
A
A
A
A
A
H
H
a
a
a
a
a
a
"}
(5,1,1) = {"
a
a
a
a
a
H
H
A
A
A
L
A
A
A
H
H
a
a
a
a
a
"}
(6,1,1) = {"
a
a
a
a
H
H
A
A
A
A
A
A
A
A
A
H
H
a
a
a
a
"}
(7,1,1) = {"
a
a
a
H
H
A
f
A
a
A
a
A
A
A
L
A
H
H
a
a
a
"}
(8,1,1) = {"
a
a
H
H
A
A
A
A
A
j
A
A
j
A
A
A
A
H
H
a
a
"}
(9,1,1) = {"
a
a
H
A
A
A
I
A
j
j
A
A
j
j
A
A
A
A
H
a
a
"}
(10,1,1) = {"
a
H
H
A
A
A
A
A
A
a
a
A
A
j
A
a
A
A
H
H
a
"}
(11,1,1) = {"
a
H
A
A
f
a
A
I
A
a
L
a
A
j
j
I
f
A
A
H
a
"}
(12,1,1) = {"
a
H
H
A
A
a
A
A
A
A
a
A
A
A
A
A
A
A
H
H
a
"}
(13,1,1) = {"
a
a
H
A
A
A
A
A
j
j
A
A
A
A
A
A
A
A
H
a
a
"}
(14,1,1) = {"
a
a
H
H
A
A
a
A
A
j
A
a
A
A
A
A
A
H
H
a
a
"}
(15,1,1) = {"
a
a
a
H
H
A
f
A
A
I
A
A
A
a
f
A
H
H
a
a
a
"}
(16,1,1) = {"
a
a
a
a
H
H
A
a
a
a
A
A
A
A
A
H
H
a
a
a
a
"}
(17,1,1) = {"
a
a
a
a
a
H
H
A
A
A
f
A
A
A
H
H
a
a
a
a
a
"}
(18,1,1) = {"
a
a
a
a
a
a
H
H
A
A
A
A
A
H
H
a
a
a
a
a
a
"}
(19,1,1) = {"
a
a
a
a
a
a
a
H
H
H
A
H
H
H
a
a
a
a
a
a
a
"}
(20,1,1) = {"
a
a
a
a
a
a
a
a
a
H
H
H
a
a
a
a
a
a
a
a
a
"}
(21,1,1) = {"
a
a
a
a
a
a
a
a
a
a
a
a
a
a
a
a
a
a
a
a
a
"}
