//MAP CONVERTED BY dmm2tgm.py THIS HEADER COMMENT PREVENTS RECONVERSION, DO NOT REMOVE
"a" = (
/turf/unsimulated/floor/void/dense,
/area/veil_border/outer)
"c" = (
/turf/unsimulated/wall/void,
/area/veil_border/outer)
"f" = (
/obj/map/light/purple,
/turf/simulated/floor,
/area/veil_border/inner)
"j" = (
/turf/simulated/wall/auto,
/area/veil_border/inner)
"k" = (
/obj/map/light/purple,
/turf/unsimulated/floor/void/dense,
/area/veil_border/outer)
"n" = (
/obj/map/light/purple,
/turf/unsimulated/floor/void/dense,
/area/veil_border/inner)
"q" = (
/turf/unsimulated/floor/void,
/area/veil_border/inner)
"A" = (
/turf/simulated/floor,
/area/veil_border/inner)
"H" = (
/turf/unsimulated/floor/void/dense,
/area/veil_border/inner)
"I" = (
/obj/decal/floatingtiles/random,
/turf/unsimulated/floor/void,
/area/veil_border/inner)
"L" = (
/obj/decal/floatingtiles/random,
/obj/map/light/purple,
/turf/unsimulated/floor/void,
/area/veil_border/inner)

(1,1,1) = {"
c
c
c
c
c
c
c
c
c
c
c
c
c
c
c
c
c
c
c
c
c
"}
(2,1,1) = {"
c
a
a
a
a
a
a
a
a
H
n
H
a
a
a
a
a
a
a
a
c
"}
(3,1,1) = {"
c
a
a
a
a
k
a
H
H
H
A
H
H
H
a
k
a
a
a
a
c
"}
(4,1,1) = {"
c
a
a
k
a
a
H
H
A
A
A
A
A
H
H
a
a
k
a
a
c
"}
(5,1,1) = {"
c
a
a
a
a
H
H
A
A
A
L
A
A
A
H
H
a
a
a
a
c
"}
(6,1,1) = {"
c
a
k
a
H
H
A
A
A
A
A
A
A
A
A
H
H
a
k
a
c
"}
(7,1,1) = {"
c
a
a
H
H
A
f
A
q
A
q
A
A
A
L
A
H
H
a
a
c
"}
(8,1,1) = {"
c
a
H
H
A
A
A
A
A
j
A
A
j
A
A
A
A
H
H
a
c
"}
(9,1,1) = {"
c
a
H
A
A
A
I
A
j
j
A
A
j
j
A
A
A
A
H
a
c
"}
(10,1,1) = {"
c
H
H
A
A
A
A
A
A
q
q
A
A
j
A
q
A
A
H
H
c
"}
(11,1,1) = {"
c
n
A
A
f
q
A
I
A
q
L
q
A
j
j
I
f
A
A
n
c
"}
(12,1,1) = {"
c
H
H
A
A
q
A
A
A
A
q
A
A
A
A
A
A
A
H
H
c
"}
(13,1,1) = {"
c
a
H
A
A
A
A
A
j
j
A
A
A
A
A
A
A
A
H
a
c
"}
(14,1,1) = {"
c
a
H
H
A
A
q
A
A
j
A
q
A
A
A
A
A
H
H
a
c
"}
(15,1,1) = {"
c
a
a
H
H
A
f
A
A
I
A
A
A
q
f
A
H
H
a
a
c
"}
(16,1,1) = {"
c
a
k
a
H
H
A
q
q
q
A
A
A
A
A
H
H
a
k
a
c
"}
(17,1,1) = {"
c
a
a
a
a
H
H
A
A
A
f
A
A
A
H
H
a
a
a
a
c
"}
(18,1,1) = {"
c
a
a
k
a
a
H
H
A
A
A
A
A
H
H
a
a
k
a
a
c
"}
(19,1,1) = {"
c
a
a
a
a
k
a
H
H
H
A
H
H
H
a
k
a
a
a
a
c
"}
(20,1,1) = {"
c
a
a
a
a
a
a
a
a
H
n
H
a
a
a
a
a
a
a
a
c
"}
(21,1,1) = {"
c
c
c
c
c
c
c
c
c
c
c
c
c
c
c
c
c
c
c
c
c
"}
