//MAP CONVERTED BY dmm2tgm.py THIS HEADER COMMENT PREVENTS RECONVERSION, DO NOT REMOVE
"a" = (
/turf/unsimulated/floor/carpet/arcade,
/area/space)
"d" = (
/obj/stool/chair/syndicate,
/turf/unsimulated/floor/carpet/arcade,
/area/space)
"z" = (
/obj/fitness/speedbag/clown,
/turf/unsimulated/floor/carpet/arcade,
/area/space)
"L" = (
/obj/machinery/light/flock/floor,
/turf/unsimulated/floor/carpet/arcade,
/area/space)
"S" = (
/obj/critter/domestic_bee/clownbee,
/turf/unsimulated/floor/carpet/arcade,
/area/space)

(1,1,1) = {"
S
a
a
a
a
a
a
"}
(2,1,1) = {"
a
L
a
a
a
L
a
"}
(3,1,1) = {"
a
a
a
a
a
a
a
"}
(4,1,1) = {"
L
a
a
d
a
a
L
"}
(5,1,1) = {"
a
a
a
a
a
a
a
"}
(6,1,1) = {"
a
a
L
a
a
L
a
"}
(7,1,1) = {"
a
a
a
a
a
a
z
"}
