//MAP CONVERTED BY dmm2tgm.py THIS HEADER COMMENT PREVENTS RECONVERSION, DO NOT REMOVE
"af" = (
/obj/table/reinforced/auto,
/obj/landmark/newbee/pickup_toolbox,
/turf/unsimulated/floor/white,
/area/tutorial/newbee/room_6)
"ah" = (
/turf/unsimulated/floor/bluewhite{
	dir = 9
	},
/area/tutorial/newbee/room_5)
"aJ" = (
/obj/table/reinforced/auto,
/obj/item/storage/firstaid/fire{
	pixel_x = -7
	},
/obj/item/storage/firstaid/oxygen{
	pixel_x = 7
	},
/turf/unsimulated/floor/greenblack,
/area/tutorial/newbee/room_11)
"aK" = (
/turf/unsimulated/wall/setpieces/leadwall/junction{
	dir = 8
	},
/area/tutorial/newbee)
"aQ" = (
/turf/unsimulated/floor/escape{
	dir = 10
	},
/area/tutorial/newbee/room_16)
"bh" = (
/turf/unsimulated/floor/darkpurpleblack{
	dir = 5
	},
/area/tutorial/newbee/room_12)
"bj" = (
/turf/unsimulated/floor/blackwhite{
	dir = 10
	},
/area/tutorial/newbee/room_6)
"bp" = (
/turf/unsimulated/floor/darkbluewhite{
	dir = 6
	},
/area/tutorial/newbee/room_7)
"br" = (
/turf/unsimulated/floor/blackwhite{
	dir = 1
	},
/area/tutorial/newbee/room_6)
"bN" = (
/obj/table/reinforced/auto,
/obj/item/wrench,
/turf/unsimulated/floor/black,
/area/tutorial/newbee/room_12)
"bW" = (
/obj/machinery/power/apc/autoname_north/hardened{
	pixel_y = 0;
	cell_type = 0
	},
/turf/unsimulated/floor,
/area/tutorial/newbee/unpowered)
"cE" = (
/turf/simulated/wall/false_wall/centcom{
	dir = 1
	},
/area/tutorial/newbee/room_13)
"cT" = (
/obj/decal/cleanable/blood/splatter,
/turf/unsimulated/floor/plating,
/area/tutorial/newbee/room_8)
"dF" = (
/obj/machinery/light/incandescent,
/turf/simulated/floor/bluegreen/side{
	dir = 1
	},
/area/tutorial/newbee/room_9)
"dK" = (
/turf/unsimulated/wall/setpieces/leadwall{
	dir = 1
	},
/area/tutorial/newbee)
"dR" = (
/turf/unsimulated/floor/arrival{
	dir = 1
	},
/area/tutorial/newbee/room_1)
"ee" = (
/turf/unsimulated/wall/setpieces/leadwindow/full{
	dir = 8
	},
/area/tutorial/newbee)
"ek" = (
/obj/decal/cleanable/dirt/dirt5,
/obj/item/storage/firstaid/toxin,
/mob/living/critter/spider/clownqueen,
/turf/unsimulated/floor/plating,
/area/tutorial/newbee/room_8)
"eo" = (
/obj/mapping_helper/wingrille_spawn/auto/reinforced,
/turf/unsimulated/floor/plating,
/area/tutorial/newbee/room_9)
"fe" = (
/obj/table/reinforced/auto,
/obj/landmark/newbee/pickup_backpack,
/turf/unsimulated/floor/black,
/area/tutorial/newbee/room_11)
"fj" = (
/obj/machinery/light/incandescent,
/turf/unsimulated/floor/darkbluewhite,
/area/tutorial/newbee/room_7)
"fK" = (
/turf/unsimulated/wall/setpieces/leadwindow/full{
	dir = 4
	},
/area/tutorial/newbee)
"fP" = (
/obj/machinery/door/airlock/pyro/alt{
	dir = 4
	},
/obj/landmark/newbee/exit_healing,
/turf/unsimulated/floor/white,
/area/tutorial/newbee/room_6)
"gb" = (
/obj/machinery/door/airlock/pyro/alt,
/obj/landmark/newbee/exit_movement,
/turf/unsimulated/floor/black,
/area/tutorial/newbee/room_14)
"gi" = (
/turf/unsimulated/floor/bluewhite{
	dir = 6
	},
/area/tutorial/newbee/room_5)
"gj" = (
/obj/landmark/newbee/clown_murder,
/turf/unsimulated/floor/escape{
	dir = 1
	},
/area/tutorial/newbee/room_16)
"gl" = (
/obj/machinery/light/incandescent,
/turf/unsimulated/floor/red/side{
	dir = 10
	},
/area/tutorial/newbee/room_4)
"gp" = (
/obj/forcefield/energyshield/perma/doorlink{
	dir = 4
	},
/obj/machinery/door/airlock/pyro/external{
	dir = 4
	},
/obj/landmark/newbee/enter_space,
/turf/simulated/floor/bluegreen,
/area/tutorial/newbee/room_10)
"gx" = (
/obj/table/reinforced/auto,
/obj/landmark/newbee/pickup_id_card,
/turf/unsimulated/floor,
/area/tutorial/newbee/room_2)
"gL" = (
/turf/unsimulated/floor/black/corner,
/area/tutorial/newbee/room_2)
"gM" = (
/obj/landmark/newbee/mouse,
/turf/unsimulated/floor/red/side{
	dir = 6
	},
/area/tutorial/newbee/room_4)
"he" = (
/turf/unsimulated/wall/setpieces/leadwall/cap{
	dir = 4
	},
/area/tutorial/newbee)
"ho" = (
/turf/unsimulated/wall/setpieces/leadwindow/full,
/area/tutorial/newbee)
"hy" = (
/obj/decal/cleanable/blood/tracks,
/obj/structure/girder,
/turf/unsimulated/floor/plating,
/area/tutorial/newbee/room_8)
"hC" = (
/obj/health_scanner/floor,
/turf/unsimulated/floor/black,
/area/tutorial/newbee/room_11)
"il" = (
/turf/unsimulated/wall/setpieces/leadwall/junction{
	dir = 1
	},
/area/tutorial/newbee)
"in" = (
/obj/landmark/newbee/enter_maints,
/obj/machinery/door/airlock/pyro/maintenance{
	dir = 4
	},
/turf/unsimulated/floor/plating,
/area/tutorial/newbee/room_8)
"iv" = (
/obj/machinery/light/incandescent,
/turf/unsimulated/floor/darkpurpleblack{
	dir = 4
	},
/area/tutorial/newbee/room_12)
"iw" = (
/obj/landmark/newbee/decon_wall,
/turf/simulated/wall/auto/supernorn,
/area/tutorial/newbee/room_13)
"iC" = (
/obj/machinery/light/incandescent,
/turf/unsimulated/floor/purple/side{
	dir = 1
	},
/area/tutorial/newbee/room_3)
"iZ" = (
/turf/unsimulated/floor/orange/side{
	dir = 6
	},
/area/tutorial/newbee/room_4)
"jm" = (
/turf/unsimulated/floor/bluewhite{
	dir = 1
	},
/area/tutorial/newbee/room_5)
"jH" = (
/obj/decal/cleanable/dirt,
/turf/unsimulated/floor/plating,
/area/tutorial/newbee/room_8)
"jJ" = (
/turf/unsimulated/floor/darkbluewhite{
	dir = 1
	},
/area/tutorial/newbee/room_7)
"kq" = (
/turf/unsimulated/floor/darkpurpleblack{
	dir = 1
	},
/area/tutorial/newbee/room_12)
"kK" = (
/obj/item/scrapweapons/weapons/spear/glass,
/turf/unsimulated/floor,
/area/tutorial/newbee/room_16)
"kW" = (
/turf/unsimulated/floor/purple/side{
	dir = 9
	},
/area/tutorial/newbee/room_3)
"lc" = (
/obj/decal/poster/wallsign/space{
	pixel_x = -32
	},
/turf/simulated/floor/bluegreen/side{
	dir = 4
	},
/area/tutorial/newbee/room_9)
"ld" = (
/obj/decal/cleanable/dirt/dirt5,
/turf/unsimulated/floor/plating,
/area/tutorial/newbee/room_8)
"lI" = (
/obj/decal/cleanable/blood/tracks,
/turf/unsimulated/floor/plating,
/area/tutorial/newbee/room_8)
"me" = (
/obj/landmark/newbee/basic_movement,
/turf/unsimulated/floor,
/area/tutorial/newbee/room_1)
"mr" = (
/obj/machinery/light/incandescent,
/turf/unsimulated/floor/yellow/checker,
/area/tutorial/newbee/room_13)
"mS" = (
/obj/landmark/newbee/disarm_person,
/turf/unsimulated/floor/orange/side{
	dir = 5
	},
/area/tutorial/newbee/room_4)
"mZ" = (
/obj/strip_door,
/turf/unsimulated/floor/yellow/checker,
/area/tutorial/newbee/room_13)
"ne" = (
/turf/unsimulated/floor/purple/side{
	dir = 8
	},
/area/tutorial/newbee/room_3)
"nk" = (
/turf/unsimulated/floor/purple/side{
	dir = 6
	},
/area/tutorial/newbee/room_3)
"no" = (
/obj/machinery/light/runway_light/delay2,
/obj/lattice/directional_icons{
	dir = 9
	},
/turf/space,
/area/tutorial/newbee/room_10)
"nE" = (
/obj/machinery/light/incandescent,
/obj/landmark/newbee/sprinting,
/obj/item/bananapeel,
/turf/unsimulated/floor/yellow/checker,
/area/tutorial/newbee/room_13)
"nL" = (
/obj/machinery/light/incandescent,
/turf/unsimulated/floor/greenblack,
/area/tutorial/newbee/room_11)
"nV" = (
/turf/unsimulated/floor,
/area/tutorial/newbee/room_3)
"oc" = (
/turf/unsimulated/floor/purple/side{
	dir = 10
	},
/area/tutorial/newbee/room_3)
"oj" = (
/turf/unsimulated/floor/escape{
	dir = 1
	},
/area/tutorial/newbee/room_16)
"ol" = (
/obj/machinery/light/runway_light/delay2,
/obj/lattice/directional_icons{
	dir = 5
	},
/turf/space,
/area/tutorial/newbee/room_10)
"ou" = (
/turf/unsimulated/floor/green/side{
	dir = 10
	},
/area/tutorial/newbee/room_4)
"oB" = (
/turf/unsimulated/floor,
/area/tutorial/newbee/room_15)
"oK" = (
/obj/health_scanner/floor,
/turf/unsimulated/floor/blue,
/area/tutorial/newbee/room_5)
"oX" = (
/turf/simulated/floor/bluegreen/corner{
	dir = 8
	},
/area/tutorial/newbee/room_9)
"pd" = (
/obj/decal/cleanable/dirt/dirt4,
/turf/unsimulated/floor/plating,
/area/tutorial/newbee/room_8)
"pe" = (
/obj/mapping_helper/wingrille_spawn/auto/reinforced,
/turf/unsimulated/floor/plating,
/area/tutorial/newbee/room_11)
"po" = (
/obj/machinery/light/small/floor/warm/very,
/turf/unsimulated/floor/black/grime,
/area/tutorial/newbee/room_16)
"pO" = (
/turf/unsimulated/wall/setpieces/leadwall/junction_four,
/area/tutorial/newbee)
"pU" = (
/turf/unsimulated/floor/arrival{
	dir = 9
	},
/area/tutorial/newbee/room_1)
"qa" = (
/turf/unsimulated/floor/black/grime,
/area/tutorial/newbee/room_16)
"qf" = (
/turf/unsimulated/floor/arrival,
/area/tutorial/newbee/room_1)
"qj" = (
/turf/unsimulated/floor/blackwhite{
	dir = 4
	},
/area/tutorial/newbee/room_6)
"qn" = (
/obj/machinery/light/incandescent,
/turf/unsimulated/floor/bluewhite{
	dir = 8
	},
/area/tutorial/newbee/room_5)
"qp" = (
/turf/unsimulated/floor/black,
/area/tutorial/newbee/room_12)
"qO" = (
/turf/unsimulated/floor/escape{
	dir = 5
	},
/area/tutorial/newbee/room_16)
"ry" = (
/obj/landmark/newbee/emergency_supply_closet,
/turf/simulated/floor/bluegreen,
/area/tutorial/newbee/room_9)
"so" = (
/turf/unsimulated/floor/yellow/checker,
/area/tutorial/newbee/room_13)
"sJ" = (
/turf/unsimulated/floor/darkbluewhite{
	dir = 4
	},
/area/tutorial/newbee/room_7)
"tv" = (
/turf/unsimulated/floor/black,
/area/tutorial/newbee/room_11)
"tI" = (
/turf/unsimulated/floor,
/area/tutorial/newbee/room_1)
"tL" = (
/obj/machinery/light/incandescent,
/turf/unsimulated/floor/green/side{
	dir = 5
	},
/area/tutorial/newbee/room_4)
"tY" = (
/turf/unsimulated/floor/darkpurpleblack{
	dir = 4
	},
/area/tutorial/newbee/room_12)
"ue" = (
/turf/unsimulated/floor,
/area/tutorial/newbee/room_2)
"uk" = (
/turf/unsimulated/floor/darkpurpleblack{
	dir = 10
	},
/area/tutorial/newbee/room_12)
"um" = (
/obj/machinery/light/incandescent,
/obj/item/gun/energy/phaser_gun{
	pixel_x = -3;
	pixel_y = 2
	},
/turf/unsimulated/floor/grey/blackgrime/other,
/area/tutorial/newbee/room_13)
"ux" = (
/turf/unsimulated/floor/bluewhite{
	dir = 8
	},
/area/tutorial/newbee/room_5)
"uG" = (
/turf/unsimulated/floor/blackwhite{
	dir = 9
	},
/area/tutorial/newbee/room_6)
"uL" = (
/turf/unsimulated/floor/orange/side{
	dir = 10
	},
/area/tutorial/newbee/room_4)
"uT" = (
/obj/machinery/light/incandescent,
/turf/unsimulated/floor/yellow/side{
	dir = 6
	},
/area/tutorial/newbee/room_4)
"vb" = (
/turf/unsimulated/floor/purple/side{
	dir = 5
	},
/area/tutorial/newbee/room_3)
"vh" = (
/turf/unsimulated/floor/escape{
	dir = 8
	},
/area/tutorial/newbee/room_16)
"vi" = (
/turf/unsimulated/wall/setpieces/leadwall/cap{
	dir = 8
	},
/area/tutorial/newbee)
"vA" = (
/turf/simulated/floor/bluegreen/corner{
	dir = 4
	},
/area/tutorial/newbee/room_9)
"vG" = (
/obj/decal/cleanable/blood/tracks,
/obj/decal/cleanable/blood/splatter/extra,
/obj/mapping_helper/mob_spawn/corpse/human/random/webbed/clown,
/turf/unsimulated/floor/plating,
/area/tutorial/newbee/room_8)
"vS" = (
/turf/unsimulated/floor/blackwhite{
	dir = 5
	},
/area/tutorial/newbee/room_6)
"wn" = (
/obj/decal/poster/wallsign/space{
	pixel_x = 32
	},
/turf/unsimulated/floor/greenblack{
	dir = 4
	},
/area/tutorial/newbee/room_11)
"wr" = (
/turf/unsimulated/floor/purple/side{
	dir = 1
	},
/area/tutorial/newbee/room_3)
"wt" = (
/turf/unsimulated/floor/arrival{
	dir = 10
	},
/area/tutorial/newbee/room_1)
"wD" = (
/turf/unsimulated/wall/setpieces/leadwall{
	dir = 10
	},
/area/tutorial/newbee)
"wE" = (
/turf/simulated/floor/bluegreen/side{
	dir = 1
	},
/area/tutorial/newbee/room_9)
"wI" = (
/turf/unsimulated/wall/setpieces/leadwall{
	dir = 5
	},
/area/tutorial/newbee)
"wN" = (
/obj/machinery/light/incandescent,
/turf/unsimulated/floor/escape{
	dir = 8
	},
/area/tutorial/newbee/room_16)
"wY" = (
/obj/machinery/light/incandescent,
/turf/unsimulated/floor/purple/side,
/area/tutorial/newbee/room_3)
"xc" = (
/obj/structure/girder,
/obj/landmark/newbee/decon_girder,
/turf/unsimulated/floor/white,
/area/tutorial/newbee/room_7)
"xX" = (
/obj/forcefield/energyshield/perma/doorlink{
	dir = 4
	},
/obj/machinery/door/airlock/pyro/external{
	dir = 4
	},
/obj/landmark/newbee/traverse_space,
/turf/unsimulated/floor/black,
/area/tutorial/newbee/room_11)
"yJ" = (
/turf/simulated/floor/bluegreen/corner{
	dir = 1
	},
/area/tutorial/newbee/room_9)
"zd" = (
/obj/machinery/light/incandescent,
/turf/unsimulated/floor/blackwhite{
	dir = 4
	},
/area/tutorial/newbee/room_6)
"zp" = (
/obj/decoration/damagedchair{
	dir = 8
	},
/obj/item/clipboard/with_pen{
	pixel_y = 7;
	pixel_x = -6
	},
/turf/unsimulated/floor/black/grime,
/area/tutorial/newbee/room_16)
"zE" = (
/turf/unsimulated/floor/white,
/area/tutorial/newbee/room_5)
"zN" = (
/turf/unsimulated/floor/darkblueblack{
	dir = 10
	},
/area/tutorial/newbee/room_13)
"zY" = (
/obj/landmark/newbee/laying_down,
/turf/unsimulated/floor/yellow/checker,
/area/tutorial/newbee/room_13)
"AI" = (
/obj/table/reinforced/auto,
/obj/landmark/newbee/pickup_headset,
/turf/unsimulated/floor/darkblue/checker/other,
/area/tutorial/newbee/room_14)
"AK" = (
/obj/decal/cleanable/dirt/dirt5,
/obj/decal/cleanable/blood/tracks{
	dir = 6
	},
/turf/unsimulated/floor/plating,
/area/tutorial/newbee/room_8)
"AS" = (
/turf/unsimulated/floor/darkpurpleblack{
	dir = 6
	},
/area/tutorial/newbee/room_12)
"Bd" = (
/turf/unsimulated/wall/setpieces/leadwall/cap{
	dir = 1
	},
/area/tutorial/newbee)
"Bv" = (
/obj/decal/cleanable/dirt/dirt3,
/turf/unsimulated/floor/plating,
/area/tutorial/newbee/room_8)
"Bw" = (
/obj/landmark/newbee/idlock_doors,
/obj/machinery/door/airlock/pyro/engineering/alt{
	dir = 4
	},
/obj/mapping_helper/access/engineering_power,
/turf/unsimulated/floor,
/area/tutorial/newbee/room_3)
"BB" = (
/obj/strip_door{
	dir = 4
	},
/turf/unsimulated/floor/yellow/checker,
/area/tutorial/newbee/room_13)
"BP" = (
/turf/unsimulated/floor/blackwhite{
	dir = 6
	},
/area/tutorial/newbee/room_6)
"BY" = (
/obj/machinery/light/incandescent,
/turf/unsimulated/floor/arrival{
	dir = 1
	},
/area/tutorial/newbee/room_1)
"Ck" = (
/obj/machinery/light/incandescent,
/turf/unsimulated/floor/blackwhite{
	dir = 8
	},
/area/tutorial/newbee/room_6)
"Cs" = (
/obj/machinery/light/incandescent,
/turf/unsimulated/floor/orange/side{
	dir = 9
	},
/area/tutorial/newbee/room_4)
"CW" = (
/turf/unsimulated/floor/yellow/side{
	dir = 5
	},
/area/tutorial/newbee/room_4)
"DB" = (
/turf/simulated/wall/false_wall/centcom{
	dir = 8
	},
/area/tutorial/newbee/room_13)
"DI" = (
/turf/unsimulated/floor/arrival{
	dir = 4
	},
/area/tutorial/newbee/room_1)
"DQ" = (
/turf/unsimulated/floor/purple/side{
	dir = 4
	},
/area/tutorial/newbee/room_3)
"Ec" = (
/obj/item/scrapweapons/weapons/dagger,
/turf/unsimulated/floor,
/area/tutorial/newbee/room_16)
"Ei" = (
/turf/unsimulated/floor/white,
/area/tutorial/newbee/room_7)
"Ek" = (
/turf/unsimulated/floor/darkpurpleblack{
	dir = 9
	},
/area/tutorial/newbee/room_12)
"Ev" = (
/turf/unsimulated/floor/black/side{
	dir = 4
	},
/area/tutorial/newbee/room_2)
"EA" = (
/turf/unsimulated/floor/green/side{
	dir = 6
	},
/area/tutorial/newbee/room_4)
"EE" = (
/turf/unsimulated/floor/darkbluewhite{
	dir = 9
	},
/area/tutorial/newbee/room_7)
"Ff" = (
/obj/landmark/newbee/unpowered_doors,
/obj/machinery/door/airlock/pyro/classic{
	dir = 4;
	panel_open = 1
	},
/turf/unsimulated/floor,
/area/tutorial/newbee/unpowered)
"Fw" = (
/turf/unsimulated/floor/arrival{
	dir = 5
	},
/area/tutorial/newbee/room_1)
"FM" = (
/turf/unsimulated/floor/arrival{
	dir = 6
	},
/area/tutorial/newbee/room_1)
"Gf" = (
/obj/machinery/light/incandescent,
/turf/unsimulated/floor/darkbluewhite{
	dir = 1
	},
/area/tutorial/newbee/room_7)
"Gz" = (
/obj/table/reinforced/auto,
/obj/landmark/newbee/pickup_first_aid,
/turf/unsimulated/floor/bluewhite{
	dir = 1
	},
/area/tutorial/newbee/room_5)
"GU" = (
/obj/machinery/light/runway_light/delay4,
/obj/lattice/directional_icons{
	dir = 5
	},
/turf/space,
/area/tutorial/newbee/room_10)
"GV" = (
/turf/unsimulated/wall/setpieces/leadwall/junction{
	dir = 4
	},
/area/tutorial/newbee)
"Hb" = (
/turf/unsimulated/floor/bluewhite{
	dir = 10
	},
/area/tutorial/newbee/room_5)
"Hd" = (
/turf/simulated/floor/bluegreen/side{
	dir = 8
	},
/area/tutorial/newbee/room_9)
"HV" = (
/turf/space,
/area/tutorial/newbee/room_10)
"Ir" = (
/obj/machinery/door/airlock/pyro/alt,
/obj/landmark/newbee/final_room,
/turf/unsimulated/floor,
/area/tutorial/newbee/room_16)
"Iw" = (
/turf/unsimulated/floor/greenblack{
	dir = 9
	},
/area/tutorial/newbee/room_11)
"IJ" = (
/obj/item/bat,
/turf/unsimulated/floor,
/area/tutorial/newbee/room_16)
"IK" = (
/turf/unsimulated/floor/bluewhite{
	dir = 5
	},
/area/tutorial/newbee/room_5)
"IY" = (
/turf/unsimulated/floor/red/side{
	dir = 9
	},
/area/tutorial/newbee/room_4)
"Jd" = (
/turf/unsimulated/floor/bluewhite{
	dir = 4
	},
/area/tutorial/newbee/room_5)
"Jv" = (
/turf/unsimulated/floor,
/area/tutorial/newbee/room_16)
"JH" = (
/obj/machinery/light/small/floor/warm/very,
/obj/item/clothing/under/rank/geneticist{
	pixel_y = 3;
	pixel_x = -8
	},
/obj/item/clothing/suit/labcoat/genetics{
	pixel_x = 5;
	pixel_y = -6
	},
/turf/unsimulated/floor/honeyblocks,
/area/tutorial/newbee/room_16)
"JS" = (
/turf/unsimulated/wall/setpieces/leadwall{
	dir = 9
	},
/area/tutorial/newbee)
"Kk" = (
/turf/unsimulated/floor/red/side{
	dir = 5
	},
/area/tutorial/newbee/room_4)
"Kn" = (
/obj/landmark/newbee/traverse_maints,
/obj/machinery/door/airlock/pyro/maintenance,
/turf/unsimulated/floor/plating,
/area/tutorial/newbee/room_9)
"Kz" = (
/obj/fakeobject/teleport_pad,
/obj/landmark/tutorial_start,
/turf/unsimulated/floor,
/area/tutorial/newbee/room_1)
"KK" = (
/obj/machinery/light/incandescent,
/obj/item/gun/energy/tasershotgun{
	pixel_x = 17
	},
/turf/unsimulated/floor/redblack,
/area/tutorial/newbee/room_13)
"KP" = (
/obj/landmark/newbee/help_person,
/turf/unsimulated/floor/green/side{
	dir = 9
	},
/area/tutorial/newbee/room_4)
"Lr" = (
/obj/table/reinforced/auto,
/obj/landmark/newbee/pickup_weldingtool,
/turf/unsimulated/floor/black,
/area/tutorial/newbee/room_12)
"Lt" = (
/turf/unsimulated/floor/black/corner{
	dir = 4
	},
/area/tutorial/newbee/room_2)
"Ly" = (
/turf/unsimulated/floor,
/area/tutorial/newbee/room_4)
"LB" = (
/obj/machinery/light/incandescent,
/turf/unsimulated/floor/darkpurpleblack{
	dir = 8
	},
/area/tutorial/newbee/room_12)
"LQ" = (
/turf/unsimulated/floor/escape{
	dir = 6
	},
/area/tutorial/newbee/room_16)
"LX" = (
/turf/simulated/wall/auto/supernorn,
/area/tutorial/newbee/room_16)
"Ma" = (
/turf/unsimulated/wall/setpieces/leadwall{
	dir = 8
	},
/area/tutorial/newbee)
"Mh" = (
/turf/simulated/floor/bluegreen/corner,
/area/tutorial/newbee/room_9)
"Mr" = (
/obj/machinery/light/incandescent,
/turf/unsimulated/floor/darkblue/checker/other,
/area/tutorial/newbee/room_14)
"MB" = (
/obj/machinery/door/airlock/pyro/alt,
/obj/landmark/newbee/get_health,
/turf/unsimulated/floor/white/side,
/area/tutorial/newbee/room_5)
"MD" = (
/obj/machinery/light/incandescent,
/turf/simulated/floor/bluegreen/side,
/area/tutorial/newbee/room_9)
"MY" = (
/turf/simulated/wall/false_wall/centcom,
/area/tutorial/newbee/room_13)
"Nr" = (
/obj/machinery/light/incandescent,
/turf/unsimulated/floor/escape{
	dir = 4
	},
/area/tutorial/newbee/room_16)
"Nu" = (
/turf/unsimulated/floor/darkbluewhite{
	dir = 10
	},
/area/tutorial/newbee/room_7)
"Nz" = (
/obj/table/reinforced/auto,
/obj/landmark/newbee/pickup_flashlight,
/turf/unsimulated/floor/white,
/area/tutorial/newbee/room_7)
"NL" = (
/turf/unsimulated/floor/purple/side,
/area/tutorial/newbee/room_3)
"NN" = (
/turf/unsimulated/floor/greenblack{
	dir = 8
	},
/area/tutorial/newbee/room_11)
"NO" = (
/turf/cordon,
/area/space)
"NP" = (
/obj/machinery/crusher/slow/tutorial,
/turf/unsimulated/floor/grey/blackgrime/other,
/area/tutorial/newbee/room_13)
"Oa" = (
/turf/unsimulated/floor/darkblue/checker/other,
/area/tutorial/newbee/room_14)
"OP" = (
/turf/unsimulated/floor/greenblack{
	dir = 10
	},
/area/tutorial/newbee/room_11)
"PV" = (
/turf/unsimulated/wall/setpieces/leadwall{
	dir = 6
	},
/area/tutorial/newbee)
"Qb" = (
/obj/machinery/door/airlock/pyro/alt{
	dir = 4
	},
/obj/landmark/newbee/powered_doors,
/turf/unsimulated/floor,
/area/tutorial/newbee/room_2)
"Qq" = (
/obj/machinery/light/runway_light/delay4,
/obj/lattice/directional_icons{
	dir = 9
	},
/turf/space,
/area/tutorial/newbee/room_10)
"QM" = (
/turf/unsimulated/floor/black/side{
	dir = 8
	},
/area/tutorial/newbee/room_2)
"Rd" = (
/turf/unsimulated/floor/bluewhite,
/area/tutorial/newbee/room_5)
"Rz" = (
/obj/machinery/light/small/floor/warm/very,
/turf/unsimulated/floor/plating,
/area/tutorial/newbee/room_8)
"RA" = (
/obj/machinery/door/airlock/pyro/alt,
/obj/landmark/newbee/exit_storage,
/turf/unsimulated/floor,
/area/tutorial/newbee/room_12)
"RG" = (
/obj/critter/domestic_bee{
	pixel_y = 6;
	pixel_x = -19
	},
/obj/item/reagent_containers/food/snacks/ingredient/egg/bee{
	pixel_x = -4
	},
/obj/item/reagent_containers/food/snacks/ingredient/egg/bee/buddy{
	pixel_y = 16;
	pixel_x = 8
	},
/turf/unsimulated/floor/honeyblocks,
/area/tutorial/newbee/room_16)
"Sq" = (
/turf/unsimulated/floor/black/side,
/area/tutorial/newbee/room_2)
"SE" = (
/obj/machinery/light/incandescent,
/obj/item/swords_sheaths/captain/blue{
	pixel_x = -14
	},
/turf/unsimulated/floor/darkblueblack,
/area/tutorial/newbee/room_13)
"Tm" = (
/obj/table/reinforced/auto,
/obj/landmark/newbee/pickup_welding_mask,
/turf/unsimulated/floor/black,
/area/tutorial/newbee/room_12)
"Tp" = (
/turf/unsimulated/floor/arrival{
	dir = 8
	},
/area/tutorial/newbee/room_1)
"Tz" = (
/turf/unsimulated/floor/darkbluewhite{
	dir = 8
	},
/area/tutorial/newbee/room_7)
"TD" = (
/obj/machinery/light/incandescent,
/turf/unsimulated/floor/black/side,
/area/tutorial/newbee/room_2)
"TN" = (
/turf/unsimulated/floor/plating,
/area/tutorial/newbee/room_8)
"Ud" = (
/obj/landmark/newbee/water_tank,
/turf/unsimulated/floor,
/area/tutorial/newbee/room_15)
"Ui" = (
/turf/unsimulated/floor/blackwhite,
/area/tutorial/newbee/room_6)
"Uk" = (
/turf/unsimulated/floor/white,
/area/tutorial/newbee/room_6)
"Ul" = (
/obj/table/reinforced/auto,
/obj/landmark/newbee/pickup_crowbar,
/turf/unsimulated/floor,
/area/tutorial/newbee/room_3)
"UE" = (
/obj/machinery/conveyor/area_activated{
	dir = 1;
	move_lag = 1.5
	},
/turf/unsimulated/floor/yellow/checker,
/area/tutorial/newbee/room_13)
"UX" = (
/turf/unsimulated/floor/greenblack{
	dir = 6
	},
/area/tutorial/newbee/room_11)
"Va" = (
/obj/machinery/door/airlock/pyro/glass/engineering,
/obj/machinery/door/airlock/pyro/glass/command,
/obj/mapping_helper/access/heads,
/turf/unsimulated/floor/black,
/area/tutorial/newbee/room_13)
"Ve" = (
/obj/landmark/newbee/grab_person,
/turf/unsimulated/floor/yellow/side{
	dir = 10
	},
/area/tutorial/newbee/room_4)
"Vh" = (
/turf/unsimulated/floor/redblack{
	dir = 6
	},
/area/tutorial/newbee/room_13)
"VV" = (
/turf/unsimulated/floor/yellow/side{
	dir = 9
	},
/area/tutorial/newbee/room_4)
"Wh" = (
/obj/machinery/light/incandescent,
/turf/unsimulated/floor,
/area/tutorial/newbee/room_15)
"Wy" = (
/turf/unsimulated/floor/escape{
	dir = 9
	},
/area/tutorial/newbee/room_16)
"WC" = (
/obj/machinery/door/airlock/pyro/glass/security{
	dir = 1
	},
/obj/mapping_helper/access/security,
/turf/unsimulated/floor/black,
/area/tutorial/newbee/room_13)
"WF" = (
/turf/unsimulated/floor/greenblack{
	dir = 5
	},
/area/tutorial/newbee/room_11)
"Xs" = (
/turf/unsimulated/floor/darkpurpleblack,
/area/tutorial/newbee/room_12)
"Xu" = (
/obj/machinery/light/incandescent,
/turf/unsimulated/floor/arrival,
/area/tutorial/newbee/room_1)
"XV" = (
/turf/unsimulated/wall/setpieces/leadwall/cap,
/area/tutorial/newbee)
"Yk" = (
/obj/machinery/light/incandescent,
/turf/unsimulated/floor/bluewhite{
	dir = 4
	},
/area/tutorial/newbee/room_5)
"Yl" = (
/turf/unsimulated/floor/escape,
/area/tutorial/newbee/room_16)
"Yq" = (
/obj/machinery/door/airlock/pyro/alt{
	dir = 4
	},
/obj/landmark/newbee/exit_radio,
/turf/unsimulated/floor/blue/side{
	dir = 4
	},
/area/tutorial/newbee/room_15)
"Yy" = (
/obj/machinery/light/incandescent,
/turf/unsimulated/floor/greenblack{
	dir = 1
	},
/area/tutorial/newbee/room_11)
"YH" = (
/obj/decal/cleanable/dirt/dirt2,
/turf/unsimulated/floor/plating,
/area/tutorial/newbee/room_8)
"YZ" = (
/obj/landmark/newbee/pull_target,
/turf/unsimulated/floor/darkblue/checker/other,
/area/tutorial/newbee/room_14)
"ZG" = (
/turf/unsimulated/floor/honeyblocks/border{
	dir = 4
	},
/area/tutorial/newbee/room_16)
"ZL" = (
/turf/unsimulated/floor/escape{
	dir = 4
	},
/area/tutorial/newbee/room_16)
"ZN" = (
/turf/unsimulated/floor/darkbluewhite{
	dir = 5
	},
/area/tutorial/newbee/room_7)
"ZP" = (
/turf/simulated/floor/bluegreen,
/area/tutorial/newbee/room_9)
"ZZ" = (
/turf/unsimulated/wall/setpieces/leadwall/junction,
/area/tutorial/newbee)

(1,1,1) = {"
NO
NO
NO
NO
NO
NO
NO
NO
NO
NO
NO
NO
NO
NO
NO
NO
NO
NO
NO
NO
NO
"}
(2,1,1) = {"
NO
JS
dK
dK
dK
dK
dK
GV
dK
dK
dK
dK
dK
GV
dK
dK
dK
dK
dK
wD
NO
"}
(3,1,1) = {"
NO
Ma
pU
Tp
Tp
Tp
wt
Ma
Wy
wN
vh
wN
aQ
LX
qa
qa
zp
qa
po
Ma
NO
"}
(4,1,1) = {"
NO
Ma
BY
tI
Kz
tI
Xu
Ma
oj
Ec
Jv
Jv
Yl
ZZ
dK
ho
dK
wD
qa
Ma
NO
"}
(5,1,1) = {"
NO
Ma
dR
tI
tI
tI
qf
Ma
gj
Jv
kK
Jv
Jv
Ir
Wh
oB
Ud
Ma
ZG
Ma
NO
"}
(6,1,1) = {"
NO
Ma
BY
tI
me
tI
Xu
Ma
oj
IJ
Jv
Jv
Yl
ZZ
dK
wD
oB
Ma
RG
Ma
NO
"}
(7,1,1) = {"
NO
Ma
Fw
DI
tI
DI
FM
Ma
qO
Nr
ZL
Nr
LQ
Ma
bW
Ma
Wh
Ma
JH
Ma
NO
"}
(8,1,1) = {"
NO
ZZ
dK
dK
Qb
GV
dK
pO
dK
dK
dK
dK
dK
pO
dK
aK
Yq
aK
dK
il
NO
"}
(9,1,1) = {"
NO
Ma
gL
Ev
ue
Ma
zN
Ma
mr
UE
UE
UE
nE
Ma
Mr
Oa
Oa
Oa
Mr
Ma
NO
"}
(10,1,1) = {"
NO
Ma
TD
ue
ue
Va
SE
Ma
zY
Bd
ho
wD
so
Ma
Oa
Oa
Oa
Oa
Oa
Ma
NO
"}
(11,1,1) = {"
NO
Ma
Sq
gx
ue
ZZ
MY
il
so
mZ
so
Ma
so
gb
Oa
Oa
Oa
AI
Oa
Ma
NO
"}
(12,1,1) = {"
NO
Ma
TD
ue
ue
WC
KK
ZZ
cE
wD
BB
Ma
BB
Ma
Oa
Oa
YZ
Oa
Oa
Ma
NO
"}
(13,1,1) = {"
NO
Ma
Lt
QM
ue
Ma
Vh
DB
um
ee
so
fK
NP
Ma
Mr
Oa
Oa
Oa
Mr
Ma
NO
"}
(14,1,1) = {"
NO
ZZ
dK
dK
Bw
aK
dK
pO
dK
aK
iw
aK
dK
pO
dK
dK
dK
dK
dK
il
NO
"}
(15,1,1) = {"
NO
Ma
kW
ne
nV
ne
oc
Ma
Ek
LB
qp
LB
uk
Ma
Iw
NN
NN
NN
OP
Ma
NO
"}
(16,1,1) = {"
NO
Ma
iC
nV
nV
nV
wY
Ma
kq
Tm
qp
qp
Xs
Ma
Yy
tv
fe
tv
nL
Ma
NO
"}
(17,1,1) = {"
NO
Ma
wr
nV
nV
Ul
NL
Ma
kq
Lr
qp
qp
Xs
RA
tv
tv
tv
hC
aJ
Ma
NO
"}
(18,1,1) = {"
NO
Ma
iC
nV
nV
nV
wY
Ma
kq
bN
qp
qp
Xs
Ma
Yy
tv
tv
tv
nL
Ma
NO
"}
(19,1,1) = {"
NO
Ma
vb
DQ
nV
DQ
nk
Ma
bh
iv
tY
iv
AS
Ma
WF
wn
tv
wn
UX
Ma
NO
"}
(20,1,1) = {"
NO
ZZ
dK
dK
Ff
dK
dK
pO
dK
dK
dK
dK
dK
pO
pe
pe
xX
pe
pe
il
NO
"}
(21,1,1) = {"
NO
Ma
KP
ou
Ly
VV
Ve
Ma
ah
qn
ux
qn
Hb
Ma
GU
HV
HV
HV
ol
Ma
NO
"}
(22,1,1) = {"
NO
Ma
tL
EA
Ly
CW
uT
Ma
jm
zE
Jd
zE
Rd
Ma
HV
HV
HV
HV
HV
Ma
NO
"}
(23,1,1) = {"
NO
Ma
Ly
Ly
Ly
Ly
Ly
MB
zE
Rd
oK
Gz
Rd
Ma
HV
HV
HV
HV
HV
Ma
NO
"}
(24,1,1) = {"
NO
Ma
Cs
uL
Ly
IY
gl
Ma
jm
zE
ux
zE
Rd
Ma
HV
HV
HV
HV
HV
Ma
NO
"}
(25,1,1) = {"
NO
Ma
mS
iZ
Ly
Kk
gM
Ma
IK
Yk
zE
Yk
gi
Ma
HV
HV
HV
HV
HV
Ma
NO
"}
(26,1,1) = {"
NO
ZZ
dK
dK
dK
dK
dK
pO
dK
dK
fP
dK
dK
il
HV
HV
HV
HV
HV
Ma
NO
"}
(27,1,1) = {"
NO
Ma
EE
Tz
Tz
Tz
Nu
Ma
uG
Ck
Uk
Ck
bj
Ma
HV
HV
HV
HV
HV
Ma
NO
"}
(28,1,1) = {"
NO
Ma
jJ
Ei
Ei
Ei
fj
Ma
br
Uk
Uk
Uk
Ui
Ma
HV
HV
HV
HV
HV
Ma
NO
"}
(29,1,1) = {"
NO
Ma
Gf
Nz
Ei
Ei
Ei
xc
Uk
Uk
Uk
Uk
Ui
Ma
HV
HV
HV
HV
HV
Ma
NO
"}
(30,1,1) = {"
NO
Ma
jJ
Ei
Ei
Ei
fj
Ma
br
Uk
af
Uk
Ui
Ma
HV
HV
HV
HV
HV
Ma
NO
"}
(31,1,1) = {"
NO
Ma
ZN
sJ
Ei
sJ
bp
Ma
vS
zd
qj
zd
BP
Ma
HV
HV
HV
HV
HV
Ma
NO
"}
(32,1,1) = {"
NO
ZZ
dK
dK
in
GV
dK
aK
dK
dK
dK
dK
dK
il
no
HV
HV
HV
Qq
Ma
NO
"}
(33,1,1) = {"
NO
Ma
TN
ld
TN
Ma
Bv
TN
jH
TN
TN
pd
TN
ZZ
eo
eo
gp
eo
eo
il
NO
"}
(34,1,1) = {"
NO
Ma
jH
Rz
pd
Ma
TN
TN
vi
TN
Bv
TN
TN
Ma
Mh
lc
ZP
lc
vA
Ma
NO
"}
(35,1,1) = {"
NO
Ma
TN
Bd
dK
PV
TN
TN
Ma
TN
JS
dK
dK
il
MD
ZP
ZP
ZP
dF
Ma
NO
"}
(36,1,1) = {"
NO
Ma
TN
jH
TN
TN
YH
TN
Ma
TN
Ma
TN
TN
Kn
ZP
ZP
ZP
ry
wE
Ma
NO
"}
(37,1,1) = {"
NO
ZZ
dK
dK
dK
dK
XV
cT
Ma
TN
he
TN
TN
Ma
MD
ZP
ZP
ZP
dF
Ma
NO
"}
(38,1,1) = {"
NO
Ma
ek
vG
lI
lI
hy
AK
Ma
Bv
TN
TN
ld
Ma
oX
Hd
Hd
Hd
yJ
Ma
NO
"}
(39,1,1) = {"
NO
wI
dK
dK
dK
dK
dK
dK
aK
dK
dK
dK
dK
aK
dK
dK
dK
dK
dK
PV
NO
"}
(40,1,1) = {"
NO
NO
NO
NO
NO
NO
NO
NO
NO
NO
NO
NO
NO
NO
NO
NO
NO
NO
NO
NO
NO
"}
