//MAP CONVERTED BY dmm2tgm.py THIS HEADER COMMENT PREVENTS RECONVERSION, DO NOT REMOVE
"gf" = (
/obj/machinery/door/airlock/pyro/external,
/turf/unsimulated/floor/shuttle{
	dir = 8
	},
/area/shuttle/escape/centcom)
"iN" = (
/obj/stool/chair/comfy/shuttle{
	dir = 4
	},
/obj/machinery/drainage,
/turf/unsimulated/floor/shuttle{
	dir = 8
	},
/area/shuttle/escape/centcom)
"kz" = (
/obj/indestructible/shuttle_corner{
	dir = 8
	},
/turf/unsimulated/outdoors/grass,
/area/shuttle/escape/centcom)
"kA" = (
/obj/indestructible/shuttle_corner{
	dir = 1
	},
/turf/unsimulated/outdoors/grass,
/area/shuttle/escape/centcom)
"sx" = (
/obj/stool/chair/comfy/shuttle{
	dir = 4
	},
/obj/machinery/light/small/floor,
/turf/unsimulated/floor/shuttle{
	dir = 8
	},
/area/shuttle/escape/centcom)
"tv" = (
/obj/wingrille_spawn/auto,
/obj/machinery/shuttle/engine/heater{
	dir = 8;
	icon_state = "alt_heater-R"
	},
/turf/unsimulated/floor/plating,
/area/shuttle/escape/centcom)
"ur" = (
/obj/machinery/door/airlock/pyro/security{
	name = "Secure Transport";
	opacity = 0
	},
/turf/unsimulated/floor/shuttle{
	dir = 8
	},
/area/shuttle/escape/centcom)
"xl" = (
/obj/stool/chair/comfy/shuttle/red{
	dir = 4
	},
/obj/machinery/drainage,
/turf/unsimulated/floor/shuttle{
	dir = 8
	},
/area/shuttle/escape/centcom)
"xL" = (
/obj/indestructible/shuttle_corner{
	dir = 4
	},
/turf/unsimulated/outdoors/grass,
/area/shuttle/escape/centcom)
"xY" = (
/obj/machinery/sleeper/compact{
	dir = 8
	},
/obj/machinery/light/small/floor,
/turf/unsimulated/floor/shuttle{
	dir = 8
	},
/area/shuttle/escape/centcom)
"zK" = (
/obj/indestructible/shuttle_corner{
	dir = 0
	},
/turf/space/fluid,
/area/shuttle/escape/centcom)
"Aa" = (
/obj/machinery/door/airlock/pyro/command{
	opacity = 0
	},
/turf/unsimulated/floor/shuttle{
	dir = 8
	},
/area/shuttle/escape/centcom)
"Jz" = (
/obj/wingrille_spawn/auto,
/obj/machinery/shuttle/engine/heater{
	dir = 8;
	icon_state = "alt_heater-R"
	},
/obj/machinery/shuttle/engine/heater{
	dir = 8;
	icon_state = "alt_heater"
	},
/turf/unsimulated/floor/plating,
/area/shuttle/escape/centcom)
"LM" = (
/obj/indestructible/shuttle_corner{
	dir = 0
	},
/turf/unsimulated/outdoors/grass,
/area/shuttle/escape/centcom)
"Mk" = (
/obj/stool/chair/comfy/shuttle/brown{
	dir = 4
	},
/obj/machinery/drainage,
/turf/unsimulated/floor/shuttle{
	dir = 8
	},
/area/shuttle/escape/centcom)
"RJ" = (
/obj/stool/chair/comfy/shuttle/red{
	dir = 4
	},
/obj/machinery/light/small/floor,
/turf/unsimulated/floor/shuttle{
	dir = 8
	},
/area/shuttle/escape/centcom)
"SP" = (
/obj/machinery/door/airlock/pyro/medical{
	name = "First-Aid Station";
	opacity = 0
	},
/turf/unsimulated/floor/shuttle{
	dir = 8
	},
/area/shuttle/escape/centcom)
"Ug" = (
/turf/simulated/wall/auto/shuttle{
	icon_state = "12"
	},
/area/shuttle/escape/centcom)
"We" = (
/turf/unsimulated/outdoors/grass,
/area/centcom/outside)
"WT" = (
/obj/machinery/shuttle/engine/propulsion{
	dir = 8;
	icon_state = "alt_propulsion"
	},
/turf/unsimulated/outdoors/grass,
/area/shuttle/escape/centcom)
"Xb" = (
/obj/machinery/computer/shuttle/embedded/east,
/obj/stool/chair/comfy/shuttle/pilot{
	dir = 4
	},
/obj/machinery/light/small/floor,
/turf/unsimulated/floor/shuttle{
	dir = 8
	},
/area/shuttle/escape/centcom)
"YK" = (
/obj/wingrille_spawn/auto,
/turf/unsimulated/floor/shuttle{
	dir = 8
	},
/area/shuttle/escape/centcom)

(1,1,1) = {"
We
We
We
We
We
We
We
We
We
WT
We
We
We
We
We
"}
(2,1,1) = {"
We
We
WT
We
We
We
We
We
LM
tv
xL
We
We
WT
We
"}
(3,1,1) = {"
We
LM
Jz
xL
We
We
We
We
gf
iN
gf
We
LM
Jz
xL
"}
(4,1,1) = {"
We
SP
iN
SP
We
We
We
We
Ug
sx
Ug
We
ur
xl
ur
"}
(5,1,1) = {"
We
Ug
xY
Ug
We
We
We
We
kA
YK
kz
We
Ug
RJ
Ug
"}
(6,1,1) = {"
We
kA
YK
kz
We
We
WT
We
We
We
We
We
kA
YK
kz
"}
(7,1,1) = {"
We
We
We
We
We
LM
Jz
xL
We
We
We
We
We
We
We
"}
(8,1,1) = {"
We
We
We
We
We
Aa
Mk
Aa
We
We
We
We
We
We
We
"}
(9,1,1) = {"
We
We
We
We
We
Ug
Xb
Ug
We
We
We
We
We
We
We
"}
(10,1,1) = {"
We
We
We
We
We
kA
YK
kz
We
We
We
We
We
We
We
"}
(11,1,1) = {"
We
WT
We
We
We
We
We
We
We
We
We
We
We
WT
We
"}
(12,1,1) = {"
LM
Jz
xL
We
We
WT
We
We
We
WT
We
We
LM
Jz
xL
"}
(13,1,1) = {"
gf
iN
gf
We
zK
Jz
xL
We
LM
tv
xL
We
ur
xl
ur
"}
(14,1,1) = {"
Ug
sx
Ug
We
gf
iN
gf
We
gf
iN
gf
We
Ug
RJ
Ug
"}
(15,1,1) = {"
kA
YK
kz
We
Ug
sx
Ug
We
Ug
sx
Ug
We
kA
YK
kz
"}
(16,1,1) = {"
We
We
We
We
kA
YK
kz
We
kA
YK
kz
We
We
We
We
"}
