//MAP CONVERTED BY dmm2tgm.py THIS HEADER COMMENT PREVENTS RECONVERSION, DO NOT REMOVE
"a" = (
/obj/machinery/portable_atmospherics/canister/air,
/turf/simulated/floor/plating,
/area/space)
"f" = (
/turf/simulated/floor/plating,
/area/space)
"g" = (
/obj/machinery/atmospherics/portables_connector/west,
/turf/simulated/floor/plating,
/area/space)
"t" = (
/obj/machinery/atmospherics/portables_connector/east,
/obj/machinery/light/small/sticky{
	dir = 8
	},
/turf/simulated/floor/plating,
/area/space)
"v" = (
/obj/machinery/atmospherics/valve/vertical{
	dir = 4
	},
/turf/simulated/floor/plating,
/area/space)
"M" = (
/obj/machinery/light/small/sticky{
	dir = 4
	},
/turf/simulated/floor/plating,
/area/space)
"Y" = (
/obj/machinery/portable_atmospherics/scrubber,
/turf/simulated/floor/plating,
/area/space)

(1,1,1) = {"
Y
t
a
a
f
"}
(2,1,1) = {"
f
v
a
a
f
"}
(3,1,1) = {"
Y
g
f
M
f
"}
