//MAP CONVERTED BY dmm2tgm.py THIS HEADER COMMENT PREVENTS RECONVERSION, DO NOT REMOVE
"a" = (
/turf/variableTurf/wall,
/area/noGenerate)
"b" = (
/turf/simulated/wall/auto/reinforced,
/area/noGenerate)
"c" = (
/turf/simulated/floor/wood/two,
/area/noGenerate)
"d" = (
/turf/simulated/floor/carpet{
	dir = 8;
	icon_state = "purple4"
	},
/area/noGenerate)
"e" = (
/obj/decal/cleanable/blood/gibs,
/obj/decal/cleanable/blood/drip/high,
/obj/fakeobject/skeleton,
/turf/simulated/floor/carpet{
	dir = 10;
	icon_state = "fpurple1"
	},
/area/noGenerate)
"f" = (
/obj/decal/cleanable/blood/splatter,
/obj/decal/cleanable/blood/gibs/core,
/obj/fakeobject/skeleton,
/turf/simulated/floor/carpet{
	dir = 10;
	icon_state = "fpurple1"
	},
/area/noGenerate)
"g" = (
/turf/simulated/floor/carpet{
	dir = 4;
	icon_state = "purple4"
	},
/area/noGenerate)
"h" = (
/obj/decal/cleanable/dirt,
/turf/simulated/floor/wood/two,
/area/noGenerate)
"i" = (
/obj/table/wood/round,
/obj/candle_light{
	pixel_w = 0;
	pixel_x = 1;
	pixel_y = 12;
	pixel_z = 0
	},
/turf/simulated/floor/wood/two,
/area/noGenerate)
"j" = (
/obj/stool/chair/dining/wood{
	dir = 4;
	icon_state = "chair_wooden"
	},
/turf/simulated/floor/wood/two,
/area/noGenerate)
"k" = (
/obj/table/wood/auto,
/obj/item/plate{
	pixel_y = 8
	},
/obj/item/skull,
/turf/simulated/floor/wood/two,
/area/noGenerate)
"l" = (
/obj/table/wood/auto,
/obj/item/plate{
	pixel_y = 8
	},
/obj/item/reagent_containers/food/drinks/skull_chalice{
	pixel_y = 20
	},
/obj/item/parts/human_parts/arm/left,
/obj/item/coin,
/turf/simulated/floor/wood/two,
/area/noGenerate)
"m" = (
/obj/stool/chair/dining/wood{
	dir = 8;
	icon_state = "chair_wooden"
	},
/turf/simulated/floor/wood/two,
/area/noGenerate)
"n" = (
/obj/table/wood/round,
/obj/candle_light{
	pixel_w = 1;
	pixel_z = 12
	},
/turf/simulated/floor/wood/two,
/area/noGenerate)
"o" = (
/obj/table/wood/auto,
/obj/item/plate{
	pixel_y = 8
	},
/obj/decal/cleanable/blood/gibs/body,
/turf/simulated/floor/wood/two,
/area/noGenerate)
"p" = (
/obj/table/wood/auto,
/obj/item/plate{
	pixel_y = 8
	},
/obj/item/reagent_containers/food/drinks/skull_chalice{
	pixel_y = 20
	},
/obj/item/parts/human_parts/leg/left,
/obj/decal/cleanable/dirt,
/turf/simulated/floor/wood/two,
/area/noGenerate)
"q" = (
/obj/item/kitchen/utensil/knife,
/obj/item/skull,
/obj/decal/cleanable/blood/splatter,
/turf/simulated/floor/wood/two,
/area/noGenerate)
"r" = (
/obj/decal/poster/wallsign/bar{
	desc = "What kind of establishment is hidden in an asteroid?"
	},
/turf/simulated/wall/auto/reinforced,
/area/noGenerate)
"s" = (
/turf/simulated/floor/airless/stairs/wood/wide,
/area/noGenerate)
"t" = (
/turf/simulated/floor/airless/stairs/wood/wide{
	dir = 6;
	icon_state = "wood_stairs2"
	},
/area/noGenerate)
"u" = (
/obj/decal/cleanable/dirt,
/turf/variableTurf/floor,
/area/noGenerate)
"v" = (
/obj/item/skull,
/turf/variableTurf/floor,
/area/noGenerate)
"w" = (
/obj/decal/cleanable/blood/tracks,
/turf/variableTurf/floor,
/area/noGenerate)
"x" = (
/turf/variableTurf/floor,
/area/noGenerate)
"y" = (
/obj/decal/cleanable/blood/tracks,
/obj/item/oreprospector,
/turf/variableTurf/floor,
/area/noGenerate)

(1,1,1) = {"
a
a
a
a
a
a
a
a
a
a
"}
(2,1,1) = {"
a
b
b
b
b
b
b
b
a
a
"}
(3,1,1) = {"
a
c
c
i
c
c
q
b
u
a
"}
(4,1,1) = {"
a
d
h
j
j
j
c
r
v
x
"}
(5,1,1) = {"
a
e
c
k
o
p
c
s
w
y
"}
(6,1,1) = {"
a
f
c
l
k
o
c
t
u
x
"}
(7,1,1) = {"
a
g
c
m
m
m
c
b
x
a
"}
(8,1,1) = {"
a
h
c
n
c
c
h
b
a
a
"}
(9,1,1) = {"
a
b
b
b
b
b
b
b
a
a
"}
(10,1,1) = {"
a
a
a
a
a
a
a
a
a
a
"}
