//MAP CONVERTED BY dmm2tgm.py THIS HEADER COMMENT PREVENTS RECONVERSION, DO NOT REMOVE
"a" = (
/obj/machinery/light/runway_light/delay4,
/obj/lattice/auto/turf_attaching,
/turf/space,
/area/space)
"b" = (
/obj/decal/tile_edge/floorguide/arrow_e{
	pixel_x = 7
	},
/mob/living/critter/robotic/bot/cleanbot,
/turf/simulated/floor/airless/caution/west,
/area/space)
"g" = (
/obj/machinery/light/incandescent/blueish{
	dir = 1;
	pixel_y = 4
	},
/turf/space,
/area/noGenerate)
"h" = (
/obj/window/bulletproof/east,
/obj/machinery/vending/standard,
/turf/unsimulated/floor/airless/techfloor,
/area/space)
"i" = (
/obj/lattice/auto/turf_attaching,
/obj/machinery/light/runway_light/delay3,
/turf/space,
/area/space)
"j" = (
/obj/machinery/illuminated_sign/open_neon,
/turf/unsimulated/wall/auto/adventure,
/area/space)
"k" = (
/obj/machinery/light/incandescent/blueish,
/turf/unsimulated/floor/airless/techfloor,
/area/space)
"m" = (
/obj/machinery/light/runway_light/delay4,
/obj/lattice/auto/turf_attaching,
/obj/lattice/auto/turf_attaching,
/turf/space,
/area/space)
"n" = (
/obj/decal/poster/wallsign/stencil/right/s{
	pixel_x = 12;
	pixel_y = 5
	},
/turf/unsimulated/wall/auto/adventure,
/area/space)
"t" = (
/obj/window/bulletproof/west,
/obj/machinery/vending/pda,
/turf/unsimulated/floor/airless/techfloor,
/area/space)
"x" = (
/obj/decal/tile_edge/floorguide/arrow_e{
	pixel_x = 10
	},
/turf/simulated/floor/airless/caution/east,
/area/space)
"z" = (
/obj/machinery/vending/computer3,
/turf/unsimulated/floor/airless/techfloor,
/area/space)
"A" = (
/obj/decal/poster/wallsign/stencil/right/p{
	pixel_x = 12;
	pixel_y = 10
	},
/turf/unsimulated/wall/auto/adventure,
/area/space)
"E" = (
/obj/decal/tile_edge/floorguide/arrow_e{
	pixel_x = 7
	},
/turf/simulated/floor/airless/caution/west,
/area/space)
"F" = (
/obj/machinery/light/runway_light/delay2,
/obj/machinery/light/incandescent/blueish,
/turf/unsimulated/floor/airless/techfloor,
/area/space)
"G" = (
/obj/decal/poster/wallsign/stencil/right/h{
	pixel_x = 12;
	pixel_y = 10
	},
/turf/unsimulated/wall/auto/adventure,
/area/space)
"L" = (
/obj/machinery/light/runway_light/delay5,
/obj/lattice/auto/turf_attaching,
/turf/space,
/area/space)
"M" = (
/turf/space,
/area/allowGenerate)
"N" = (
/obj/lattice/auto/turf_attaching,
/turf/space,
/area/space)
"O" = (
/obj/decal/poster/wallsign/stencil/right/o{
	pixel_x = 12;
	pixel_y = 5
	},
/turf/unsimulated/wall/auto/adventure,
/area/space)
"P" = (
/turf/space,
/area/noGenerate)
"Q" = (
/obj/lattice/auto/turf_attaching,
/obj/lattice/auto/turf_attaching,
/turf/space,
/area/space)
"S" = (
/obj/machinery/vending/floppy,
/turf/unsimulated/floor/airless/techfloor,
/area/space)
"U" = (
/obj/machinery/light/runway_light/delay2,
/turf/unsimulated/floor/airless/techfloor,
/area/space)
"Y" = (
/turf/unsimulated/wall/auto/adventure,
/area/space)
"Z" = (
/turf/unsimulated/floor/airless/techfloor,
/area/space)

(1,1,1) = {"
M
M
P
P
P
P
P
M
"}
(2,1,1) = {"
M
M
P
L
N
L
P
M
"}
(3,1,1) = {"
M
P
P
a
N
m
P
P
"}
(4,1,1) = {"
P
P
b
i
Q
i
E
P
"}
(5,1,1) = {"
P
j
t
U
Z
F
n
g
"}
(6,1,1) = {"
P
Y
S
Z
Z
Z
G
P
"}
(7,1,1) = {"
P
Y
z
Z
Z
Z
O
P
"}
(8,1,1) = {"
P
j
h
Z
Z
k
A
g
"}
(9,1,1) = {"
P
P
x
N
N
Q
x
P
"}
(10,1,1) = {"
M
P
P
P
P
P
P
P
"}
