//MAP CONVERTED BY dmm2tgm.py THIS HEADER COMMENT PREVENTS RECONVERSION, DO NOT REMOVE
"a" = (
/obj/gunbotdrone_spawner/uncommon,
/turf/variableTurf/clear,
/area/noGenerate)

(1,1,1) = {"
a
"}
