//MAP CONVERTED BY dmm2tgm.py THIS HEADER COMMENT PREVENTS RECONVERSION, DO NOT REMOVE
"a" = (
/turf/simulated/floor/carpet/clowncarpet,
/area/space)
"d" = (
/obj/stool/bar,
/turf/simulated/floor/carpet/clowncarpet/innercorner{
	dir = 5
	},
/area/space)
"e" = (
/obj/submachine/chef_sink{
	pixel_y = 22
	},
/obj/decal/cleanable/ash,
/turf/simulated/floor/carpet/clowncarpet/border{
	dir = 9
	},
/area/space)
"f" = (
/obj/table/clothred/auto,
/obj/item/reagent_containers/food/drinks/drinkingglass/random_style{
	pixel_y = 11;
	pixel_x = 4;
	rand_pos = 0
	},
/obj/item/reagent_containers/food/drinks/drinkingglass/random_style{
	rand_pos = 0;
	pixel_y = -9;
	pixel_x = -7
	},
/obj/item/shaker/ketchup{
	pixel_y = 12;
	pixel_x = -8
	},
/turf/simulated/floor/carpet/clowncarpet,
/area/space)
"g" = (
/obj/item/reagent_containers/food/snacks/cookie/peanut{
	rand_pos = 0
	},
/obj/machinery/light/small{
	dir = 4;
	icon_state = "bulb1"
	},
/turf/simulated/floor/carpet/clowncarpet/border{
	dir = 6
	},
/area/space)
"h" = (
/obj/cable{
	icon_state = "4-8"
	},
/obj/critter/dog/george,
/turf/simulated/floor/carpet/clowncarpet,
/area/space)
"k" = (
/obj/stool/chair/comfy/wheelchair{
	dir = 8
	},
/turf/simulated/floor/carpet/clowncarpet/border{
	dir = 6
	},
/area/space)
"t" = (
/obj/item/storage/box/costume/clown/recycled{
	pixel_y = 5;
	pixel_x = 1
	},
/obj/item/disk/data/cartridge/clown{
	pixel_y = 3;
	pixel_x = -8
	},
/obj/item/clothing/suit/cardboard_box/colorful/clown,
/obj/decal/cleanable/ketchup,
/turf/simulated/floor/carpet/clowncarpet/innercorner{
	dir = 9
	},
/area/space)
"u" = (
/obj/cable,
/obj/machinery/power/apc{
	dir = 2;
	name = "S APC";
	pixel_y = -24
	},
/obj/storage/secure/closet/fridge/opened,
/obj/item/reagent_containers/food/drinks/milk/rancid,
/obj/item/reagent_containers/food/drinks/milk/rancid,
/obj/item/reagent_containers/food/drinks/milk/rancid,
/obj/item/reagent_containers/food/snacks/ingredient/dough_cookie,
/obj/item/reagent_containers/food/snacks/ingredient/dough_cookie,
/obj/item/reagent_containers/food/snacks/ingredient/sugar,
/obj/item/reagent_containers/food/snacks/ingredient/sugar,
/obj/item/reagent_containers/food/snacks/ingredient/flour,
/obj/item/reagent_containers/food/snacks/ingredient/flour,
/obj/item/reagent_containers/food/drinks/milk,
/obj/item/reagent_containers/food/drinks/milk,
/turf/simulated/floor/carpet/clowncarpet/border{
	dir = 10
	},
/area/space)
"x" = (
/obj/table/glass/auto,
/obj/item/reagent_containers/food/drinks/drinkingglass/random_style{
	pixel_y = 11;
	pixel_x = 7;
	rand_pos = 0
	},
/obj/item/reagent_containers/food/snacks/cookie/peanut{
	rand_pos = 0
	},
/obj/item/reagent_containers/food/snacks/condiment/syrup{
	rand_pos = 0;
	pixel_y = 17;
	pixel_x = -7
	},
/turf/simulated/floor/carpet/clowncarpet/border,
/area/space)
"B" = (
/obj/decal/poster/wallsign/poster_clown{
	pixel_x = -4;
	pixel_y = 42
	},
/turf/simulated/floor/carpet/clowncarpet/border{
	dir = 5
	},
/area/space)
"C" = (
/obj/cable{
	icon_state = "4-8"
	},
/obj/stool/bar,
/obj/decal/cleanable/vomit,
/turf/simulated/floor/carpet/clowncarpet,
/area/space)
"D" = (
/obj/cable{
	icon_state = "4-8"
	},
/obj/table/clothred/auto,
/obj/item/plate{
	pixel_y = 10
	},
/obj/item/reagent_containers/food/snacks/cookie/chocolate_chip{
	rand_pos = 0;
	pixel_y = 8;
	pixel_x = -2
	},
/obj/item/reagent_containers/food/snacks/cookie/chocolate_chip{
	rand_pos = 0;
	pixel_y = 12;
	pixel_x = 2
	},
/obj/item/reagent_containers/food/snacks/cookie/chocolate_chip{
	rand_pos = 0;
	pixel_y = 6;
	pixel_x = 4
	},
/turf/simulated/floor/carpet/clowncarpet,
/area/space)
"E" = (
/obj/table/clothred/auto,
/obj/machinery/glass_recycler{
	density = 1;
	pixel_y = 7
	},
/obj/item/storage/box/glassbox{
	pixel_x = -2;
	pixel_y = 11
	},
/turf/simulated/floor/carpet/clowncarpet/border{
	dir = 9
	},
/area/space)
"G" = (
/turf/simulated/floor/carpet/clowncarpet/innercorner{
	dir = 8
	},
/area/space)
"I" = (
/turf/simulated/wall/auto/supernorn,
/area/space)
"L" = (
/turf/simulated/floor/carpet/clowncarpet/innercorner,
/area/space)
"P" = (
/obj/table/clothred/auto,
/obj/item/reagent_containers/food/drinks/milk/clownspider{
	pixel_y = 13
	},
/obj/item/reagent_containers/food/snacks/cookie/oatmeal{
	rand_pos = 0;
	pixel_y = -8;
	pixel_x = -5
	},
/obj/item/storage/box/cookie_tin/sugar{
	pixel_x = -14;
	pixel_y = 5
	},
/obj/decal/cleanable/dirt/dirt2,
/obj/machinery/light/small{
	dir = 1
	},
/turf/simulated/floor/carpet/clowncarpet/border{
	dir = 1
	},
/area/space)
"Q" = (
/obj/stool/bar,
/obj/item/reagent_containers/food/snacks/cookie/bacon{
	rand_pos = 0
	},
/obj/decal/cleanable/cobweb2,
/turf/simulated/floor/carpet/clowncarpet/border{
	dir = 5
	},
/area/space)
"S" = (
/obj/cable{
	icon_state = "2-4"
	},
/obj/submachine/chef_oven,
/obj/decal/cleanable/dirt/dirt3,
/turf/simulated/floor/carpet/clowncarpet/border{
	dir = 8
	},
/area/space)
"V" = (
/obj/cable{
	icon_state = "4-8"
	},
/turf/simulated/floor/carpet/clowncarpet/border{
	dir = 4
	},
/area/space)
"X" = (
/obj/stool/chair/green{
	dir = 4
	},
/obj/decal/cleanable/paper,
/obj/machinery/light/small{
	dir = 8;
	icon_state = "bulb1"
	},
/turf/simulated/floor/carpet/clowncarpet/border{
	dir = 10
	},
/area/space)

(1,1,1) = {"
I
e
S
u
I
"}
(2,1,1) = {"
E
t
h
G
X
"}
(3,1,1) = {"
P
f
D
a
x
"}
(4,1,1) = {"
Q
d
C
L
k
"}
(5,1,1) = {"
I
B
V
g
I
"}
