//MAP CONVERTED BY dmm2tgm.py THIS HEADER COMMENT PREVENTS RECONVERSION, DO NOT REMOVE
"a" = (
/obj/machinery/light/small{
	dir = 8;
	icon_state = "bulb1"
	},
/obj/table/reinforced/bar/auto{
	name = "sturdy wooden table"
	},
/obj/item/pen{
	pixel_x = -7
	},
/obj/item/paper_bin,
/obj/item/device/light/zippo,
/obj/item/instrument/harmonica,
/turf/simulated/floor/carpet{
	dir = 10;
	icon_state = "fred6"
	},
/area/space)
"c" = (
/obj/machinery/light/small{
	dir = 1
	},
/obj/stool/chair/couch,
/turf/simulated/floor/carpet{
	dir = 1;
	icon_state = "fred6"
	},
/area/space)
"d" = (
/obj/item/instrument/large/jukebox,
/obj/decal/glow{
	brightness = 3;
	color_b = 0.2;
	color_g = 0.45;
	color_r = 0.5;
	invisibility = 101;
	name = "glow - YELLOW"
	},
/turf/simulated/floor/carpet{
	dir = 2;
	icon_state = "fred6"
	},
/area/space)
"i" = (
/turf/simulated/floor/carpet{
	dir = 10;
	icon_state = "fred4"
	},
/area/space)
"l" = (
/obj/stool/chair/comfy{
	dir = 4;
	icon_state = "chair_comfy"
	},
/obj/cable{
	icon_state = "4-8"
	},
/turf/simulated/floor/carpet{
	dir = 8;
	icon_state = "fred3"
	},
/area/space)
"n" = (
/obj/stool/chair/couch{
	dir = 8;
	icon_state = "chair_couch-brown"
	},
/turf/simulated/floor/carpet{
	dir = 9;
	icon_state = "fred6"
	},
/area/space)
"o" = (
/obj/item/device/radio/beacon,
/turf/simulated/floor/carpet{
	dir = 2;
	icon_state = "fred3"
	},
/area/space)
"r" = (
/obj/shrub{
	dir = 10;
	icon_state = "shrub"
	},
/turf/simulated/floor/carpet{
	dir = 9;
	icon_state = "fred6"
	},
/area/space)
"v" = (
/obj/stool/chair/couch{
	dir = 4;
	icon_state = "chair_couch-brown"
	},
/obj/item/cigpacket/propuffs{
	rand_pos = 0
	},
/turf/simulated/floor/carpet{
	dir = 5;
	icon_state = "fred6"
	},
/area/space)
"w" = (
/obj/submachine/ATM{
	pixel_x = 0;
	pixel_y = -32
	},
/obj/machinery/light/small{
	dir = 4;
	icon_state = "bulb1"
	},
/obj/shrub{
	dir = 10;
	icon_state = "shrub"
	},
/turf/simulated/floor/carpet{
	dir = 6;
	icon_state = "fred6"
	},
/area/space)
"z" = (
/obj/shrub{
	dir = 10;
	icon_state = "shrub"
	},
/turf/simulated/floor/carpet{
	dir = 5;
	icon_state = "fred6"
	},
/area/space)
"B" = (
/obj/stool/chair/comfy{
	dir = 8;
	icon_state = "chair_comfy"
	},
/obj/cable{
	icon_state = "4-8"
	},
/turf/simulated/floor/carpet{
	dir = 4;
	icon_state = "fred3"
	},
/area/space)
"E" = (
/obj/cable{
	icon_state = "4-8"
	},
/turf/simulated/floor/carpet{
	dir = 4;
	icon_state = "fred6"
	},
/area/space)
"H" = (
/turf/simulated/floor/carpet{
	dir = 1;
	icon_state = "fred3"
	},
/area/space)
"I" = (
/obj/table/wood/auto,
/obj/item/game_kit,
/obj/item/decoration/ashtray,
/obj/item/instrument/saxophone,
/obj/item/clothing/glasses/sunglasses,
/obj/cable{
	icon_state = "4-8"
	},
/turf/simulated/floor/carpet,
/area/space)
"K" = (
/obj/table/reinforced/bar/auto{
	name = "sturdy wooden table"
	},
/obj/item/storage/dicepouch,
/obj/item/reagent_containers/food/drinks/bottle/hobo_wine,
/turf/simulated/floor/carpet{
	dir = 6;
	icon_state = "fred6"
	},
/area/space)
"M" = (
/obj/machinery/power/apc{
	dir = 2;
	name = "S APC";
	pixel_y = -24
	},
/obj/shrub{
	dir = 10;
	icon_state = "shrub"
	},
/obj/cable,
/turf/simulated/floor/carpet{
	dir = 10;
	icon_state = "fred6"
	},
/area/space)
"P" = (
/obj/critter/boogiebot,
/turf/simulated/floor/carpet{
	dir = 6;
	icon_state = "fred4"
	},
/area/space)
"Q" = (
/obj/critter/dog/george,
/turf/simulated/floor/carpet{
	dir = 9;
	icon_state = "fred4"
	},
/area/space)
"T" = (
/obj/cable{
	icon_state = "2-4"
	},
/turf/simulated/floor/carpet{
	dir = 8;
	icon_state = "fred6"
	},
/area/space)
"V" = (
/turf/simulated/wall/auto/supernorn,
/area/space)
"Y" = (
/turf/simulated/floor/carpet{
	dir = 5;
	icon_state = "fred4"
	},
/area/space)

(1,1,1) = {"
V
r
T
M
V
"}
(2,1,1) = {"
n
Q
l
i
a
"}
(3,1,1) = {"
c
H
I
o
d
"}
(4,1,1) = {"
v
Y
B
P
K
"}
(5,1,1) = {"
V
z
E
w
V
"}
