//MAP CONVERTED BY dmm2tgm.py THIS HEADER COMMENT PREVENTS RECONVERSION, DO NOT REMOVE
"a" = (
/turf/space/shuttle_transit,
/area/area_that_kills_you_if_you_enter_it)
"n" = (
/turf/space/shuttle_transit,
/area/shuttle/escape/transit)
"q" = (
/turf/space/shuttle_transit,
/area/shuttle_particle_spawn/south)
"w" = (
/turf/space/shuttle_transit,
/area/shuttle_transit_space/south)
"V" = (
/obj/landmark/escape_pod_succ/north,
/turf/space/shuttle_transit,
/area/shuttle_transit_space/south)

(1,1,1) = {"
a
a
a
a
a
a
a
a
a
a
a
a
a
a
a
a
a
a
a
a
a
a
a
a
a
a
a
a
a
a
"}
(2,1,1) = {"
a
w
w
w
w
w
w
w
w
w
w
w
w
w
w
w
w
w
w
w
w
w
w
w
w
w
w
w
w
a
"}
(3,1,1) = {"
a
w
w
w
w
w
w
w
w
w
w
w
w
w
w
w
w
w
w
w
w
w
w
w
w
w
w
w
w
a
"}
(4,1,1) = {"
a
w
w
w
w
w
w
w
w
w
w
w
w
w
w
w
w
w
w
w
w
w
w
w
w
w
w
w
w
a
"}
(5,1,1) = {"
a
w
w
w
w
w
w
w
w
w
w
w
w
w
w
w
w
w
w
w
w
w
w
w
w
w
w
w
w
a
"}
(6,1,1) = {"
a
w
w
w
w
w
w
w
w
w
w
w
w
w
w
w
w
w
w
w
w
w
w
w
V
w
w
w
w
a
"}
(7,1,1) = {"
a
w
w
w
w
w
w
w
w
w
w
w
w
w
w
w
w
w
w
w
w
w
w
w
w
w
w
w
w
a
"}
(8,1,1) = {"
a
w
w
w
w
w
w
w
w
w
w
w
w
w
w
w
w
w
w
w
w
w
w
w
w
w
w
w
w
a
"}
(9,1,1) = {"
a
w
w
w
w
w
w
w
w
n
n
n
n
n
n
n
n
n
n
n
n
n
n
w
w
w
w
w
w
a
"}
(10,1,1) = {"
a
w
w
w
w
w
w
w
n
n
n
n
n
n
n
n
n
n
n
n
n
n
n
q
q
q
w
w
w
a
"}
(11,1,1) = {"
a
w
w
w
w
w
w
w
n
n
n
n
n
n
n
n
n
n
n
n
n
n
n
n
w
w
w
w
w
a
"}
(12,1,1) = {"
a
w
w
w
w
n
n
n
n
n
n
n
n
n
n
n
n
n
n
n
n
n
n
n
w
w
w
w
w
a
"}
(13,1,1) = {"
a
w
w
w
n
n
n
n
n
n
n
n
n
n
n
n
n
n
n
n
n
n
n
n
w
w
w
w
w
a
"}
(14,1,1) = {"
a
w
w
w
n
n
n
n
n
n
n
n
n
n
n
n
n
n
n
n
n
n
n
w
w
w
w
w
w
a
"}
(15,1,1) = {"
a
w
w
w
n
n
n
n
n
n
n
n
n
n
n
n
n
n
n
n
n
n
w
w
w
w
w
w
w
a
"}
(16,1,1) = {"
a
w
w
w
n
n
n
n
n
n
n
n
n
n
n
n
n
n
n
n
n
n
w
w
w
w
w
w
w
a
"}
(17,1,1) = {"
a
w
w
w
n
n
n
n
n
n
n
n
n
n
n
n
n
n
n
n
n
n
n
w
w
w
w
w
w
a
"}
(18,1,1) = {"
a
w
w
w
n
n
n
n
n
n
n
n
n
n
n
n
n
n
n
n
n
n
n
n
w
w
w
w
w
a
"}
(19,1,1) = {"
a
w
w
w
w
n
n
n
n
n
n
n
n
n
n
n
n
n
n
n
n
n
n
n
w
w
w
w
w
a
"}
(20,1,1) = {"
a
w
w
w
w
w
w
w
n
n
n
n
n
n
n
n
n
n
n
n
n
n
n
n
w
w
w
w
w
a
"}
(21,1,1) = {"
a
w
w
w
w
w
w
w
n
n
n
n
n
n
n
n
n
n
n
n
n
n
n
q
q
q
w
w
w
a
"}
(22,1,1) = {"
a
w
w
w
w
w
w
w
w
n
n
n
n
n
n
n
n
n
n
n
n
n
n
w
w
w
w
w
w
a
"}
(23,1,1) = {"
a
w
w
w
w
w
w
w
w
w
w
w
w
w
w
w
w
w
w
w
w
w
w
w
w
w
w
w
w
a
"}
(24,1,1) = {"
a
w
w
w
w
w
w
w
w
w
w
w
w
w
w
w
w
w
w
w
w
w
w
w
w
w
w
w
w
a
"}
(25,1,1) = {"
a
w
w
w
w
w
w
w
w
w
w
w
w
w
w
w
w
w
w
w
w
w
w
w
V
w
w
w
w
a
"}
(26,1,1) = {"
a
w
w
w
w
w
w
w
w
w
w
w
w
w
w
w
w
w
w
w
w
w
w
w
w
w
w
w
w
a
"}
(27,1,1) = {"
a
w
w
w
w
w
w
w
w
w
w
w
w
w
w
w
w
w
w
w
w
w
w
w
w
w
w
w
w
a
"}
(28,1,1) = {"
a
w
w
w
w
w
w
w
w
w
w
w
w
w
w
w
w
w
w
w
w
w
w
w
w
w
w
w
w
a
"}
(29,1,1) = {"
a
w
w
w
w
w
w
w
w
w
w
w
w
w
w
w
w
w
w
w
w
w
w
w
w
w
w
w
w
a
"}
(30,1,1) = {"
a
a
a
a
a
a
a
a
a
a
a
a
a
a
a
a
a
a
a
a
a
a
a
a
a
a
a
a
a
a
"}
