//MAP CONVERTED BY dmm2tgm.py THIS HEADER COMMENT PREVENTS RECONVERSION, DO NOT REMOVE
"aa" = (
/obj/decoration/regallamp{
	anchored = 1;
	lit = 1
	},
/turf/unsimulated/floor/carpet/regalcarpet/border{
	dir = 5
	},
/area/shuttle/escape/centcom)
"ak" = (
/obj/stool/chair/comfy/throne_gold{
	anchored = 1
	},
/turf/unsimulated/floor/carpet/regalcarpet/border{
	dir = 8
	},
/area/shuttle/escape/centcom)
"ar" = (
/obj/stool/chair/wooden/regal{
	anchored = 1;
	dir = 1
	},
/turf/unsimulated/floor/carpet/regalcarpet/border,
/area/shuttle/escape/centcom)
"aN" = (
/obj/decal/lightshaft,
/obj/machinery/light/small/floor,
/obj/shrub,
/turf/unsimulated/floor/marble/border_wb{
	dir = 4
	},
/area/shuttle/escape/centcom)
"aU" = (
/turf/unsimulated/floor/marble/border_wb{
	dir = 4
	},
/area/shuttle/escape/centcom)
"bi" = (
/obj/decoration/regallamp{
	anchored = 1;
	lit = 1
	},
/turf/unsimulated/floor/marble/border_wb{
	dir = 10
	},
/area/shuttle/escape/centcom)
"cu" = (
/obj/stool/chair/comfy/throne_gold{
	anchored = 1
	},
/obj/item/clothing/head/crown{
	pixel_x = 11;
	pixel_y = -13
	},
/turf/unsimulated/floor/carpet/regalcarpet,
/area/shuttle/escape/centcom)
"cU" = (
/turf/unsimulated/floor/carpet/regalcarpet/border{
	dir = 6
	},
/area/shuttle/escape/centcom)
"dc" = (
/obj/indestructible/shuttle_corner{
	dir = 1
	},
/turf/unsimulated/outdoors/grass,
/area/shuttle/escape/centcom)
"dW" = (
/obj/decal/lightshaft,
/obj/table/clothred/auto,
/obj/item/reagent_containers/food/drinks/bottle/wine{
	pixel_x = 7;
	pixel_y = 17;
	rand_pos = 0
	},
/obj/item/reagent_containers/food/drinks/drinkingglass/wine{
	pixel_x = -2;
	pixel_y = 8;
	rand_pos = 0
	},
/obj/machinery/light{
	dir = 1;
	pixel_y = 21
	},
/turf/unsimulated/floor/marble/border_bw{
	dir = 8
	},
/area/shuttle/escape/centcom)
"eO" = (
/obj/shrub{
	dir = 4
	},
/obj/potted_plant/potted_plant5{
	dir = 4
	},
/turf/unsimulated/floor/marble/black,
/area/shuttle/escape/centcom)
"eQ" = (
/turf/unsimulated/floor/marble/border_wb{
	dir = 8
	},
/area/shuttle/escape/centcom)
"fK" = (
/obj/wingrille_spawn/auto,
/obj/machinery/shuttle/engine/heater{
	icon_state = "alt_heater-R"
	},
/turf/space,
/area/shuttle/escape/centcom)
"gp" = (
/obj/stool/chair/comfy/throne_gold{
	anchored = 1
	},
/turf/unsimulated/floor/carpet/regalcarpet,
/area/shuttle/escape/centcom)
"gu" = (
/obj/shrub{
	dir = 10
	},
/turf/unsimulated/floor/marble/border_bw{
	dir = 8
	},
/area/shuttle/escape/centcom)
"he" = (
/obj/machinery/shuttle/engine/propulsion{
	icon_state = "alt_propulsion"
	},
/turf/unsimulated/outdoors/grass,
/area/shuttle/escape/centcom)
"iz" = (
/obj/table/regal/auto,
/obj/item/reagent_containers/food/snacks/plant/apple{
	pixel_x = -13;
	pixel_y = 13;
	rand_pos = 0
	},
/obj/item/reagent_containers/food/drinks/bottle/wine{
	pixel_x = -6;
	pixel_y = 13;
	rand_pos = 0
	},
/obj/item/reagent_containers/food/drinks/bottle/champagne{
	pixel_x = 6;
	pixel_y = 8;
	rand_pos = 0
	},
/obj/item/reagent_containers/food/drinks/bottle/fancy_beer{
	pixel_x = -1;
	pixel_y = 6;
	rand_pos = 0
	},
/obj/item/kitchen/food_box/donut_box{
	pixel_x = -13
	},
/turf/unsimulated/floor/carpet/regalcarpet,
/area/shuttle/escape/centcom)
"iJ" = (
/obj/table/regal/auto,
/obj/item/reagent_containers/food/drinks/drinkingglass/wine{
	pixel_y = 15;
	rand_pos = 0
	},
/obj/item/reagent_containers/food/drinks/drinkingglass/wine{
	pixel_x = 6;
	pixel_y = 15;
	rand_pos = 0
	},
/obj/item/reagent_containers/food/drinks/drinkingglass/wine{
	pixel_x = 12;
	pixel_y = 15;
	rand_pos = 0
	},
/obj/item/reagent_containers/food/drinks/drinkingglass/wine{
	pixel_x = -6;
	pixel_y = 15;
	rand_pos = 0
	},
/obj/item/reagent_containers/food/drinks/drinkingglass/wine{
	pixel_x = -12;
	pixel_y = 15;
	rand_pos = 0
	},
/obj/item/reagent_containers/food/drinks/drinkingglass/flute{
	rand_pos = 0
	},
/obj/item/reagent_containers/food/drinks/drinkingglass/flute{
	pixel_x = -8;
	rand_pos = 0
	},
/obj/item/reagent_containers/food/drinks/drinkingglass/flute{
	pixel_x = 8;
	rand_pos = 0
	},
/turf/unsimulated/floor/carpet/regalcarpet,
/area/shuttle/escape/centcom)
"kl" = (
/obj/table/regal/auto,
/obj/item/reagent_containers/food/snacks/salad{
	pixel_x = 8;
	pixel_y = 14;
	rand_pos = 0
	},
/obj/item/reagent_containers/food/snacks/salad{
	pixel_x = 12;
	pixel_y = 8;
	rand_pos = 0
	},
/obj/item/reagent_containers/food/snacks/salad{
	pixel_x = 8;
	rand_pos = 0
	},
/obj/item/reagent_containers/food/snacks/salad{
	pixel_x = 12;
	pixel_y = -8;
	rand_pos = 0
	},
/obj/item/reagent_containers/food/snacks/plant/apple{
	pixel_x = -4;
	pixel_y = 13;
	rand_pos = 0
	},
/obj/item/reagent_containers/food/snacks/cake/chocolate/gateau{
	pixel_x = -8;
	pixel_y = 3;
	rand_pos = 0
	},
/turf/unsimulated/floor/carpet/regalcarpet,
/area/shuttle/escape/centcom)
"lX" = (
/obj/shrub{
	dir = 1
	},
/obj/item/clothing/head/crown,
/turf/unsimulated/floor/carpet/regalcarpet/border{
	dir = 8
	},
/area/shuttle/escape/centcom)
"mj" = (
/obj/stool/chair/comfy/throne_gold{
	anchored = 1
	},
/turf/unsimulated/floor/carpet/regalcarpet/border{
	dir = 4
	},
/area/shuttle/escape/centcom)
"mG" = (
/obj/decoration/regallamp{
	anchored = 1;
	lit = 1
	},
/turf/unsimulated/floor/marble/border_bw{
	dir = 4
	},
/area/shuttle/escape/centcom)
"mY" = (
/obj/indestructible/shuttle_corner{
	dir = 4
	},
/turf/unsimulated/floor/marble/border_bw{
	dir = 4
	},
/area/shuttle/escape/centcom)
"nf" = (
/obj/shrub{
	dir = 1
	},
/obj/machinery/light{
	dir = 4;
	pixel_x = 10
	},
/turf/unsimulated/floor/marble/border_bw{
	dir = 8
	},
/area/shuttle/escape/centcom)
"pr" = (
/obj/stool/chair/wooden/regal{
	anchored = 1
	},
/turf/unsimulated/floor/carpet/regalcarpet/border{
	dir = 1
	},
/area/shuttle/escape/centcom)
"pM" = (
/obj/decoration/regallamp{
	anchored = 1;
	lit = 1
	},
/turf/unsimulated/floor/marble/border_wb{
	dir = 6
	},
/area/shuttle/escape/centcom)
"pV" = (
/obj/indestructible/shuttle_corner{
	dir = 8
	},
/turf/unsimulated/floor/marble/border_wb{
	dir = 4
	},
/area/shuttle/escape/centcom)
"ql" = (
/turf/simulated/wall/auto/shuttle{
	icon_state = "3"
	},
/area/shuttle/escape/centcom)
"qI" = (
/obj/table/clothred/auto,
/obj/item/reagent_containers/food/drinks/drinkingglass/flute{
	pixel_x = -5;
	pixel_y = 16;
	rand_pos = 0
	},
/obj/item/reagent_containers/food/drinks/bottle/fancy_beer{
	pixel_x = 5;
	pixel_y = 11;
	rand_pos = 0
	},
/obj/item/reagent_containers/food/drinks/bottle/mead{
	pixel_x = -2;
	pixel_y = 8;
	rand_pos = 0
	},
/turf/unsimulated/floor/marble/border_bw{
	dir = 8
	},
/area/shuttle/escape/centcom)
"qS" = (
/obj/lattice{
	dir = 1;
	icon_state = "lattice-dir-b"
	},
/turf/unsimulated/outdoors/grass,
/area/centcom/outside)
"ra" = (
/obj/table/regal/auto,
/obj/item/reagent_containers/food/snacks/danish_apple{
	pixel_x = 8;
	rand_pos = 0
	},
/obj/item/reagent_containers/food/snacks/danish_apple{
	pixel_x = 5;
	pixel_y = 8;
	rand_pos = 0
	},
/obj/item/reagent_containers/food/snacks/danish_apple{
	pixel_x = -9;
	pixel_y = 6;
	rand_pos = 0
	},
/obj/item/reagent_containers/food/snacks/danish_apple{
	pixel_x = -4;
	rand_pos = 0
	},
/obj/machinery/light/small/floor,
/turf/unsimulated/floor/carpet/regalcarpet,
/area/shuttle/escape/centcom)
"ri" = (
/obj/indestructible/shuttle_corner{
	dir = 8
	},
/turf/unsimulated/outdoors/grass,
/area/shuttle/escape/centcom)
"sm" = (
/obj/indestructible/shuttle_corner{
	dir = 0;
	icon_state = "7"
	},
/turf/simulated/wall/auto/shuttle{
	icon_state = "3"
	},
/area/shuttle/escape/centcom)
"th" = (
/obj/decoration/regallamp{
	anchored = 1;
	lit = 1
	},
/turf/unsimulated/floor/marble/black,
/area/shuttle/escape/centcom)
"tj" = (
/turf/unsimulated/floor/marble/border_bw{
	dir = 10
	},
/area/shuttle/escape/centcom)
"tJ" = (
/obj/wingrille_spawn/auto,
/obj/machinery/shuttle/engine/heater{
	icon_state = "alt_heater-L"
	},
/turf/simulated/floor/plating/airless,
/area/shuttle/escape/centcom)
"ub" = (
/obj/table/regal/auto,
/obj/item/reagent_containers/food/snacks/breadloaf/honeywheat{
	pixel_x = -11;
	pixel_y = 13;
	rand_pos = 0
	},
/obj/item/reagent_containers/food/snacks/breadloaf/pumpkin{
	pixel_x = -6;
	pixel_y = 5;
	rand_pos = 0
	},
/obj/item/reagent_containers/food/snacks/breadloaf/corn/sweet/honey{
	pixel_x = 16;
	pixel_y = 13;
	rand_pos = 0
	},
/obj/machinery/light/small/floor,
/obj/item/kitchen/food_box/donut_box{
	pixel_x = 5;
	pixel_y = 4
	},
/turf/unsimulated/floor/carpet/regalcarpet,
/area/shuttle/escape/centcom)
"uD" = (
/obj/indestructible/shuttle_corner{
	dir = 0
	},
/turf/unsimulated/floor/marble/border_bw{
	dir = 8
	},
/area/shuttle/escape/centcom)
"uR" = (
/obj/item/storage/wall/medical{
	dir = 8
	},
/turf/simulated/wall/auto/shuttle{
	icon_state = "3"
	},
/area/shuttle/escape/centcom)
"vs" = (
/turf/simulated/wall/auto/shuttle{
	icon_state = "12"
	},
/area/shuttle/escape/centcom)
"vt" = (
/obj/table/regal/auto,
/obj/item/reagent_containers/food/snacks/garlicbread{
	pixel_y = 15;
	rand_pos = 0
	},
/obj/item/reagent_containers/food/snacks/garlicbread{
	pixel_y = 7;
	rand_pos = 0
	},
/obj/item/reagent_containers/food/snacks/garlicbread{
	rand_pos = 0
	},
/obj/item/reagent_containers/food/snacks/pickle{
	pixel_x = 11;
	pixel_y = -11;
	rand_pos = 0
	},
/obj/item/reagent_containers/food/snacks/pickle{
	pixel_y = -9;
	rand_pos = 0
	},
/obj/item/reagent_containers/food/snacks/pickle{
	pixel_x = -9;
	pixel_y = -11;
	rand_pos = 0
	},
/turf/unsimulated/floor/carpet/regalcarpet,
/area/shuttle/escape/centcom)
"wt" = (
/turf/unsimulated/floor/carpet/regalcarpet/border{
	dir = 9
	},
/area/shuttle/escape/centcom)
"wQ" = (
/obj/shrub{
	dir = 8
	},
/turf/unsimulated/floor/marble/border_bw{
	dir = 4
	},
/area/shuttle/escape/centcom)
"xc" = (
/obj/item/storage/wall/medical{
	dir = 4
	},
/turf/simulated/wall/auto/shuttle{
	icon_state = "3"
	},
/area/shuttle/escape/centcom)
"yh" = (
/obj/table/regal/auto,
/obj/decoration/floralarrangement{
	pixel_x = 15;
	pixel_y = -17
	},
/obj/item/reagent_containers/food/drinks/bottle/wine{
	pixel_x = -6;
	pixel_y = 9;
	rand_pos = 0
	},
/obj/item/reagent_containers/food/drinks/drinkingglass/wine{
	pixel_x = 2;
	pixel_y = 16;
	rand_pos = 0
	},
/obj/item/reagent_containers/food/drinks/bottle/fancy_beer{
	pixel_x = 4;
	pixel_y = 6;
	rand_pos = 0
	},
/obj/item/reagent_containers/food/drinks/bottle/mead{
	rand_pos = 0
	},
/obj/item/reagent_containers/food/drinks/bottle/fancy_beer{
	pixel_x = -7;
	pixel_y = -11;
	rand_pos = 0
	},
/turf/unsimulated/floor/carpet/regalcarpet,
/area/shuttle/escape/centcom)
"yq" = (
/obj/decal/lightshaft,
/obj/shrub{
	dir = 6
	},
/turf/unsimulated/floor/marble/border_wb{
	dir = 1
	},
/area/shuttle/escape/centcom)
"yu" = (
/obj/table/regal/auto,
/obj/item/reagent_containers/food/snacks/ice_cream/goodrandom{
	pixel_x = -12;
	pixel_y = 22;
	rand_pos = 0
	},
/obj/item/reagent_containers/food/snacks/ice_cream/goodrandom{
	pixel_x = -12;
	pixel_y = 9;
	rand_pos = 0
	},
/obj/item/reagent_containers/food/snacks/danish_blueb{
	pixel_x = 12;
	rand_pos = 0
	},
/obj/item/reagent_containers/food/snacks/danish_blueb{
	pixel_x = 6;
	pixel_y = 17;
	rand_pos = 0
	},
/obj/item/reagent_containers/food/snacks/danish_blueb{
	pixel_x = 13;
	pixel_y = 18;
	rand_pos = 0
	},
/obj/item/reagent_containers/food/snacks/danish_blueb{
	pixel_x = 15;
	pixel_y = 10;
	rand_pos = 0
	},
/obj/item/reagent_containers/food/snacks/danish_cherry{
	pixel_x = 3;
	pixel_y = 13;
	rand_pos = 0
	},
/obj/item/reagent_containers/food/snacks/danish_cherry{
	pixel_x = 9;
	pixel_y = 6;
	rand_pos = 0
	},
/obj/item/reagent_containers/food/snacks/danish_cherry{
	rand_pos = 0
	},
/obj/item/reagent_containers/food/snacks/cake/chocolate/gateau{
	pixel_x = -8;
	pixel_y = 16;
	rand_pos = 0
	},
/turf/unsimulated/floor/carpet/regalcarpet,
/area/shuttle/escape/centcom)
"yL" = (
/obj/indestructible/shuttle_corner{
	dir = 4
	},
/turf/unsimulated/floor/marble/border_bw{
	dir = 8
	},
/area/shuttle/escape/centcom)
"yU" = (
/obj/shrub{
	dir = 6
	},
/obj/machinery/light/small/floor,
/turf/unsimulated/floor/marble/border_wb{
	dir = 8
	},
/area/shuttle/escape/centcom)
"yW" = (
/obj/shrub{
	dir = 8
	},
/turf/unsimulated/floor/marble/border_wb{
	dir = 4
	},
/area/shuttle/escape/centcom)
"za" = (
/turf/unsimulated/floor/marble/border_bw{
	dir = 9
	},
/area/shuttle/escape/centcom)
"zi" = (
/obj/decoration/regallamp{
	anchored = 1;
	lit = 1
	},
/turf/unsimulated/floor/marble/border_wb{
	dir = 4
	},
/area/shuttle/escape/centcom)
"zx" = (
/obj/wingrille_spawn/auto,
/obj/machinery/shuttle/engine/heater{
	icon_state = "alt_heater-R"
	},
/turf/simulated/floor/plating/airless,
/area/shuttle/escape/centcom)
"Ab" = (
/obj/shrub{
	dir = 1
	},
/turf/unsimulated/floor/carpet/regalcarpet/border{
	dir = 4
	},
/area/shuttle/escape/centcom)
"Be" = (
/obj/table/clothred/auto,
/obj/decoration/decorativeplant/plant4{
	pixel_x = 16;
	pixel_y = 16
	},
/obj/item/reagent_containers/food/drinks/bottle/champagne{
	pixel_x = -6;
	pixel_y = 19;
	rand_pos = 0
	},
/obj/item/reagent_containers/food/drinks/drinkingglass/flute{
	pixel_x = 4;
	pixel_y = 17;
	rand_pos = 0
	},
/obj/item/reagent_containers/food/drinks/drinkingglass/flute{
	pixel_y = 20;
	rand_pos = 0
	},
/obj/machinery/light{
	dir = 1;
	pixel_y = 21
	},
/obj/item/kitchen/food_box/donut_box{
	pixel_x = 2;
	pixel_y = 7
	},
/turf/unsimulated/floor/marble/border_bw{
	dir = 4
	},
/area/shuttle/escape/centcom)
"BX" = (
/turf/unsimulated/floor/marble/border_bw{
	dir = 5
	},
/area/shuttle/escape/centcom)
"Ca" = (
/obj/machinery/light,
/obj/table/regal/auto,
/obj/decoration/floralarrangement,
/turf/unsimulated/floor/carpet/regalcarpet/border{
	dir = 6
	},
/area/shuttle/escape/centcom)
"Cb" = (
/obj/lattice{
	icon_state = "lattice-dir"
	},
/turf/unsimulated/outdoors/grass,
/area/centcom/outside)
"Cg" = (
/obj/table/regal/auto,
/obj/item/reagent_containers/food/snacks/croissant{
	pixel_x = -16;
	pixel_y = 11;
	rand_pos = 0
	},
/obj/item/reagent_containers/food/snacks/plant/grape{
	pixel_x = -3;
	pixel_y = 12;
	rand_pos = 0
	},
/obj/item/reagent_containers/food/snacks/plant/grape{
	rand_pos = 0
	},
/obj/item/reagent_containers/food/snacks/plant/grape/green{
	pixel_x = 11;
	pixel_y = 12;
	rand_pos = 0
	},
/obj/item/reagent_containers/food/snacks/plant/grape/green{
	pixel_x = 15;
	rand_pos = 0
	},
/obj/item/reagent_containers/food/snacks/plant/grape/green{
	pixel_x = 7;
	pixel_y = 7;
	rand_pos = 0
	},
/turf/unsimulated/floor/carpet/regalcarpet,
/area/shuttle/escape/centcom)
"Cj" = (
/obj/shrub{
	dir = 10
	},
/obj/machinery/light/small/floor,
/turf/unsimulated/floor/marble/border_wb{
	dir = 4
	},
/area/shuttle/escape/centcom)
"Cu" = (
/turf/unsimulated/floor/marble/border_wb{
	dir = 10
	},
/area/shuttle/escape/centcom)
"CH" = (
/obj/table/regal/auto,
/obj/item/reagent_containers/food/snacks/croissant{
	pixel_x = -8;
	pixel_y = 11;
	rand_pos = 0
	},
/obj/item/reagent_containers/food/snacks/croissant{
	pixel_y = 11;
	rand_pos = 0
	},
/obj/item/reagent_containers/food/snacks/croissant{
	pixel_x = 8;
	pixel_y = 11;
	rand_pos = 0
	},
/obj/item/reagent_containers/food/snacks/fairybread{
	pixel_x = -8;
	rand_pos = 0
	},
/obj/item/reagent_containers/food/snacks/fairybread{
	rand_pos = 0
	},
/obj/item/reagent_containers/food/snacks/fairybread{
	pixel_x = 7;
	rand_pos = 0
	},
/obj/item/reagent_containers/food/snacks/fairybread{
	pixel_x = 15;
	rand_pos = 0
	},
/obj/item/reagent_containers/food/snacks/plant/apple{
	pixel_x = -14;
	pixel_y = -3;
	rand_pos = 0
	},
/turf/unsimulated/floor/carpet/regalcarpet,
/area/shuttle/escape/centcom)
"Dy" = (
/turf/unsimulated/floor/marble/border_bw{
	dir = 8
	},
/area/shuttle/escape/centcom)
"DE" = (
/obj/table/regal/auto,
/obj/item/storage/toolbox/emergency{
	pixel_x = 13
	},
/obj/item/reagent_containers/food/drinks/bottle/wine{
	pixel_x = 14;
	pixel_y = 20;
	rand_pos = 0
	},
/obj/item/reagent_containers/food/drinks/drinkingglass/wine{
	pixel_x = 2;
	pixel_y = 16;
	rand_pos = 0
	},
/obj/item/reagent_containers/food/drinks/drinkingglass/wine{
	pixel_x = -6;
	pixel_y = 6;
	rand_pos = 0
	},
/obj/item/clothing/head/crown,
/turf/unsimulated/floor/carpet/regalcarpet/border,
/area/shuttle/escape/centcom)
"DH" = (
/turf/unsimulated/floor/marble/border_bw{
	dir = 6
	},
/area/shuttle/escape/centcom)
"DS" = (
/obj/wingrille_spawn/auto/crystal,
/turf/unsimulated/floor/marble/black,
/area/shuttle/escape/centcom)
"Ez" = (
/obj/machinery/door/airlock/pyro/external{
	dir = 4
	},
/turf/unsimulated/floor/shuttle,
/area/shuttle/escape/centcom)
"EK" = (
/turf/unsimulated/floor/carpet/regalcarpet/border{
	dir = 5
	},
/area/shuttle/escape/centcom)
"FA" = (
/obj/table/regal/auto,
/obj/item/reagent_containers/food/drinks/bottle/champagne{
	pixel_x = -3;
	pixel_y = 19;
	rand_pos = 0
	},
/obj/item/reagent_containers/food/drinks/drinkingglass/flute{
	pixel_y = 5;
	rand_pos = 0
	},
/obj/item/reagent_containers/food/drinks/drinkingglass/flute{
	pixel_x = 7;
	pixel_y = 13;
	rand_pos = 0
	},
/obj/item/reagent_containers/food/drinks/bottle/mead{
	pixel_x = -10;
	pixel_y = 7;
	rand_pos = 0
	},
/obj/item/reagent_containers/food/snacks/plant/apple{
	pixel_x = -14;
	pixel_y = 2;
	rand_pos = 0
	},
/turf/unsimulated/floor/carpet/regalcarpet,
/area/shuttle/escape/centcom)
"FS" = (
/obj/machinery/light,
/obj/table/regal/auto,
/obj/decoration/floralarrangement,
/turf/unsimulated/floor/carpet/regalcarpet/border{
	dir = 10
	},
/area/shuttle/escape/centcom)
"HB" = (
/obj/indestructible/shuttle_corner{
	dir = 0
	},
/turf/unsimulated/floor/marble/black,
/area/shuttle/escape/centcom)
"HR" = (
/obj/machinery/computer/announcement,
/turf/unsimulated/floor/carpet/regalcarpet/border{
	dir = 1
	},
/area/shuttle/escape/centcom)
"IB" = (
/obj/shrub{
	dir = 1
	},
/turf/unsimulated/floor/marble/border_bw{
	dir = 4
	},
/area/shuttle/escape/centcom)
"IW" = (
/obj/table/regal/auto,
/obj/decoration/floralarrangement,
/obj/machinery/light/small/floor,
/turf/unsimulated/floor/marble/black,
/area/shuttle/escape/centcom)
"Jn" = (
/turf/unsimulated/floor/carpet/regalcarpet/border{
	dir = 4
	},
/area/shuttle/escape/centcom)
"Jq" = (
/obj/shrub{
	dir = 8
	},
/turf/unsimulated/floor/marble/border_bw{
	dir = 8
	},
/area/shuttle/escape/centcom)
"JU" = (
/obj/table/regal/auto,
/obj/item/reagent_containers/food/drinks/bottle/wine{
	pixel_x = -8;
	pixel_y = 7;
	rand_pos = 0
	},
/obj/item/reagent_containers/food/drinks/bottle/champagne{
	pixel_x = 14;
	pixel_y = 11;
	rand_pos = 0
	},
/obj/item/reagent_containers/food/drinks/bottle/fancy_beer{
	pixel_x = 1;
	pixel_y = 4;
	rand_pos = 0
	},
/obj/item/kitchen/utensil/knife{
	dir = 4;
	pixel_y = 19
	},
/obj/item/kitchen/utensil/fork{
	dir = 4;
	pixel_y = 11
	},
/obj/item/kitchen/utensil/fork{
	dir = 4;
	pixel_y = 9
	},
/turf/unsimulated/floor/carpet/regalcarpet,
/area/shuttle/escape/centcom)
"JV" = (
/obj/wingrille_spawn/auto/crystal,
/turf/unsimulated/floor/marble,
/area/shuttle/escape/centcom)
"JW" = (
/obj/indestructible/shuttle_corner{
	dir = 1
	},
/turf/unsimulated/floor/marble/border_bw{
	dir = 4
	},
/area/shuttle/escape/centcom)
"Kc" = (
/obj/machinery/computer/shuttle,
/turf/unsimulated/floor/carpet/regalcarpet/border{
	dir = 1
	},
/area/shuttle/escape/centcom)
"Lb" = (
/obj/table/regal/auto,
/obj/random_item_spawner/med_kit/one{
	pixel_x = 23;
	pixel_y = 5
	},
/obj/random_item_spawner/med_kit/one{
	pixel_x = 19;
	pixel_y = 12
	},
/obj/item/kitchen/food_box/donut_box{
	pixel_x = -16;
	pixel_y = 12
	},
/obj/item/kitchen/food_box/donut_box{
	pixel_x = -8;
	pixel_y = 3
	},
/turf/unsimulated/floor/carpet/regalcarpet/border,
/area/shuttle/escape/centcom)
"LO" = (
/obj/shrub{
	dir = 4
	},
/turf/unsimulated/floor/marble/border_wb{
	dir = 1
	},
/area/shuttle/escape/centcom)
"LR" = (
/turf/unsimulated/floor/marble/border_bw{
	dir = 4
	},
/area/shuttle/escape/centcom)
"Nh" = (
/obj/machinery/shuttle/engine/heater{
	icon_state = "alt_heater"
	},
/turf/simulated/wall/auto/shuttle{
	icon_state = "3"
	},
/area/shuttle/escape/centcom)
"Nl" = (
/obj/table/regal/auto,
/obj/item/reagent_containers/food/snacks/painauchocolat{
	pixel_x = 6;
	rand_pos = 0
	},
/obj/item/reagent_containers/food/snacks/painauchocolat{
	rand_pos = 0
	},
/obj/item/reagent_containers/food/snacks/painauchocolat{
	pixel_x = -5;
	rand_pos = 0
	},
/obj/item/reagent_containers/food/snacks/painauchocolat{
	pixel_x = -11;
	rand_pos = 0
	},
/obj/item/reagent_containers/food/snacks/painauchocolat{
	pixel_x = -19;
	rand_pos = 0
	},
/obj/item/reagent_containers/food/snacks/plant/pear{
	pixel_x = 6;
	pixel_y = 13;
	rand_pos = 0
	},
/obj/item/reagent_containers/food/snacks/plant/pear{
	pixel_x = 16;
	pixel_y = 14;
	rand_pos = 0
	},
/obj/item/reagent_containers/food/snacks/plant/apple{
	pixel_x = -4;
	pixel_y = 13;
	rand_pos = 0
	},
/obj/machinery/light/small/floor,
/turf/unsimulated/floor/carpet/regalcarpet,
/area/shuttle/escape/centcom)
"NV" = (
/obj/item/storage/wall/fire{
	dir = 4
	},
/turf/simulated/wall/auto/shuttle{
	icon_state = "3"
	},
/area/shuttle/escape/centcom)
"NW" = (
/turf/simulated/wall/auto/shuttle{
	icon_state = "11"
	},
/area/shuttle/escape/centcom)
"Og" = (
/obj/shrub{
	dir = 6
	},
/obj/machinery/light{
	dir = 8;
	pixel_x = -10
	},
/turf/unsimulated/floor/marble/border_bw{
	dir = 4
	},
/area/shuttle/escape/centcom)
"OZ" = (
/obj/decal/lightshaft,
/obj/decoration/regallamp{
	anchored = 1;
	lit = 1
	},
/turf/unsimulated/floor/marble/border_wb{
	dir = 8
	},
/area/shuttle/escape/centcom)
"Qy" = (
/obj/wingrille_spawn/auto,
/obj/machinery/shuttle/engine/heater{
	icon_state = "alt_heater-M"
	},
/turf/simulated/floor/plating/airless,
/area/shuttle/escape/centcom)
"QN" = (
/obj/shrub{
	dir = 10
	},
/obj/machinery/light{
	dir = 1;
	pixel_y = 21
	},
/turf/unsimulated/floor/marble/border_wb{
	dir = 1
	},
/area/shuttle/escape/centcom)
"QT" = (
/obj/indestructible/shuttle_corner{
	dir = 4
	},
/turf/unsimulated/outdoors/grass,
/area/shuttle/escape/centcom)
"Rg" = (
/obj/indestructible/shuttle_corner{
	dir = 8
	},
/turf/unsimulated/floor/marble/border_bw{
	dir = 8
	},
/area/shuttle/escape/centcom)
"Rr" = (
/obj/shrub{
	dir = 8
	},
/turf/unsimulated/floor/marble/border_wb{
	dir = 8
	},
/area/shuttle/escape/centcom)
"Rx" = (
/obj/shrub,
/obj/item/clothing/head/crown,
/turf/unsimulated/floor/marble/border_wb{
	dir = 5
	},
/area/shuttle/escape/centcom)
"RB" = (
/obj/indestructible/shuttle_corner{
	dir = 0
	},
/turf/unsimulated/outdoors/grass,
/area/shuttle/escape/centcom)
"Sk" = (
/turf/unsimulated/floor/carpet/regalcarpet,
/area/shuttle/escape/centcom)
"SC" = (
/obj/table/clothred/auto,
/obj/decoration/decorativeplant/plant5{
	pixel_x = 17;
	pixel_y = 15
	},
/obj/item/reagent_containers/food/drinks/drinkingglass/wine{
	pixel_x = 8;
	pixel_y = 14;
	rand_pos = 0
	},
/obj/item/reagent_containers/food/drinks/bottle/mead{
	pixel_x = 20;
	pixel_y = 9;
	rand_pos = 0
	},
/obj/item/kitchen/food_box/donut_box{
	pixel_x = -4;
	pixel_y = 6
	},
/turf/unsimulated/floor/marble/border_bw{
	dir = 4
	},
/area/shuttle/escape/centcom)
"SS" = (
/turf/unsimulated/floor/marble/border_wb{
	dir = 6
	},
/area/shuttle/escape/centcom)
"Tr" = (
/obj/shrub{
	dir = 10
	},
/obj/item/clothing/head/crown,
/turf/unsimulated/floor/marble/border_wb{
	dir = 8
	},
/area/shuttle/escape/centcom)
"TP" = (
/obj/indestructible/shuttle_corner{
	dir = 4
	},
/turf/unsimulated/floor/marble/border_wb{
	dir = 8
	},
/area/shuttle/escape/centcom)
"UB" = (
/obj/shrub{
	dir = 1
	},
/turf/unsimulated/floor/marble/border_wb{
	dir = 9
	},
/area/shuttle/escape/centcom)
"VH" = (
/obj/table/regal/auto,
/obj/item/reagent_containers/food/snacks/plant/apple{
	pixel_x = 18;
	pixel_y = 12;
	rand_pos = 0
	},
/obj/item/reagent_containers/food/snacks/danish_weed{
	pixel_x = 3;
	pixel_y = 13;
	rand_pos = 0
	},
/obj/item/reagent_containers/food/snacks/danish_weed{
	pixel_x = -9;
	pixel_y = 8;
	rand_pos = 0
	},
/obj/item/reagent_containers/food/snacks/danish_weed{
	rand_pos = 0
	},
/obj/item/reagent_containers/food/snacks/danish_weed{
	pixel_x = -19;
	rand_pos = 0
	},
/obj/item/reagent_containers/food/snacks/danish_blueb{
	pixel_x = -10;
	rand_pos = 0
	},
/obj/item/reagent_containers/food/snacks/danish_blueb{
	pixel_x = -13;
	pixel_y = 16;
	rand_pos = 0
	},
/turf/unsimulated/floor/carpet/regalcarpet,
/area/shuttle/escape/centcom)
"VW" = (
/obj/indestructible/shuttle_corner{
	dir = 8
	},
/turf/unsimulated/floor/marble/border_bw{
	dir = 4
	},
/area/shuttle/escape/centcom)
"Wb" = (
/turf/unsimulated/outdoors/grass,
/area/centcom/outside)
"WE" = (
/obj/table/regal/auto,
/obj/item/reagent_containers/food/snacks/garlicbread_ch{
	rand_pos = 0
	},
/obj/item/reagent_containers/food/snacks/garlicbread_ch{
	pixel_y = 10;
	rand_pos = 0
	},
/obj/item/reagent_containers/food/snacks/garlicbread_ch{
	pixel_y = 21;
	rand_pos = 0
	},
/obj/machinery/light/small/floor,
/turf/unsimulated/floor/carpet/regalcarpet,
/area/shuttle/escape/centcom)
"WN" = (
/obj/shrub,
/obj/machinery/light{
	dir = 1;
	pixel_y = 21
	},
/turf/unsimulated/floor/marble/border_wb{
	dir = 1
	},
/area/shuttle/escape/centcom)
"Xb" = (
/obj/table/regal/auto,
/obj/item/reagent_containers/food/drinks/drinkingglass/wine{
	rand_pos = 0
	},
/obj/item/reagent_containers/food/drinks/drinkingglass/wine{
	pixel_x = 6;
	rand_pos = 0
	},
/obj/item/reagent_containers/food/drinks/drinkingglass/wine{
	pixel_x = 12;
	rand_pos = 0
	},
/obj/item/reagent_containers/food/drinks/drinkingglass/wine{
	pixel_x = -6;
	rand_pos = 0
	},
/obj/item/reagent_containers/food/drinks/drinkingglass/wine{
	pixel_x = -12;
	rand_pos = 0
	},
/obj/item/kitchen/utensil/knife{
	dir = 4;
	pixel_y = 19
	},
/obj/item/kitchen/utensil/fork{
	dir = 4;
	pixel_y = 11
	},
/obj/item/kitchen/utensil/fork{
	dir = 4;
	pixel_y = 9
	},
/obj/item/kitchen/utensil/fork{
	dir = 4;
	pixel_y = 7
	},
/turf/unsimulated/floor/carpet/regalcarpet,
/area/shuttle/escape/centcom)
"Xf" = (
/obj/item/reagent_containers/food/snacks/donut/custom/frosted{
	desc = "IT HIM, IT REALLY HIM";
	name = "smol donut";
	pixel_x = -2;
	pixel_y = -4;
	rand_pos = 0;
	doants = 0
	},
/obj/reagent_dispensers/cleanable/ants,
/obj/item/clothing/head/crown{
	desc = "Oww owwwow ouwie, spiky...";
	pixel_y = 9
	},
/turf/unsimulated/outdoors/grass,
/area/centcom/outside)
"Xh" = (
/obj/indestructible/shuttle_corner{
	dir = 1
	},
/turf/unsimulated/floor/marble/black,
/area/shuttle/escape/centcom)
"Xi" = (
/obj/item/storage/wall/emergency{
	dir = 8
	},
/turf/simulated/wall/auto/shuttle{
	icon_state = "3"
	},
/area/shuttle/escape/centcom)
"XE" = (
/obj/decoration/regallamp{
	anchored = 1;
	lit = 1
	},
/turf/unsimulated/floor/carpet/regalcarpet/border{
	dir = 9
	},
/area/shuttle/escape/centcom)
"YN" = (
/obj/decoration/regallamp{
	anchored = 1;
	lit = 1
	},
/turf/unsimulated/floor/marble/border_bw{
	dir = 8
	},
/area/shuttle/escape/centcom)
"YQ" = (
/turf/unsimulated/floor/carpet/regalcarpet/border{
	dir = 8
	},
/area/shuttle/escape/centcom)
"Zi" = (
/obj/shrub{
	dir = 4
	},
/obj/potted_plant/potted_plant2{
	dir = 8
	},
/turf/unsimulated/floor/marble/black,
/area/shuttle/escape/centcom)
"ZF" = (
/turf/unsimulated/floor/carpet/regalcarpet/border{
	dir = 10
	},
/area/shuttle/escape/centcom)
"ZS" = (
/obj/shrub{
	dir = 6
	},
/turf/unsimulated/floor/marble/border_wb{
	dir = 4
	},
/area/shuttle/escape/centcom)
"ZX" = (
/obj/shrub{
	dir = 4
	},
/obj/machinery/light/small/floor,
/turf/unsimulated/floor/marble/border_wb{
	dir = 8
	},
/area/shuttle/escape/centcom)

(1,1,1) = {"
Wb
Wb
Wb
Wb
RB
DS
DS
Ez
Ez
DS
DS
ql
xc
ql
ql
sm
Nh
he
Wb
"}
(2,1,1) = {"
Cb
Cb
qS
RB
VW
wQ
mG
LR
LR
mG
wQ
mG
IB
mG
Og
JW
NV
QT
Wb
"}
(3,1,1) = {"
Wb
Wb
Wb
vs
Be
za
tj
LR
za
tj
LR
wt
YQ
YQ
ZF
Cu
th
tJ
he
"}
(4,1,1) = {"
qS
RB
DS
Rg
qI
BX
DH
Dy
BX
DH
Dy
pr
iJ
JU
ar
Cu
IW
Qy
he
"}
(5,1,1) = {"
RB
pV
zi
yW
aU
aU
Cj
yW
aN
ZS
Rx
pr
CH
WE
ar
Cu
eO
zx
he
"}
(6,1,1) = {"
DS
XE
lX
ak
YQ
FS
JV
JV
JV
JV
QN
pr
Cg
yu
ar
bi
HB
ri
Wb
"}
(7,1,1) = {"
DS
HR
cu
Sk
Sk
Lb
JV
Xf
Wb
JV
yq
pr
yh
ra
ar
Cu
vs
Wb
Wb
"}
(8,1,1) = {"
DS
Kc
gp
Sk
Sk
DE
JV
Wb
Wb
JV
LO
pr
ub
FA
ar
SS
vs
Wb
Wb
"}
(9,1,1) = {"
DS
aa
Ab
mj
Jn
Ca
JV
JV
JV
JV
WN
pr
kl
VH
ar
pM
Xh
QT
Wb
"}
(10,1,1) = {"
dc
TP
OZ
Rr
eQ
eQ
yU
Tr
ZX
Rr
UB
pr
vt
Nl
ar
SS
Zi
tJ
he
"}
(11,1,1) = {"
qS
dc
DS
mY
SC
za
tj
LR
za
tj
LR
pr
iz
Xb
ar
SS
IW
Qy
he
"}
(12,1,1) = {"
Wb
Wb
Wb
vs
dW
BX
DH
Dy
BX
DH
Dy
EK
Jn
Jn
cU
SS
th
fK
he
"}
(13,1,1) = {"
Cb
Cb
qS
dc
yL
Jq
YN
Dy
Dy
YN
Jq
YN
gu
YN
nf
uD
uR
ri
Wb
"}
(14,1,1) = {"
Wb
Wb
Wb
Wb
dc
DS
DS
Ez
Ez
DS
DS
ql
Xi
ql
ql
NW
Nh
he
Wb
"}
