//MAP CONVERTED BY dmm2tgm.py THIS HEADER COMMENT PREVENTS RECONVERSION, DO NOT REMOVE
"a" = (
/turf/simulated/wall/auto/reinforced/supernorn,
/area/area_for_testing_things)
"U" = (
/turf/simulated/floor/plating,
/area/area_for_testing_things)
"V" = (
/obj/landmark/start/job/assistant,
/turf/simulated/floor/plating,
/area/area_for_testing_things)

(1,1,1) = {"
a
a
a
a
a
a
a
a
a
a
a
a
a
a
a
a
a
a
a
a
"}
(2,1,1) = {"
a
U
U
U
U
U
U
U
U
U
U
U
U
U
U
U
U
U
V
a
"}
(3,1,1) = {"
a
U
U
U
U
U
U
U
U
U
U
U
U
U
U
U
U
U
U
a
"}
(4,1,1) = {"
a
U
U
U
U
U
U
U
U
U
U
U
U
U
U
U
U
U
U
a
"}
(5,1,1) = {"
a
U
U
U
U
U
U
U
U
U
U
U
U
U
U
U
U
U
U
a
"}
(6,1,1) = {"
a
U
U
U
U
U
U
U
U
U
U
U
U
U
U
U
U
U
U
a
"}
(7,1,1) = {"
a
U
U
U
U
U
U
U
U
U
U
U
U
U
U
U
U
U
U
a
"}
(8,1,1) = {"
a
U
U
U
U
U
U
U
U
U
U
U
U
U
U
U
U
U
U
a
"}
(9,1,1) = {"
a
U
U
U
U
U
U
U
U
U
U
U
U
U
U
U
U
U
U
a
"}
(10,1,1) = {"
a
U
U
U
U
U
U
U
U
U
U
U
U
U
U
U
U
U
U
a
"}
(11,1,1) = {"
a
U
U
U
U
U
U
U
U
U
U
U
U
U
U
U
U
U
U
a
"}
(12,1,1) = {"
a
U
U
U
U
U
U
U
U
U
U
U
U
U
U
U
U
U
U
a
"}
(13,1,1) = {"
a
U
U
U
U
U
U
U
U
U
U
U
U
U
U
U
U
U
U
a
"}
(14,1,1) = {"
a
U
U
U
U
U
U
U
U
U
U
U
U
U
U
U
U
U
U
a
"}
(15,1,1) = {"
a
U
U
U
U
U
U
U
U
U
U
U
U
U
U
U
U
U
U
a
"}
(16,1,1) = {"
a
U
U
U
U
U
U
U
U
U
U
U
U
U
U
U
U
U
U
a
"}
(17,1,1) = {"
a
U
U
U
U
U
U
U
U
U
U
U
U
U
U
U
U
U
U
a
"}
(18,1,1) = {"
a
U
U
U
U
U
U
U
U
U
U
U
U
U
U
U
U
U
U
a
"}
(19,1,1) = {"
a
U
U
U
U
U
U
U
U
U
U
U
U
U
U
U
U
U
U
a
"}
(20,1,1) = {"
a
a
a
a
a
a
a
a
a
a
a
a
a
a
a
a
a
a
a
a
"}
