//MAP CONVERTED BY dmm2tgm.py THIS HEADER COMMENT PREVENTS RECONVERSION, DO NOT REMOVE
"ab" = (
/turf/unsimulated/floor/dojo/sand/horizontal,
/area/shuttle/escape/centcom)
"bg" = (
/obj/machinery/computer/shuttle/embedded/south,
/turf/unsimulated/floor/tatami,
/area/shuttle/escape/centcom)
"bC" = (
/obj/stool/chair/comfy/shuttle/brown{
	dir = 8
	},
/obj/lantern{
	dir = 4
	},
/turf/unsimulated/floor/dojo/sand,
/area/shuttle/escape/centcom)
"bK" = (
/obj/stool/chair/comfy/shuttle/brown,
/obj/lantern{
	dir = 8
	},
/turf/unsimulated/floor/wood/two,
/area/shuttle/escape/centcom)
"gh" = (
/obj/decal/fakeobjects/swordrack{
	pixel_y = 5
	},
/turf/unsimulated/wall/auto/sengoku{
	opacity = 0
	},
/area/shuttle/escape/centcom)
"ib" = (
/turf/unsimulated/wall/auto/sengoku{
	opacity = 0
	},
/area/shuttle/escape/centcom)
"ik" = (
/obj/wingrille_spawn/auto,
/turf/unsimulated/floor/wood/two,
/area/shuttle/escape/centcom)
"kb" = (
/obj/decal/wallscroll/scroll2{
	pixel_y = 32
	},
/turf/unsimulated/floor/wood/two,
/area/shuttle/escape/centcom)
"kM" = (
/obj/machinery/shuttle/engine/propulsion{
	dir = 9;
	icon_state = "alt_propulsion"
	},
/turf/unsimulated/outdoors/grass,
/area/shuttle/escape/centcom)
"lQ" = (
/obj/lantern{
	pixel_y = 10
	},
/turf/unsimulated/wall/auto/sengoku{
	opacity = 0
	},
/area/shuttle/escape/centcom)
"mo" = (
/obj/machinery/door/unpowered/wood/pyro,
/turf/unsimulated/floor/dojo/sand/vertical,
/area/shuttle/escape/centcom)
"oQ" = (
/turf/unsimulated/outdoors/grass,
/area/shuttle/escape/centcom)
"pk" = (
/obj/lattice{
	icon_state = "lattice-dir-b"
	},
/turf/unsimulated/outdoors/grass,
/area/centcom/outside)
"sm" = (
/obj/machinery/shuttle/engine/propulsion{
	dir = 5;
	icon_state = "alt_propulsion"
	},
/turf/unsimulated/outdoors/grass,
/area/shuttle/escape/centcom)
"uH" = (
/obj/machinery/door/unpowered/wood/pyro{
	dir = 8
	},
/turf/unsimulated/floor/dojo/stone,
/area/shuttle/escape/centcom)
"vJ" = (
/obj/stool/chair/comfy/shuttle/brown,
/turf/unsimulated/floor/dojo/sand/vertical,
/area/shuttle/escape/centcom)
"vM" = (
/obj/table/auto,
/obj/random_item_spawner/med_kit,
/turf/unsimulated/floor/wood/two,
/area/shuttle/escape/centcom)
"vR" = (
/obj/stool/chair/comfy/shuttle/brown,
/turf/unsimulated/floor/tatami,
/area/shuttle/escape/centcom)
"wk" = (
/obj/machinery/door/unpowered/wood/pyro,
/turf/unsimulated/floor/wood/two,
/area/shuttle/escape/centcom)
"xl" = (
/turf/unsimulated/wall/water/border,
/area/shuttle/escape/centcom)
"xP" = (
/obj/machinery/shuttle/engine/heater{
	dir = 1;
	icon_state = "alt_heater-L"
	},
/obj/window/reinforced/south,
/turf/unsimulated/floor/plating,
/area/shuttle/escape/centcom)
"yt" = (
/turf/unsimulated/floor/tatami,
/area/shuttle/escape/centcom)
"yB" = (
/obj/stool/chair/comfy/shuttle/brown{
	dir = 4
	},
/turf/unsimulated/floor/dojo/sand,
/area/shuttle/escape/centcom)
"zF" = (
/turf/unsimulated/floor/dojo/stone,
/area/shuttle/escape/centcom)
"AD" = (
/turf/unsimulated/wall/auto/paper{
	opacity = 0
	},
/area/shuttle/escape/centcom)
"Ck" = (
/obj/machinery/shuttle/engine/heater{
	dir = 1;
	icon_state = "alt_heater-M"
	},
/obj/window/reinforced/south,
/turf/unsimulated/floor/plating,
/area/shuttle/escape/centcom)
"Cl" = (
/obj/machinery/door/unpowered/wood/pyro,
/turf/unsimulated/floor/dojo/sand,
/area/shuttle/escape/centcom)
"Fa" = (
/obj/stool/chair/comfy/shuttle/brown,
/turf/unsimulated/floor/wood/two,
/area/shuttle/escape/centcom)
"Fd" = (
/obj/machinery/door/unpowered/wood/pyro{
	dir = 4
	},
/turf/unsimulated/floor/dojo/stone,
/area/shuttle/escape/centcom)
"Gd" = (
/obj/table/auto,
/obj/random_item_spawner/med_kit,
/turf/unsimulated/floor/dojo/sand,
/area/shuttle/escape/centcom)
"IL" = (
/obj/stool/chair/comfy/shuttle/brown,
/turf/unsimulated/floor/dojo/sand/circle,
/area/shuttle/escape/centcom)
"Ny" = (
/turf/unsimulated/floor/dojo/sand,
/area/shuttle/escape/centcom)
"Rb" = (
/turf/unsimulated/outdoors/grass,
/area/centcom/outside)
"RH" = (
/obj/stool/chair/comfy/shuttle/brown,
/obj/lantern{
	dir = 4
	},
/turf/unsimulated/floor/wood/two,
/area/shuttle/escape/centcom)
"Sm" = (
/obj/decal/fakeobjects/lotus{
	icon_state = "lotus_2"
	},
/turf/unsimulated/wall/water/border,
/area/shuttle/escape/centcom)
"UH" = (
/obj/lattice{
	icon_state = "lattice-dir"
	},
/turf/unsimulated/outdoors/grass,
/area/centcom/outside)
"XZ" = (
/obj/decal/wallscroll{
	pixel_y = 32
	},
/turf/unsimulated/floor/wood/two,
/area/shuttle/escape/centcom)
"Ya" = (
/obj/machinery/sleeper/compact,
/turf/unsimulated/floor/dojo/sand,
/area/shuttle/escape/centcom)
"Ym" = (
/obj/stool/chair/comfy/shuttle/brown,
/obj/lantern{
	dir = 8
	},
/turf/unsimulated/floor/dojo/sand/circle,
/area/shuttle/escape/centcom)
"Ze" = (
/obj/lantern{
	pixel_y = 10
	},
/turf/unsimulated/wall/auto/paper{
	opacity = 0
	},
/area/shuttle/escape/centcom)
"Zk" = (
/obj/machinery/shuttle/engine/propulsion{
	dir = 10;
	icon_state = "alt_propulsion"
	},
/turf/unsimulated/outdoors/grass,
/area/shuttle/escape/centcom)
"ZU" = (
/obj/machinery/shuttle/engine/heater{
	dir = 1;
	icon_state = "alt_heater-R"
	},
/obj/window/reinforced/south,
/turf/unsimulated/floor/plating,
/area/shuttle/escape/centcom)

(1,1,1) = {"
oQ
ib
ib
ib
ib
ib
Fd
ib
ik
ik
ik
ib
ib
pk
UH
UH
UH
"}
(2,1,1) = {"
kM
ZU
vJ
Ym
ib
kb
zF
bK
Fa
Fa
Fa
bK
AD
ik
AD
Rb
Rb
"}
(3,1,1) = {"
Zk
Ck
IL
ab
mo
zF
zF
Fa
Fa
Fa
Fa
Fa
ik
vM
AD
AD
pk
"}
(4,1,1) = {"
sm
xP
vJ
IL
lQ
xl
zF
Fa
Fa
Fa
Fa
Fa
Ze
vR
vR
AD
AD
"}
(5,1,1) = {"
Rb
ib
ib
ib
gh
Sm
zF
zF
zF
zF
zF
zF
wk
yt
bg
AD
AD
"}
(6,1,1) = {"
kM
ZU
Ya
yB
lQ
xl
zF
Fa
Fa
Fa
Fa
Fa
Ze
vR
vR
AD
AD
"}
(7,1,1) = {"
Zk
Ck
Gd
Ny
Cl
zF
zF
Fa
Fa
Fa
Fa
Fa
ik
vM
AD
AD
pk
"}
(8,1,1) = {"
sm
xP
Ya
bC
ib
XZ
zF
RH
Fa
Fa
Fa
RH
AD
ik
AD
Rb
Rb
"}
(9,1,1) = {"
oQ
ib
ib
ib
ib
ib
uH
ib
ik
ik
ik
ib
ib
pk
UH
UH
UH
"}
