//MAP CONVERTED BY dmm2tgm.py THIS HEADER COMMENT PREVENTS RECONVERSION, DO NOT REMOVE
"h" = (
/turf/simulated/floor/shuttle/green,
/area/station/devzone/gravity_gforce_tunnel_vision)
"i" = (
/turf/simulated/floor/shuttle/red,
/area/station/devzone/gravity_gforce_pancake)
"j" = (
/turf/simulated/floor/red,
/area/station/devzone/gravity_gforce_extreme)
"o" = (
/turf/simulated/floor/green/checker,
/area/station/devzone/gravity_traction_full)
"p" = (
/obj/table/auto,
/turf/simulated/floor/blue/checker,
/area/station/devzone/gravity_traction_partial)
"v" = (
/turf/simulated/floor/darkblue,
/area/station/devzone/gravity_gforce_half)
"w" = (
/turf/simulated/floor/darkpurple,
/area/station/devzone/gravity_gforce_none)
"E" = (
/obj/table/auto,
/turf/simulated/floor/darkpurple,
/area/station/devzone/gravity_gforce_none)
"F" = (
/turf/simulated/floor/shuttle/yellow,
/area/station/devzone/gravity_gforce_blindness)
"G" = (
/turf/simulated/floor/orange,
/area/station/devzone/gravity_gforce_high)
"P" = (
/turf/simulated/floor/blue/checker,
/area/station/devzone/gravity_traction_partial)
"S" = (
/turf/simulated/floor/shuttle/white,
/area/station/devzone/gravity_gforce_greyout)
"V" = (
/turf/simulated/floor,
/area/station/devzone)
"Y" = (
/obj/table/auto,
/turf/simulated/floor/darkblue,
/area/station/devzone/gravity_gforce_half)
"Z" = (
/turf/simulated/floor,
/area/station/devzone/gravity_gforce_normal)

(1,1,1) = {"
V
V
V
V
V
V
V
V
V
V
V
V
V
V
V
V
V
V
V
"}
(2,1,1) = {"
V
E
w
w
v
v
v
Y
Z
Z
Z
Z
G
G
G
S
S
S
V
"}
(3,1,1) = {"
V
w
w
w
v
v
v
v
Z
Z
Z
Z
G
G
G
S
S
S
V
"}
(4,1,1) = {"
V
w
w
w
v
v
v
v
Z
Z
Z
Z
G
G
G
S
S
S
V
"}
(5,1,1) = {"
V
w
w
w
v
v
v
v
Z
Z
Z
Z
G
G
G
S
S
S
V
"}
(6,1,1) = {"
V
w
w
w
v
v
v
v
Z
Z
Z
Z
G
G
G
h
h
h
V
"}
(7,1,1) = {"
V
w
w
w
v
v
v
v
Z
Z
Z
Z
G
G
G
h
h
h
V
"}
(8,1,1) = {"
V
w
w
w
v
v
v
v
Z
Z
Z
Z
G
G
G
h
h
h
V
"}
(9,1,1) = {"
V
w
w
w
v
v
v
v
Z
Z
Z
Z
G
G
G
h
h
h
V
"}
(10,1,1) = {"
V
V
w
V
V
P
v
V
V
V
V
V
V
V
V
V
V
V
V
"}
(11,1,1) = {"
V
w
w
w
P
P
P
P
o
o
o
o
j
j
j
F
F
F
V
"}
(12,1,1) = {"
V
w
w
w
P
P
P
P
o
o
o
o
j
j
j
F
F
F
V
"}
(13,1,1) = {"
V
w
w
w
P
P
P
P
o
o
o
o
j
j
j
F
F
F
V
"}
(14,1,1) = {"
V
w
w
w
P
P
P
P
o
o
o
o
j
j
j
F
F
F
V
"}
(15,1,1) = {"
V
w
w
w
P
P
P
P
o
o
o
o
j
j
j
i
i
i
V
"}
(16,1,1) = {"
V
w
w
w
P
P
P
P
o
o
o
o
j
j
j
i
i
i
V
"}
(17,1,1) = {"
V
w
w
w
P
P
P
P
o
o
o
o
j
j
j
i
i
i
V
"}
(18,1,1) = {"
V
E
w
w
P
P
P
p
o
o
o
o
j
j
j
i
i
i
V
"}
(19,1,1) = {"
V
V
V
V
V
V
V
V
V
V
V
V
V
V
V
V
V
V
V
"}
