//MAP CONVERTED BY dmm2tgm.py THIS HEADER COMMENT PREVENTS RECONVERSION, DO NOT REMOVE
"a" = (
/turf/unsimulated/wall/solidcolor/black{
	opacity = 0;
	name = "impassible blast blocker";
	mouse_opacity = 1
	},
/area/station/devzone)
"m" = (
/turf/unsimulated/wall/solidcolor/white{
	opacity = 0;
	density = 0;
	name = "blast stopper";
	mouse_opacity = 1
	},
/area/station/devzone)
"y" = (
/obj/death_button/create_dummy,
/turf/unsimulated/wall/solidcolor/black{
	opacity = 0;
	name = "impassible blast blocker";
	mouse_opacity = 1
	},
/area/station/devzone)
"A" = (
/obj/table/reinforced/auto,
/turf/simulated/floor,
/area/station/devzone)
"H" = (
/turf/simulated/floor,
/area/station/devzone)
"R" = (
/obj/table/reinforced/auto,
/obj/item/ammo/ammobox/shootingrange,
/turf/simulated/floor,
/area/station/devzone)
"T" = (
/mob/living/carbon/human/tdummy,
/turf/simulated/floor,
/area/station/devzone)

(1,1,1) = {"
H
H
H
H
y
a
a
a
a
a
a
a
a
a
a
a
a
a
a
"}
(2,1,1) = {"
H
H
H
H
H
H
m
H
H
H
H
H
H
H
H
H
H
H
a
"}
(3,1,1) = {"
H
H
H
H
H
R
m
H
H
H
H
H
H
H
H
H
T
H
a
"}
(4,1,1) = {"
H
H
H
H
H
A
m
H
H
H
H
H
H
H
H
H
H
H
a
"}
(5,1,1) = {"
H
H
H
H
H
A
m
H
H
T
H
H
H
H
H
H
H
H
a
"}
(6,1,1) = {"
H
H
H
H
H
A
m
H
H
H
H
H
H
H
T
H
H
H
a
"}
(7,1,1) = {"
H
H
H
H
H
R
m
H
H
H
H
H
H
H
H
H
H
H
a
"}
(8,1,1) = {"
H
H
H
H
H
A
m
H
H
H
H
T
H
H
H
H
H
H
a
"}
(9,1,1) = {"
H
H
H
H
H
A
m
T
H
H
H
H
H
H
H
H
H
H
a
"}
(10,1,1) = {"
H
H
H
H
H
A
m
H
H
H
H
H
H
H
H
H
T
H
a
"}
(11,1,1) = {"
H
H
H
H
H
A
m
T
H
H
H
H
H
H
H
H
H
H
a
"}
(12,1,1) = {"
H
H
H
H
H
A
m
H
H
H
H
T
H
H
H
H
H
H
a
"}
(13,1,1) = {"
H
H
H
H
H
R
m
H
H
H
H
H
H
H
H
H
H
H
a
"}
(14,1,1) = {"
H
H
H
H
H
A
m
H
H
H
H
H
H
H
T
H
H
H
a
"}
(15,1,1) = {"
H
H
H
H
H
A
m
H
H
T
H
H
H
H
H
H
H
H
a
"}
(16,1,1) = {"
H
H
H
H
H
A
m
H
H
H
H
H
H
H
H
H
H
H
a
"}
(17,1,1) = {"
H
H
H
H
H
R
m
H
H
H
H
H
H
H
H
H
T
H
a
"}
(18,1,1) = {"
H
H
H
H
H
H
m
H
H
H
H
H
H
H
H
H
H
H
a
"}
(19,1,1) = {"
H
H
H
H
a
a
a
a
a
a
a
a
a
a
a
a
a
a
a
"}
