//MAP CONVERTED BY dmm2tgm.py THIS HEADER COMMENT PREVENTS RECONVERSION, DO NOT REMOVE
"a" = (
/turf/simulated/floor/engine,
/area/station/devzone)
"b" = (
/obj/decal/tile_edge{
	icon = 'icons/obj/decals/stencils.dmi';
	icon_state = "6";
	name = "digit";
	pixel_y = 8
	},
/obj/decal/tile_edge/line/black,
/turf/simulated/floor/engine,
/area/station/devzone)
"c" = (
/obj/decal/tile_edge{
	icon = 'icons/obj/decals/stencils.dmi';
	icon_state = "3";
	name = "digit";
	pixel_y = 8
	},
/obj/decal/tile_edge/line/black,
/turf/simulated/floor/engine,
/area/station/devzone)
"g" = (
/obj/item/storage/toolbox/electrical,
/obj/item/storage/toolbox/electrical,
/obj/item/storage/toolbox/electrical,
/turf/simulated/floor/engine,
/area/station/devzone)
"h" = (
/obj/decal/tile_edge/line/black,
/turf/simulated/floor/engine,
/area/station/devzone)
"j" = (
/turf/unsimulated/wall/solidcolor/white{
	opacity = 0;
	density = 0;
	name = "blast stopper";
	mouse_opacity = 1
	},
/area/station/devzone)
"k" = (
/obj/decal/tile_edge/line/black{
	dir = 4;
	icon_state = "line1"
	},
/turf/simulated/floor/engine,
/area/station/devzone)
"l" = (
/obj/decal/tile_edge/line/black{
	dir = 8;
	icon_state = "line1"
	},
/turf/simulated/floor/engine,
/area/station/devzone)
"m" = (
/obj/decal/tile_edge/line/black,
/obj/decal/tile_edge{
	icon = 'icons/obj/decals/stencils.dmi';
	icon_state = "c";
	name = "digit";
	pixel_x = 8;
	pixel_y = 16
	},
/turf/simulated/floor/engine,
/area/station/devzone)
"n" = (
/obj/machinery/computer/siphon_db,
/turf/simulated/floor/engine,
/area/station/devzone)
"o" = (
/obj/machinery/computer/siphon_control{
	req_access = list(24,44)
	},
/turf/simulated/floor/engine,
/area/station/devzone)
"p" = (
/obj/decal/tile_edge/line/orange,
/obj/decal/tile_edge{
	icon = 'icons/obj/decals/stencils.dmi';
	icon_state = "h";
	name = "digit";
	pixel_x = 8;
	pixel_y = 16
	},
/turf/simulated/floor/engine,
/area/station/devzone)
"q" = (
/obj/decal/tile_edge{
	icon = 'icons/obj/decals/stencils.dmi';
	icon_state = "5";
	name = "digit";
	pixel_y = 8
	},
/obj/decal/tile_edge/line/black,
/turf/simulated/floor/engine,
/area/station/devzone)
"r" = (
/obj/machinery/siphon/resonator/stabilizer,
/turf/simulated/floor/engine,
/area/station/devzone)
"v" = (
/obj/decal/tile_edge/line/orange,
/turf/simulated/floor/engine,
/area/station/devzone)
"w" = (
/obj/machinery/siphon/core,
/turf/simulated/floor/engine,
/area/station/devzone)
"x" = (
/obj/decal/tile_edge/line/orange{
	dir = 9;
	icon_state = "line2"
	},
/obj/decal/tile_edge/line/orange{
	dir = 8;
	icon_state = "line3"
	},
/turf/simulated/floor/engine,
/area/station/devzone)
"y" = (
/obj/decal/tile_edge/line/black{
	dir = 4;
	icon_state = "line3"
	},
/turf/simulated/floor/engine,
/area/station/devzone)
"z" = (
/obj/decal/tile_edge/line/black{
	icon_state = "line1"
	},
/turf/simulated/floor/engine,
/area/station/devzone)
"A" = (
/obj/decal/tile_edge{
	icon = 'icons/obj/decals/stencils.dmi';
	icon_state = "0";
	name = "digit";
	pixel_y = 21
	},
/obj/decal/tile_edge/line/black{
	icon_state = "line1"
	},
/turf/simulated/floor/engine,
/area/station/devzone)
"B" = (
/obj/decal/tile_edge/line/black,
/obj/decal/tile_edge{
	icon = 'icons/obj/decals/stencils.dmi';
	icon_state = "f";
	name = "digit";
	pixel_x = 8;
	pixel_y = 16
	},
/turf/simulated/floor/engine,
/area/station/devzone)
"E" = (
/obj/stool/chair/office/yellow{
	dir = 1
	},
/turf/simulated/floor/engine,
/area/station/devzone)
"F" = (
/obj/item/device/calibrator{
	pixel_x = 5;
	rand_pos = 0
	},
/obj/item/screwdriver{
	pixel_x = -2;
	pixel_y = 7
	},
/turf/simulated/floor/engine,
/area/station/devzone)
"H" = (
/obj/decal/tile_edge/line/black,
/obj/decal/tile_edge{
	icon = 'icons/obj/decals/stencils.dmi';
	icon_state = "d";
	name = "digit";
	pixel_x = 8;
	pixel_y = 16
	},
/turf/simulated/floor/engine,
/area/station/devzone)
"I" = (
/obj/decal/tile_edge/line/black{
	dir = 1;
	icon_state = "line1"
	},
/turf/simulated/floor/engine,
/area/station/devzone)
"J" = (
/obj/machinery/siphon_lever,
/obj/item/paper/siphon_guide{
	pixel_y = -10
	},
/turf/simulated/floor/engine,
/area/station/devzone)
"K" = (
/obj/decal/tile_edge{
	icon = 'icons/obj/decals/stencils.dmi';
	icon_state = "7";
	name = "digit";
	pixel_y = 8
	},
/obj/decal/tile_edge/line/orange,
/turf/simulated/floor/engine,
/area/station/devzone)
"L" = (
/obj/decal/tile_edge{
	icon = 'icons/obj/decals/stencils.dmi';
	icon_state = "2";
	name = "digit";
	pixel_y = 8
	},
/obj/decal/tile_edge/line/black,
/turf/simulated/floor/engine,
/area/station/devzone)
"M" = (
/obj/decal/tile_edge/line/black,
/obj/decal/tile_edge{
	icon = 'icons/obj/decals/stencils.dmi';
	icon_state = "e";
	name = "digit";
	pixel_x = 8;
	pixel_y = 16
	},
/turf/simulated/floor/engine,
/area/station/devzone)
"N" = (
/obj/decal/tile_edge{
	icon = 'icons/obj/decals/stencils.dmi';
	icon_state = "8";
	name = "digit";
	pixel_y = 2
	},
/obj/decal/tile_edge/line/black{
	dir = 1;
	icon_state = "line1"
	},
/turf/simulated/floor/engine,
/area/station/devzone)
"O" = (
/obj/machinery/siphon/resonator,
/turf/simulated/floor/engine,
/area/station/devzone)
"Q" = (
/obj/machinery/loudspeaker,
/turf/simulated/floor/engine,
/area/station/devzone)
"R" = (
/obj/decal/tile_edge/line/black{
	icon_state = "line3"
	},
/turf/simulated/floor/engine,
/area/station/devzone)
"S" = (
/obj/decal/tile_edge{
	icon = 'icons/obj/decals/stencils.dmi';
	icon_state = "a";
	name = "digit";
	pixel_x = 14;
	pixel_y = 16
	},
/obj/decal/tile_edge/line/black{
	dir = 8;
	icon_state = "line1"
	},
/turf/simulated/floor/engine,
/area/station/devzone)
"T" = (
/obj/decal/tile_edge/line/orange{
	dir = 5;
	icon_state = "line2"
	},
/obj/decal/tile_edge/line/orange{
	dir = 8;
	icon_state = "line3"
	},
/turf/simulated/floor/engine,
/area/station/devzone)
"U" = (
/obj/decal/tile_edge{
	icon = 'icons/obj/decals/stencils.dmi';
	icon_state = "4";
	name = "digit";
	pixel_y = 8
	},
/obj/decal/tile_edge/line/black,
/turf/simulated/floor/engine,
/area/station/devzone)
"V" = (
/obj/decal/tile_edge/line/orange{
	dir = 6;
	icon_state = "line2"
	},
/obj/decal/tile_edge/line/orange{
	dir = 8;
	icon_state = "line3"
	},
/turf/simulated/floor/engine,
/area/station/devzone)
"W" = (
/obj/decal/tile_edge{
	icon = 'icons/obj/decals/stencils.dmi';
	icon_state = "1";
	name = "digit";
	pixel_y = 8
	},
/obj/decal/tile_edge/line/orange,
/obj/decal/tile_edge{
	icon = 'icons/obj/decals/stencils.dmi';
	icon_state = "b";
	name = "digit";
	pixel_x = 8;
	pixel_y = 16
	},
/turf/simulated/floor/engine,
/area/station/devzone)
"X" = (
/obj/decal/tile_edge/line/orange{
	dir = 10;
	icon_state = "line2"
	},
/obj/decal/tile_edge/line/orange{
	dir = 8;
	icon_state = "line3"
	},
/turf/simulated/floor/engine,
/area/station/devzone)
"Y" = (
/obj/decal/tile_edge/line/black,
/obj/decal/tile_edge{
	icon = 'icons/obj/decals/stencils.dmi';
	icon_state = "g";
	name = "digit";
	pixel_x = 8;
	pixel_y = 16
	},
/turf/simulated/floor/engine,
/area/station/devzone)
"Z" = (
/obj/decal/tile_edge{
	icon = 'icons/obj/decals/stencils.dmi';
	icon_state = "i";
	name = "digit";
	pixel_x = -6;
	pixel_y = 16
	},
/obj/decal/tile_edge/line/black{
	dir = 4;
	icon_state = "line1"
	},
/turf/simulated/floor/engine,
/area/station/devzone)

(1,1,1) = {"
j
j
j
j
j
j
j
j
j
j
j
j
j
j
j
j
j
j
j
"}
(2,1,1) = {"
j
a
a
a
a
a
a
a
a
a
a
a
a
a
a
a
a
a
j
"}
(3,1,1) = {"
j
a
a
a
a
a
a
a
O
O
O
a
a
a
a
a
a
a
j
"}
(4,1,1) = {"
j
a
a
a
a
a
a
a
O
O
O
a
a
a
a
a
a
a
j
"}
(5,1,1) = {"
j
a
a
a
a
a
a
a
O
O
O
a
a
a
a
a
a
a
j
"}
(6,1,1) = {"
j
a
a
a
a
x
l
l
l
l
l
l
S
X
a
a
a
a
j
"}
(7,1,1) = {"
j
a
a
a
a
N
K
b
q
U
c
L
W
A
a
a
a
a
j
"}
(8,1,1) = {"
j
a
a
a
a
I
h
a
a
a
a
a
m
z
a
F
a
a
j
"}
(9,1,1) = {"
j
a
a
a
a
I
h
a
a
a
R
a
H
z
a
o
a
a
j
"}
(10,1,1) = {"
j
a
a
a
a
I
h
a
Q
w
a
a
M
z
a
J
E
a
j
"}
(11,1,1) = {"
j
a
a
a
a
I
h
a
y
a
a
a
B
z
a
n
a
a
j
"}
(12,1,1) = {"
j
a
a
a
a
I
h
a
a
a
a
a
Y
z
a
g
a
a
j
"}
(13,1,1) = {"
j
a
a
a
a
I
v
h
h
h
h
h
p
z
a
a
a
a
j
"}
(14,1,1) = {"
j
a
a
a
a
T
k
k
k
k
k
k
Z
V
a
a
a
a
j
"}
(15,1,1) = {"
j
a
a
a
a
a
a
a
r
r
r
a
a
a
a
a
a
a
j
"}
(16,1,1) = {"
j
a
a
a
a
a
a
a
r
r
r
a
a
a
a
a
a
a
j
"}
(17,1,1) = {"
j
a
a
a
a
a
a
a
r
r
r
a
a
a
a
a
a
a
j
"}
(18,1,1) = {"
j
a
a
a
a
a
a
a
a
a
a
a
a
a
a
a
a
a
j
"}
(19,1,1) = {"
j
j
j
j
j
j
j
j
j
j
j
j
j
j
j
j
j
j
j
"}
