//MAP CONVERTED BY dmm2tgm.py THIS HEADER COMMENT PREVENTS RECONVERSION, DO NOT REMOVE
"a" = (
/turf/simulated/floor/auto/dirt,
/area/space)
"H" = (
/turf/simulated/floor/auto/trench,
/area/space)
"I" = (
/obj/item/shovel,
/turf/simulated/floor/auto/dirt,
/area/space)

(1,1,1) = {"
a
a
a
a
a
a
a
a
I
a
a
a
a
a
I
a
a
a
a
"}
(2,1,1) = {"
a
I
H
a
a
H
H
a
H
a
a
H
H
a
H
a
a
H
a
"}
(3,1,1) = {"
a
H
H
H
a
H
H
a
H
H
a
a
H
a
H
H
H
H
a
"}
(4,1,1) = {"
a
a
H
a
a
a
a
a
a
H
a
a
H
a
a
a
H
a
I
"}
(5,1,1) = {"
a
a
a
a
a
H
H
a
H
H
a
H
H
H
H
H
H
H
a
"}
(6,1,1) = {"
a
a
H
a
a
H
H
a
H
a
a
H
a
a
a
a
a
H
a
"}
(7,1,1) = {"
a
I
H
a
a
H
H
a
H
H
a
H
H
a
H
H
H
H
a
"}
(8,1,1) = {"
a
a
H
a
a
a
a
a
a
H
a
a
a
a
a
a
H
a
I
"}
(9,1,1) = {"
a
a
a
a
a
H
H
a
H
H
a
H
H
H
a
H
H
H
a
"}
(10,1,1) = {"
a
H
H
H
a
H
H
a
H
a
a
H
a
H
a
H
a
H
a
"}
(11,1,1) = {"
a
I
a
a
a
H
H
a
H
H
a
H
a
H
H
H
a
H
a
"}
(12,1,1) = {"
a
H
H
H
a
H
H
a
a
H
a
H
a
a
a
a
a
a
I
"}
(13,1,1) = {"
a
a
a
a
a
a
a
a
H
H
a
H
H
H
H
H
H
H
a
"}
(14,1,1) = {"
a
H
a
a
a
H
H
a
H
a
a
a
H
a
a
a
a
H
a
"}
(15,1,1) = {"
a
H
H
H
a
H
H
a
H
H
a
a
H
a
H
H
H
H
a
"}
(16,1,1) = {"
a
I
a
H
a
H
H
a
a
H
a
H
H
a
H
a
H
a
I
"}
(17,1,1) = {"
a
H
H
H
a
H
H
a
H
H
a
H
a
a
H
a
H
H
a
"}
(18,1,1) = {"
a
H
a
a
a
H
H
a
H
a
a
H
H
a
H
a
a
H
a
"}
(19,1,1) = {"
a
a
a
a
a
a
a
a
I
a
a
a
a
a
I
a
a
a
a
"}
